match_id,player,row,shots,pt_ending,winners,induced_forced,unforced,shots_in_pts_won,shots_in_pts_lost
20041107-M-Paris_Masters-F-Marat_Safin-Radek_Stepanek,1,F-XC,37,7,1,4,2,22,15
20041107-M-Paris_Masters-F-Marat_Safin-Radek_Stepanek,1,F-DTM,48,4,0,0,4,28,20
20041107-M-Paris_Masters-F-Marat_Safin-Radek_Stepanek,1,F-DTL,2,2,1,1,0,2,0
20041107-M-Paris_Masters-F-Marat_Safin-Radek_Stepanek,1,F-IO,17,5,3,1,1,9,8
20041107-M-Paris_Masters-F-Marat_Safin-Radek_Stepanek,1,F-II,1,0,0,0,0,0,1
20041107-M-Paris_Masters-F-Marat_Safin-Radek_Stepanek,1,B-XC,20,6,2,1,3,12,8
20041107-M-Paris_Masters-F-Marat_Safin-Radek_Stepanek,1,B-DTM,24,2,1,0,1,20,4
20041107-M-Paris_Masters-F-Marat_Safin-Radek_Stepanek,1,B-DTL,4,3,1,2,0,4,0
20041107-M-Paris_Masters-F-Marat_Safin-Radek_Stepanek,1,B-IO,9,2,0,1,1,4,5
20041107-M-Paris_Masters-F-Marat_Safin-Radek_Stepanek,1,S-XC,5,1,0,0,1,2,3
20041107-M-Paris_Masters-F-Marat_Safin-Radek_Stepanek,1,S-DTM,5,0,0,0,0,1,4
20041107-M-Paris_Masters-F-Marat_Safin-Radek_Stepanek,1,S-DTL,3,0,0,0,0,1,2
20041107-M-Paris_Masters-F-Marat_Safin-Radek_Stepanek,1,S-IO,2,0,0,0,0,1,1
20041107-M-Paris_Masters-F-Marat_Safin-Radek_Stepanek,2,F-XC,26,12,1,3,8,9,17
20041107-M-Paris_Masters-F-Marat_Safin-Radek_Stepanek,2,F-DTM,45,9,0,0,9,18,27
20041107-M-Paris_Masters-F-Marat_Safin-Radek_Stepanek,2,F-DTL,7,4,2,0,2,4,3
20041107-M-Paris_Masters-F-Marat_Safin-Radek_Stepanek,2,F-IO,14,8,0,2,6,3,11
20041107-M-Paris_Masters-F-Marat_Safin-Radek_Stepanek,2,B-XC,3,2,0,1,1,1,2
20041107-M-Paris_Masters-F-Marat_Safin-Radek_Stepanek,2,B-DTM,11,0,0,0,0,3,8
20041107-M-Paris_Masters-F-Marat_Safin-Radek_Stepanek,2,B-DTL,3,1,0,0,1,1,2
20041107-M-Paris_Masters-F-Marat_Safin-Radek_Stepanek,2,B-IO,2,1,0,0,1,0,2
20041107-M-Paris_Masters-F-Marat_Safin-Radek_Stepanek,2,S-XC,10,0,0,0,0,3,7
20041107-M-Paris_Masters-F-Marat_Safin-Radek_Stepanek,2,S-DTM,14,0,0,0,0,5,9
20041107-M-Paris_Masters-F-Marat_Safin-Radek_Stepanek,2,S-DTL,1,0,0,0,0,0,1
20041107-M-Paris_Masters-F-Marat_Safin-Radek_Stepanek,2,S-IO,3,1,0,0,1,0,3
20060627-M-Wimbledon-R128-Roger_Federer-Richard_Gasquet,1,F-XC,22,7,3,3,1,14,8
20060627-M-Wimbledon-R128-Roger_Federer-Richard_Gasquet,1,F-DTM,11,4,2,0,2,5,6
20060627-M-Wimbledon-R128-Roger_Federer-Richard_Gasquet,1,F-DTL,6,5,2,0,3,3,3
20060627-M-Wimbledon-R128-Roger_Federer-Richard_Gasquet,1,F-IO,32,15,4,6,5,22,10
20060627-M-Wimbledon-R128-Roger_Federer-Richard_Gasquet,1,F-II,2,1,1,0,0,2,0
20060627-M-Wimbledon-R128-Roger_Federer-Richard_Gasquet,1,B-XC,23,3,0,1,2,14,9
20060627-M-Wimbledon-R128-Roger_Federer-Richard_Gasquet,1,B-DTM,21,2,0,0,2,9,12
20060627-M-Wimbledon-R128-Roger_Federer-Richard_Gasquet,1,B-DTL,10,6,5,0,1,8,2
20060627-M-Wimbledon-R128-Roger_Federer-Richard_Gasquet,1,B-IO,2,1,1,0,0,1,1
20060627-M-Wimbledon-R128-Roger_Federer-Richard_Gasquet,1,S-XC,9,0,0,0,0,8,1
20060627-M-Wimbledon-R128-Roger_Federer-Richard_Gasquet,1,S-DTM,6,0,0,0,0,3,3
20060627-M-Wimbledon-R128-Roger_Federer-Richard_Gasquet,1,S-DTL,1,1,0,0,1,0,1
20060627-M-Wimbledon-R128-Roger_Federer-Richard_Gasquet,2,F-XC,19,3,0,1,2,14,5
20060627-M-Wimbledon-R128-Roger_Federer-Richard_Gasquet,2,F-DTM,20,2,0,0,2,8,12
20060627-M-Wimbledon-R128-Roger_Federer-Richard_Gasquet,2,F-DTL,8,3,0,2,1,3,5
20060627-M-Wimbledon-R128-Roger_Federer-Richard_Gasquet,2,F-IO,14,3,0,1,2,3,11
20060627-M-Wimbledon-R128-Roger_Federer-Richard_Gasquet,2,F-II,1,0,0,0,0,0,1
20060627-M-Wimbledon-R128-Roger_Federer-Richard_Gasquet,2,B-XC,38,7,0,3,4,14,24
20060627-M-Wimbledon-R128-Roger_Federer-Richard_Gasquet,2,B-DTM,19,1,0,0,1,9,10
20060627-M-Wimbledon-R128-Roger_Federer-Richard_Gasquet,2,B-DTL,9,4,2,0,2,3,6
20060627-M-Wimbledon-R128-Roger_Federer-Richard_Gasquet,2,B-IO,2,0,0,0,0,2,0
20060627-M-Wimbledon-R128-Roger_Federer-Richard_Gasquet,2,S-XC,7,2,0,0,2,1,6
20060627-M-Wimbledon-R128-Roger_Federer-Richard_Gasquet,2,S-DTM,3,0,0,0,0,0,3
20060627-M-Wimbledon-R128-Roger_Federer-Richard_Gasquet,2,S-DTL,1,0,0,0,0,0,1
20091110-M-Paris_Masters-R32-Marat_Safin-Juan_Martin_Del_Potro,1,F-XC,25,10,2,1,7,12,13
20091110-M-Paris_Masters-R32-Marat_Safin-Juan_Martin_Del_Potro,1,F-DTM,37,13,0,1,12,10,27
20091110-M-Paris_Masters-R32-Marat_Safin-Juan_Martin_Del_Potro,1,F-DTL,8,6,2,2,2,6,2
20091110-M-Paris_Masters-R32-Marat_Safin-Juan_Martin_Del_Potro,1,F-IO,11,7,2,1,4,5,6
20091110-M-Paris_Masters-R32-Marat_Safin-Juan_Martin_Del_Potro,1,B-XC,34,6,2,2,2,17,17
20091110-M-Paris_Masters-R32-Marat_Safin-Juan_Martin_Del_Potro,1,B-DTM,28,4,0,0,4,9,19
20091110-M-Paris_Masters-R32-Marat_Safin-Juan_Martin_Del_Potro,1,B-DTL,10,5,3,1,1,7,3
20091110-M-Paris_Masters-R32-Marat_Safin-Juan_Martin_Del_Potro,1,B-IO,5,0,0,0,0,4,1
20091110-M-Paris_Masters-R32-Marat_Safin-Juan_Martin_Del_Potro,1,S-DTM,1,0,0,0,0,1,0
20091110-M-Paris_Masters-R32-Marat_Safin-Juan_Martin_Del_Potro,1,S-DTL,1,0,0,0,0,0,1
20091110-M-Paris_Masters-R32-Marat_Safin-Juan_Martin_Del_Potro,1,S-IO,1,1,0,0,1,0,1
20091110-M-Paris_Masters-R32-Marat_Safin-Juan_Martin_Del_Potro,2,F-XC,32,14,6,3,5,14,18
20091110-M-Paris_Masters-R32-Marat_Safin-Juan_Martin_Del_Potro,2,F-DTM,38,2,0,0,2,22,16
20091110-M-Paris_Masters-R32-Marat_Safin-Juan_Martin_Del_Potro,2,F-DTL,3,0,0,0,0,1,2
20091110-M-Paris_Masters-R32-Marat_Safin-Juan_Martin_Del_Potro,2,F-IO,19,6,2,2,2,14,5
20091110-M-Paris_Masters-R32-Marat_Safin-Juan_Martin_Del_Potro,2,B-XC,25,1,0,0,1,13,12
20091110-M-Paris_Masters-R32-Marat_Safin-Juan_Martin_Del_Potro,2,B-DTM,21,2,0,1,1,14,7
20091110-M-Paris_Masters-R32-Marat_Safin-Juan_Martin_Del_Potro,2,B-DTL,5,2,0,2,0,4,1
20091110-M-Paris_Masters-R32-Marat_Safin-Juan_Martin_Del_Potro,2,B-IO,2,0,0,0,0,1,1
20091110-M-Paris_Masters-R32-Marat_Safin-Juan_Martin_Del_Potro,2,S-XC,3,0,0,0,0,0,3
20091110-M-Paris_Masters-R32-Marat_Safin-Juan_Martin_Del_Potro,2,S-DTL,1,1,0,1,0,1,0
20090531-M-French_Open-R16-Robin_Soderling-Rafael_Nadal,1,F-XC,112,23,10,3,10,64,48
20090531-M-French_Open-R16-Robin_Soderling-Rafael_Nadal,1,F-DTM,78,7,0,2,5,37,41
20090531-M-French_Open-R16-Robin_Soderling-Rafael_Nadal,1,F-DTL,24,12,3,1,8,13,11
20090531-M-French_Open-R16-Robin_Soderling-Rafael_Nadal,1,F-IO,72,40,14,11,15,41,31
20090531-M-French_Open-R16-Robin_Soderling-Rafael_Nadal,1,F-II,8,2,2,0,0,7,1
20090531-M-French_Open-R16-Robin_Soderling-Rafael_Nadal,1,B-XC,63,19,3,9,7,36,27
20090531-M-French_Open-R16-Robin_Soderling-Rafael_Nadal,1,B-DTM,70,10,0,1,9,27,43
20090531-M-French_Open-R16-Robin_Soderling-Rafael_Nadal,1,B-DTL,46,11,3,0,8,20,26
20090531-M-French_Open-R16-Robin_Soderling-Rafael_Nadal,1,B-IO,18,9,1,2,6,9,9
20090531-M-French_Open-R16-Robin_Soderling-Rafael_Nadal,1,S-XC,2,0,0,0,0,0,2
20090531-M-French_Open-R16-Robin_Soderling-Rafael_Nadal,1,S-DTM,5,1,0,1,0,3,2
20090531-M-French_Open-R16-Robin_Soderling-Rafael_Nadal,2,F-XC,120,13,4,4,5,64,56
20090531-M-French_Open-R16-Robin_Soderling-Rafael_Nadal,2,F-DTM,71,8,2,0,6,37,34
20090531-M-French_Open-R16-Robin_Soderling-Rafael_Nadal,2,F-DTL,23,7,7,0,0,15,8
20090531-M-French_Open-R16-Robin_Soderling-Rafael_Nadal,2,F-IO,57,14,8,0,6,28,29
20090531-M-French_Open-R16-Robin_Soderling-Rafael_Nadal,2,F-II,5,1,0,0,1,3,2
20090531-M-French_Open-R16-Robin_Soderling-Rafael_Nadal,2,B-XC,47,13,4,3,6,25,22
20090531-M-French_Open-R16-Robin_Soderling-Rafael_Nadal,2,B-DTM,62,4,0,1,3,30,32
20090531-M-French_Open-R16-Robin_Soderling-Rafael_Nadal,2,B-DTL,20,4,2,0,2,8,12
20090531-M-French_Open-R16-Robin_Soderling-Rafael_Nadal,2,B-IO,2,0,0,0,0,0,2
20090531-M-French_Open-R16-Robin_Soderling-Rafael_Nadal,2,B-II,1,0,0,0,0,1,0
20090531-M-French_Open-R16-Robin_Soderling-Rafael_Nadal,2,S-XC,7,0,0,0,0,3,4
20090531-M-French_Open-R16-Robin_Soderling-Rafael_Nadal,2,S-DTM,34,2,0,1,1,11,23
20090531-M-French_Open-R16-Robin_Soderling-Rafael_Nadal,2,S-DTL,4,0,0,0,0,2,2
20090531-M-French_Open-R16-Robin_Soderling-Rafael_Nadal,2,S-IO,3,0,0,0,0,3,0
20090531-M-French_Open-R16-Robin_Soderling-Rafael_Nadal,2,S-II,2,0,0,0,0,1,1
20091018-M-Shanghai_Masters-F-Rafael_Nadal-Nikolay_Davydenko,1,F-XC,63,5,2,1,2,34,29
20091018-M-Shanghai_Masters-F-Rafael_Nadal-Nikolay_Davydenko,1,F-DTM,47,1,0,0,1,16,31
20091018-M-Shanghai_Masters-F-Rafael_Nadal-Nikolay_Davydenko,1,F-DTL,11,3,1,1,1,6,5
20091018-M-Shanghai_Masters-F-Rafael_Nadal-Nikolay_Davydenko,1,F-IO,23,3,0,1,2,12,11
20091018-M-Shanghai_Masters-F-Rafael_Nadal-Nikolay_Davydenko,1,F-II,3,0,0,0,0,2,1
20091018-M-Shanghai_Masters-F-Rafael_Nadal-Nikolay_Davydenko,1,B-XC,57,5,0,1,4,21,36
20091018-M-Shanghai_Masters-F-Rafael_Nadal-Nikolay_Davydenko,1,B-DTM,63,6,0,0,6,26,37
20091018-M-Shanghai_Masters-F-Rafael_Nadal-Nikolay_Davydenko,1,B-DTL,7,1,0,0,1,2,5
20091018-M-Shanghai_Masters-F-Rafael_Nadal-Nikolay_Davydenko,1,B-IO,6,1,0,0,1,4,2
20091018-M-Shanghai_Masters-F-Rafael_Nadal-Nikolay_Davydenko,1,S-XC,7,1,0,0,1,3,4
20091018-M-Shanghai_Masters-F-Rafael_Nadal-Nikolay_Davydenko,1,S-DTM,42,3,0,0,3,15,27
20091018-M-Shanghai_Masters-F-Rafael_Nadal-Nikolay_Davydenko,1,S-DTL,3,0,0,0,0,2,1
20091018-M-Shanghai_Masters-F-Rafael_Nadal-Nikolay_Davydenko,1,S-IO,1,0,0,0,0,0,1
20091018-M-Shanghai_Masters-F-Rafael_Nadal-Nikolay_Davydenko,2,F-XC,135,21,4,3,14,85,50
20091018-M-Shanghai_Masters-F-Rafael_Nadal-Nikolay_Davydenko,2,F-DTM,39,5,0,0,5,18,21
20091018-M-Shanghai_Masters-F-Rafael_Nadal-Nikolay_Davydenko,2,F-DTL,15,10,3,2,5,7,8
20091018-M-Shanghai_Masters-F-Rafael_Nadal-Nikolay_Davydenko,2,F-IO,34,12,6,0,6,20,14
20091018-M-Shanghai_Masters-F-Rafael_Nadal-Nikolay_Davydenko,2,F-II,1,0,0,0,0,1,0
20091018-M-Shanghai_Masters-F-Rafael_Nadal-Nikolay_Davydenko,2,B-XC,51,9,3,2,4,26,25
20091018-M-Shanghai_Masters-F-Rafael_Nadal-Nikolay_Davydenko,2,B-DTM,57,1,0,0,1,30,27
20091018-M-Shanghai_Masters-F-Rafael_Nadal-Nikolay_Davydenko,2,B-DTL,12,5,4,0,1,6,6
20091018-M-Shanghai_Masters-F-Rafael_Nadal-Nikolay_Davydenko,2,B-IO,8,0,0,0,0,6,2
20091018-M-Shanghai_Masters-F-Rafael_Nadal-Nikolay_Davydenko,2,B-II,1,0,0,0,0,1,0
20091018-M-Shanghai_Masters-F-Rafael_Nadal-Nikolay_Davydenko,2,S-DTM,1,0,0,0,0,1,0
20091018-M-Shanghai_Masters-F-Rafael_Nadal-Nikolay_Davydenko,2,S-DTL,1,0,0,0,0,0,1
20100131-M-Australian_Open-F-Roger_Federer-Andy_Murray,1,F-XC,61,22,7,5,10,35,26
20100131-M-Australian_Open-F-Roger_Federer-Andy_Murray,1,F-DTM,45,3,0,0,3,22,23
20100131-M-Australian_Open-F-Roger_Federer-Andy_Murray,1,F-DTL,11,2,0,1,1,6,5
20100131-M-Australian_Open-F-Roger_Federer-Andy_Murray,1,F-IO,51,15,9,2,4,34,17
20100131-M-Australian_Open-F-Roger_Federer-Andy_Murray,1,F-II,4,1,1,0,0,2,2
20100131-M-Australian_Open-F-Roger_Federer-Andy_Murray,1,B-XC,63,9,3,3,3,37,26
20100131-M-Australian_Open-F-Roger_Federer-Andy_Murray,1,B-DTM,97,12,0,0,12,47,50
20100131-M-Australian_Open-F-Roger_Federer-Andy_Murray,1,B-DTL,8,3,1,0,2,4,4
20100131-M-Australian_Open-F-Roger_Federer-Andy_Murray,1,B-IO,4,0,0,0,0,2,2
20100131-M-Australian_Open-F-Roger_Federer-Andy_Murray,1,B-II,1,0,0,0,0,1,0
20100131-M-Australian_Open-F-Roger_Federer-Andy_Murray,1,S-XC,29,2,0,0,2,12,17
20100131-M-Australian_Open-F-Roger_Federer-Andy_Murray,1,S-DTM,40,3,1,0,2,18,22
20100131-M-Australian_Open-F-Roger_Federer-Andy_Murray,1,S-DTL,2,0,0,0,0,0,2
20100131-M-Australian_Open-F-Roger_Federer-Andy_Murray,1,S-IO,2,0,0,0,0,1,1
20100131-M-Australian_Open-F-Roger_Federer-Andy_Murray,2,F-XC,71,25,7,6,12,36,35
20100131-M-Australian_Open-F-Roger_Federer-Andy_Murray,2,F-DTM,60,2,0,0,2,31,29
20100131-M-Australian_Open-F-Roger_Federer-Andy_Murray,2,F-DTL,18,4,0,0,4,8,10
20100131-M-Australian_Open-F-Roger_Federer-Andy_Murray,2,F-IO,35,4,1,2,1,21,14
20100131-M-Australian_Open-F-Roger_Federer-Andy_Murray,2,F-II,3,1,0,0,1,0,3
20100131-M-Australian_Open-F-Roger_Federer-Andy_Murray,2,B-XC,94,7,1,1,5,48,46
20100131-M-Australian_Open-F-Roger_Federer-Andy_Murray,2,B-DTM,82,2,0,0,2,33,49
20100131-M-Australian_Open-F-Roger_Federer-Andy_Murray,2,B-DTL,15,9,5,1,3,10,5
20100131-M-Australian_Open-F-Roger_Federer-Andy_Murray,2,B-IO,4,2,0,1,1,2,2
20100131-M-Australian_Open-F-Roger_Federer-Andy_Murray,2,S-XC,14,3,0,1,2,7,7
20100131-M-Australian_Open-F-Roger_Federer-Andy_Murray,2,S-DTM,15,0,0,0,0,5,10
20100131-M-Australian_Open-F-Roger_Federer-Andy_Murray,2,S-DTL,2,0,0,0,0,1,1
20100131-M-Australian_Open-F-Roger_Federer-Andy_Murray,2,S-IO,1,0,0,0,0,0,1
20110603-M-Roland_Garros-SF-Novak_Djokovic-Roger_Federer,1,F-XC,107,31,12,12,7,60,47
20110603-M-Roland_Garros-SF-Novak_Djokovic-Roger_Federer,1,F-DTM,75,10,1,2,7,36,39
20110603-M-Roland_Garros-SF-Novak_Djokovic-Roger_Federer,1,F-DTL,22,5,1,0,4,9,13
20110603-M-Roland_Garros-SF-Novak_Djokovic-Roger_Federer,1,F-IO,92,23,8,6,9,63,29
20110603-M-Roland_Garros-SF-Novak_Djokovic-Roger_Federer,1,F-II,4,1,1,0,0,2,2
20110603-M-Roland_Garros-SF-Novak_Djokovic-Roger_Federer,1,B-XC,100,19,4,2,13,56,44
20110603-M-Roland_Garros-SF-Novak_Djokovic-Roger_Federer,1,B-DTM,75,5,1,3,1,44,31
20110603-M-Roland_Garros-SF-Novak_Djokovic-Roger_Federer,1,B-DTL,9,2,1,0,1,2,7
20110603-M-Roland_Garros-SF-Novak_Djokovic-Roger_Federer,1,B-IO,8,4,2,1,1,4,4
20110603-M-Roland_Garros-SF-Novak_Djokovic-Roger_Federer,1,S-XC,5,0,0,0,0,2,3
20110603-M-Roland_Garros-SF-Novak_Djokovic-Roger_Federer,1,S-DTM,8,0,0,0,0,3,5
20110603-M-Roland_Garros-SF-Novak_Djokovic-Roger_Federer,1,S-DTL,1,1,0,0,1,0,1
20110603-M-Roland_Garros-SF-Novak_Djokovic-Roger_Federer,1,S-II,1,0,0,0,0,1,0
20110603-M-Roland_Garros-SF-Novak_Djokovic-Roger_Federer,2,F-XC,83,19,7,7,5,49,34
20110603-M-Roland_Garros-SF-Novak_Djokovic-Roger_Federer,2,F-DTM,80,7,0,0,7,27,53
20110603-M-Roland_Garros-SF-Novak_Djokovic-Roger_Federer,2,F-DTL,15,6,3,3,0,9,6
20110603-M-Roland_Garros-SF-Novak_Djokovic-Roger_Federer,2,F-IO,37,10,4,2,4,23,14
20110603-M-Roland_Garros-SF-Novak_Djokovic-Roger_Federer,2,F-II,8,3,1,1,1,4,4
20110603-M-Roland_Garros-SF-Novak_Djokovic-Roger_Federer,2,B-XC,51,16,2,4,10,26,25
20110603-M-Roland_Garros-SF-Novak_Djokovic-Roger_Federer,2,B-DTM,101,7,0,0,7,31,70
20110603-M-Roland_Garros-SF-Novak_Djokovic-Roger_Federer,2,B-DTL,22,10,5,1,4,11,11
20110603-M-Roland_Garros-SF-Novak_Djokovic-Roger_Federer,2,B-IO,8,1,1,0,0,6,2
20110603-M-Roland_Garros-SF-Novak_Djokovic-Roger_Federer,2,S-XC,27,1,0,0,1,7,20
20110603-M-Roland_Garros-SF-Novak_Djokovic-Roger_Federer,2,S-DTM,25,1,0,0,1,9,16
20110603-M-Roland_Garros-SF-Novak_Djokovic-Roger_Federer,2,S-DTL,4,0,0,0,0,2,2
20110603-M-Roland_Garros-SF-Novak_Djokovic-Roger_Federer,2,S-II,1,0,0,0,0,1,0
20111122-M-Tour_Finals-RR-Roger_Federer-Rafael_Nadal,1,F-XC,38,11,5,2,4,29,9
20111122-M-Tour_Finals-RR-Roger_Federer-Rafael_Nadal,1,F-DTM,16,0,0,0,0,9,7
20111122-M-Tour_Finals-RR-Roger_Federer-Rafael_Nadal,1,F-DTL,7,4,4,0,0,7,0
20111122-M-Tour_Finals-RR-Roger_Federer-Rafael_Nadal,1,F-IO,11,7,6,1,0,10,1
20111122-M-Tour_Finals-RR-Roger_Federer-Rafael_Nadal,1,F-II,4,1,0,1,0,4,0
20111122-M-Tour_Finals-RR-Roger_Federer-Rafael_Nadal,1,B-XC,18,7,2,1,4,10,8
20111122-M-Tour_Finals-RR-Roger_Federer-Rafael_Nadal,1,B-DTM,14,1,0,0,1,11,3
20111122-M-Tour_Finals-RR-Roger_Federer-Rafael_Nadal,1,B-DTL,7,1,1,0,0,6,1
20111122-M-Tour_Finals-RR-Roger_Federer-Rafael_Nadal,1,B-IO,4,0,0,0,0,4,0
20111122-M-Tour_Finals-RR-Roger_Federer-Rafael_Nadal,1,S-XC,3,0,0,0,0,3,0
20111122-M-Tour_Finals-RR-Roger_Federer-Rafael_Nadal,1,S-DTM,1,0,0,0,0,0,1
20111122-M-Tour_Finals-RR-Roger_Federer-Rafael_Nadal,1,S-DTL,9,0,0,0,0,7,2
20111122-M-Tour_Finals-RR-Roger_Federer-Rafael_Nadal,2,F-XC,27,2,0,1,1,11,16
20111122-M-Tour_Finals-RR-Roger_Federer-Rafael_Nadal,2,F-DTM,23,3,0,0,3,6,17
20111122-M-Tour_Finals-RR-Roger_Federer-Rafael_Nadal,2,F-DTL,6,2,0,1,1,4,2
20111122-M-Tour_Finals-RR-Roger_Federer-Rafael_Nadal,2,F-IO,15,4,2,0,2,3,12
20111122-M-Tour_Finals-RR-Roger_Federer-Rafael_Nadal,2,F-II,2,0,0,0,0,0,2
20111122-M-Tour_Finals-RR-Roger_Federer-Rafael_Nadal,2,B-XC,14,4,0,0,4,1,13
20111122-M-Tour_Finals-RR-Roger_Federer-Rafael_Nadal,2,B-DTM,22,1,0,0,1,4,18
20111122-M-Tour_Finals-RR-Roger_Federer-Rafael_Nadal,2,B-DTL,12,3,1,0,2,3,9
20111122-M-Tour_Finals-RR-Roger_Federer-Rafael_Nadal,2,B-IO,2,0,0,0,0,1,1
20111122-M-Tour_Finals-RR-Roger_Federer-Rafael_Nadal,2,S-XC,1,0,0,0,0,1,0
20111122-M-Tour_Finals-RR-Roger_Federer-Rafael_Nadal,2,S-DTM,2,0,0,0,0,0,2
20111122-M-Tour_Finals-RR-Roger_Federer-Rafael_Nadal,2,S-DTL,3,0,0,0,0,0,3
20120129-M-Australian_Open-F-Novak_Djokovic-Rafael_Nadal,1,F-XC,171,23,8,4,11,81,90
20120129-M-Australian_Open-F-Novak_Djokovic-Rafael_Nadal,1,F-DTM,97,2,0,1,1,52,45
20120129-M-Australian_Open-F-Novak_Djokovic-Rafael_Nadal,1,F-DTL,34,15,5,4,6,21,13
20120129-M-Australian_Open-F-Novak_Djokovic-Rafael_Nadal,1,F-IO,98,33,10,10,13,57,41
20120129-M-Australian_Open-F-Novak_Djokovic-Rafael_Nadal,1,F-II,8,1,1,0,0,5,3
20120129-M-Australian_Open-F-Novak_Djokovic-Rafael_Nadal,1,B-XC,105,17,1,7,9,51,54
20120129-M-Australian_Open-F-Novak_Djokovic-Rafael_Nadal,1,B-DTM,93,9,0,2,7,48,45
20120129-M-Australian_Open-F-Novak_Djokovic-Rafael_Nadal,1,B-DTL,52,11,5,1,5,32,20
20120129-M-Australian_Open-F-Novak_Djokovic-Rafael_Nadal,1,B-IO,34,4,1,1,2,15,19
20120129-M-Australian_Open-F-Novak_Djokovic-Rafael_Nadal,1,S-XC,1,0,0,0,0,1,0
20120129-M-Australian_Open-F-Novak_Djokovic-Rafael_Nadal,1,S-DTM,3,0,0,0,0,0,3
20120129-M-Australian_Open-F-Novak_Djokovic-Rafael_Nadal,1,S-DTL,3,0,0,0,0,2,1
20120129-M-Australian_Open-F-Novak_Djokovic-Rafael_Nadal,1,S-IO,1,0,0,0,0,0,1
20120129-M-Australian_Open-F-Novak_Djokovic-Rafael_Nadal,2,F-XC,105,17,2,4,11,43,62
20120129-M-Australian_Open-F-Novak_Djokovic-Rafael_Nadal,2,F-DTM,121,5,0,1,4,62,59
20120129-M-Australian_Open-F-Novak_Djokovic-Rafael_Nadal,2,F-DTL,40,14,3,5,6,21,19
20120129-M-Australian_Open-F-Novak_Djokovic-Rafael_Nadal,2,F-IO,83,29,15,6,8,50,33
20120129-M-Australian_Open-F-Novak_Djokovic-Rafael_Nadal,2,F-II,4,1,0,0,1,2,2
20120129-M-Australian_Open-F-Novak_Djokovic-Rafael_Nadal,2,B-XC,89,12,1,2,9,48,41
20120129-M-Australian_Open-F-Novak_Djokovic-Rafael_Nadal,2,B-DTM,86,6,0,0,6,39,47
20120129-M-Australian_Open-F-Novak_Djokovic-Rafael_Nadal,2,B-DTL,35,9,3,3,3,18,17
20120129-M-Australian_Open-F-Novak_Djokovic-Rafael_Nadal,2,B-IO,17,1,0,1,0,9,8
20120129-M-Australian_Open-F-Novak_Djokovic-Rafael_Nadal,2,B-II,1,1,0,0,1,0,1
20120129-M-Australian_Open-F-Novak_Djokovic-Rafael_Nadal,2,S-XC,3,1,0,0,1,1,2
20120129-M-Australian_Open-F-Novak_Djokovic-Rafael_Nadal,2,S-DTM,65,3,0,0,3,26,39
20120129-M-Australian_Open-F-Novak_Djokovic-Rafael_Nadal,2,S-DTL,37,0,0,0,0,19,18
20120129-M-Australian_Open-F-Novak_Djokovic-Rafael_Nadal,2,S-IO,10,1,0,1,0,4,6
20120129-M-Australian_Open-F-Novak_Djokovic-Rafael_Nadal,2,S-II,2,0,0,0,0,1,1
20120505-M-Belgrade-SF-Benoit_Paire-Pablo_Andujar,1,F-XC,31,10,3,1,6,13,18
20120505-M-Belgrade-SF-Benoit_Paire-Pablo_Andujar,1,F-DTM,34,4,0,0,4,12,22
20120505-M-Belgrade-SF-Benoit_Paire-Pablo_Andujar,1,F-DTL,14,5,1,0,4,3,11
20120505-M-Belgrade-SF-Benoit_Paire-Pablo_Andujar,1,F-IO,12,6,3,1,2,7,5
20120505-M-Belgrade-SF-Benoit_Paire-Pablo_Andujar,1,B-XC,43,14,4,3,7,19,24
20120505-M-Belgrade-SF-Benoit_Paire-Pablo_Andujar,1,B-DTM,30,6,0,0,6,8,22
20120505-M-Belgrade-SF-Benoit_Paire-Pablo_Andujar,1,B-DTL,11,7,2,0,5,2,9
20120505-M-Belgrade-SF-Benoit_Paire-Pablo_Andujar,1,B-IO,12,7,4,1,2,7,5
20120505-M-Belgrade-SF-Benoit_Paire-Pablo_Andujar,1,S-XC,1,1,1,0,0,1,0
20120505-M-Belgrade-SF-Benoit_Paire-Pablo_Andujar,1,S-DTM,2,0,0,0,0,0,2
20120505-M-Belgrade-SF-Benoit_Paire-Pablo_Andujar,1,S-DTL,1,0,0,0,0,0,1
20120505-M-Belgrade-SF-Benoit_Paire-Pablo_Andujar,2,F-XC,31,5,2,1,2,18,13
20120505-M-Belgrade-SF-Benoit_Paire-Pablo_Andujar,2,F-DTM,24,2,0,0,2,13,11
20120505-M-Belgrade-SF-Benoit_Paire-Pablo_Andujar,2,F-DTL,7,2,1,0,1,5,2
20120505-M-Belgrade-SF-Benoit_Paire-Pablo_Andujar,2,F-IO,16,5,2,2,1,10,6
20120505-M-Belgrade-SF-Benoit_Paire-Pablo_Andujar,2,B-XC,28,2,0,0,2,19,9
20120505-M-Belgrade-SF-Benoit_Paire-Pablo_Andujar,2,B-DTM,46,2,0,0,2,29,17
20120505-M-Belgrade-SF-Benoit_Paire-Pablo_Andujar,2,B-DTL,8,5,0,2,3,4,4
20120505-M-Belgrade-SF-Benoit_Paire-Pablo_Andujar,2,B-IO,13,2,0,0,2,7,6
20120505-M-Belgrade-SF-Benoit_Paire-Pablo_Andujar,2,S-XC,3,0,0,0,0,0,3
20120505-M-Belgrade-SF-Benoit_Paire-Pablo_Andujar,2,S-DTM,3,0,0,0,0,1,2
20120505-M-Belgrade-SF-Benoit_Paire-Pablo_Andujar,2,S-IO,1,1,0,1,0,1,0
20120817-M-Cincinnati_Masters-SF-Roger_Federer-Stanislas_Wawrinka,1,F-XC,30,10,6,2,2,23,7
20120817-M-Cincinnati_Masters-SF-Roger_Federer-Stanislas_Wawrinka,1,F-DTM,25,2,0,1,1,16,9
20120817-M-Cincinnati_Masters-SF-Roger_Federer-Stanislas_Wawrinka,1,F-DTL,3,1,0,1,0,2,1
20120817-M-Cincinnati_Masters-SF-Roger_Federer-Stanislas_Wawrinka,1,F-IO,27,12,3,5,4,18,9
20120817-M-Cincinnati_Masters-SF-Roger_Federer-Stanislas_Wawrinka,1,F-II,5,2,0,2,0,3,2
20120817-M-Cincinnati_Masters-SF-Roger_Federer-Stanislas_Wawrinka,1,B-XC,12,1,1,0,0,6,6
20120817-M-Cincinnati_Masters-SF-Roger_Federer-Stanislas_Wawrinka,1,B-DTM,18,4,0,1,3,7,11
20120817-M-Cincinnati_Masters-SF-Roger_Federer-Stanislas_Wawrinka,1,B-DTL,4,3,3,0,0,4,0
20120817-M-Cincinnati_Masters-SF-Roger_Federer-Stanislas_Wawrinka,1,B-IO,1,0,0,0,0,1,0
20120817-M-Cincinnati_Masters-SF-Roger_Federer-Stanislas_Wawrinka,1,S-XC,7,0,0,0,0,3,4
20120817-M-Cincinnati_Masters-SF-Roger_Federer-Stanislas_Wawrinka,1,S-DTM,7,0,0,0,0,2,5
20120817-M-Cincinnati_Masters-SF-Roger_Federer-Stanislas_Wawrinka,1,S-IO,1,1,0,0,1,0,1
20120817-M-Cincinnati_Masters-SF-Roger_Federer-Stanislas_Wawrinka,2,F-XC,31,11,3,3,5,13,18
20120817-M-Cincinnati_Masters-SF-Roger_Federer-Stanislas_Wawrinka,2,F-DTM,17,3,0,0,3,4,13
20120817-M-Cincinnati_Masters-SF-Roger_Federer-Stanislas_Wawrinka,2,F-DTL,3,2,0,1,1,2,1
20120817-M-Cincinnati_Masters-SF-Roger_Federer-Stanislas_Wawrinka,2,F-IO,15,4,2,2,0,11,4
20120817-M-Cincinnati_Masters-SF-Roger_Federer-Stanislas_Wawrinka,2,B-XC,29,7,2,0,5,16,13
20120817-M-Cincinnati_Masters-SF-Roger_Federer-Stanislas_Wawrinka,2,B-DTM,20,2,0,0,2,10,10
20120817-M-Cincinnati_Masters-SF-Roger_Federer-Stanislas_Wawrinka,2,B-DTL,9,6,0,2,4,3,6
20120817-M-Cincinnati_Masters-SF-Roger_Federer-Stanislas_Wawrinka,2,B-IO,1,0,0,0,0,0,1
20120817-M-Cincinnati_Masters-SF-Roger_Federer-Stanislas_Wawrinka,2,S-XC,11,2,0,1,1,5,6
20120817-M-Cincinnati_Masters-SF-Roger_Federer-Stanislas_Wawrinka,2,S-DTM,8,0,0,0,0,2,6
20120817-M-Cincinnati_Masters-SF-Roger_Federer-Stanislas_Wawrinka,2,S-DTL,1,0,0,0,0,0,1
20120817-M-Cincinnati_Masters-SF-Roger_Federer-Stanislas_Wawrinka,2,S-IO,1,0,0,0,0,0,1
20120817-M-Cincinnati_Masters-SF-Roger_Federer-Stanislas_Wawrinka,2,S-II,1,1,0,0,1,0,1
20120818-M-Cincinnati_Masters-F-Novak_Djokovic-Roger_Federer,1,F-XC,29,11,5,4,2,16,13
20120818-M-Cincinnati_Masters-F-Novak_Djokovic-Roger_Federer,1,F-DTM,21,3,0,0,3,5,16
20120818-M-Cincinnati_Masters-F-Novak_Djokovic-Roger_Federer,1,F-DTL,6,3,2,0,1,3,3
20120818-M-Cincinnati_Masters-F-Novak_Djokovic-Roger_Federer,1,F-IO,12,3,0,0,3,5,7
20120818-M-Cincinnati_Masters-F-Novak_Djokovic-Roger_Federer,1,F-II,2,1,0,1,0,1,1
20120818-M-Cincinnati_Masters-F-Novak_Djokovic-Roger_Federer,1,B-XC,31,5,1,1,3,15,16
20120818-M-Cincinnati_Masters-F-Novak_Djokovic-Roger_Federer,1,B-DTM,27,3,0,1,2,14,13
20120818-M-Cincinnati_Masters-F-Novak_Djokovic-Roger_Federer,1,B-DTL,5,1,1,0,0,3,2
20120818-M-Cincinnati_Masters-F-Novak_Djokovic-Roger_Federer,1,B-IO,4,2,0,0,2,0,4
20120818-M-Cincinnati_Masters-F-Novak_Djokovic-Roger_Federer,1,S-XC,1,0,0,0,0,0,1
20120818-M-Cincinnati_Masters-F-Novak_Djokovic-Roger_Federer,1,S-DTM,5,0,0,0,0,1,4
20120818-M-Cincinnati_Masters-F-Novak_Djokovic-Roger_Federer,1,S-DTL,1,1,0,0,1,0,1
20120818-M-Cincinnati_Masters-F-Novak_Djokovic-Roger_Federer,2,F-XC,41,12,5,3,4,27,14
20120818-M-Cincinnati_Masters-F-Novak_Djokovic-Roger_Federer,2,F-DTM,15,1,0,0,1,12,3
20120818-M-Cincinnati_Masters-F-Novak_Djokovic-Roger_Federer,2,F-DTL,11,2,2,0,0,7,4
20120818-M-Cincinnati_Masters-F-Novak_Djokovic-Roger_Federer,2,F-IO,24,10,3,3,4,13,11
20120818-M-Cincinnati_Masters-F-Novak_Djokovic-Roger_Federer,2,F-II,1,0,0,0,0,1,0
20120818-M-Cincinnati_Masters-F-Novak_Djokovic-Roger_Federer,2,B-XC,18,3,1,0,2,10,8
20120818-M-Cincinnati_Masters-F-Novak_Djokovic-Roger_Federer,2,B-DTM,12,0,0,0,0,7,5
20120818-M-Cincinnati_Masters-F-Novak_Djokovic-Roger_Federer,2,B-DTL,5,1,0,0,1,2,3
20120818-M-Cincinnati_Masters-F-Novak_Djokovic-Roger_Federer,2,S-XC,9,2,0,0,2,4,5
20120818-M-Cincinnati_Masters-F-Novak_Djokovic-Roger_Federer,2,S-IO,1,1,0,1,0,1,0
20120301-M-Delray_Beach-R16-Bernard_Tomic-Tim_Smyczek,1,F-XC,28,7,2,2,3,17,11
20120301-M-Delray_Beach-R16-Bernard_Tomic-Tim_Smyczek,1,F-DTM,31,5,0,1,4,14,17
20120301-M-Delray_Beach-R16-Bernard_Tomic-Tim_Smyczek,1,F-DTL,5,4,1,2,1,4,1
20120301-M-Delray_Beach-R16-Bernard_Tomic-Tim_Smyczek,1,F-IO,19,2,0,0,2,8,11
20120301-M-Delray_Beach-R16-Bernard_Tomic-Tim_Smyczek,1,F-II,1,1,1,0,0,1,0
20120301-M-Delray_Beach-R16-Bernard_Tomic-Tim_Smyczek,1,B-XC,25,3,0,0,3,11,14
20120301-M-Delray_Beach-R16-Bernard_Tomic-Tim_Smyczek,1,B-DTM,17,1,0,0,1,11,6
20120301-M-Delray_Beach-R16-Bernard_Tomic-Tim_Smyczek,1,B-DTL,2,1,0,0,1,0,2
20120301-M-Delray_Beach-R16-Bernard_Tomic-Tim_Smyczek,1,S-XC,19,1,0,0,1,8,11
20120301-M-Delray_Beach-R16-Bernard_Tomic-Tim_Smyczek,1,S-DTM,24,3,1,1,1,11,13
20120301-M-Delray_Beach-R16-Bernard_Tomic-Tim_Smyczek,1,S-DTL,1,0,0,0,0,1,0
20120301-M-Delray_Beach-R16-Bernard_Tomic-Tim_Smyczek,1,S-IO,4,0,0,0,0,4,0
20120301-M-Delray_Beach-R16-Bernard_Tomic-Tim_Smyczek,2,F-XC,23,4,0,0,4,6,17
20120301-M-Delray_Beach-R16-Bernard_Tomic-Tim_Smyczek,2,F-DTM,34,3,0,0,3,14,20
20120301-M-Delray_Beach-R16-Bernard_Tomic-Tim_Smyczek,2,F-DTL,2,1,1,0,0,2,0
20120301-M-Delray_Beach-R16-Bernard_Tomic-Tim_Smyczek,2,F-IO,19,5,1,2,2,12,7
20120301-M-Delray_Beach-R16-Bernard_Tomic-Tim_Smyczek,2,F-II,2,0,0,0,0,1,1
20120301-M-Delray_Beach-R16-Bernard_Tomic-Tim_Smyczek,2,B-XC,41,6,0,0,6,17,24
20120301-M-Delray_Beach-R16-Bernard_Tomic-Tim_Smyczek,2,B-DTM,27,2,1,0,1,16,11
20120301-M-Delray_Beach-R16-Bernard_Tomic-Tim_Smyczek,2,B-DTL,4,4,3,0,1,3,1
20120301-M-Delray_Beach-R16-Bernard_Tomic-Tim_Smyczek,2,B-IO,8,2,1,0,1,4,4
20120301-M-Delray_Beach-R16-Bernard_Tomic-Tim_Smyczek,2,S-XC,6,2,0,0,2,1,5
20120301-M-Delray_Beach-R16-Bernard_Tomic-Tim_Smyczek,2,S-DTM,8,0,0,0,0,3,5
20120301-M-Delray_Beach-R16-Bernard_Tomic-Tim_Smyczek,2,S-DTL,2,0,0,0,0,2,0
20120301-M-Delray_Beach-R16-Bernard_Tomic-Tim_Smyczek,2,S-IO,1,0,0,0,0,0,1
20120303-M-Dubai-F-Andy_Murray-Roger_Federer,1,F-XC,17,5,2,1,2,10,7
20120303-M-Dubai-F-Andy_Murray-Roger_Federer,1,F-DTM,27,3,0,1,2,14,13
20120303-M-Dubai-F-Andy_Murray-Roger_Federer,1,F-DTL,5,2,0,0,2,1,4
20120303-M-Dubai-F-Andy_Murray-Roger_Federer,1,F-IO,18,2,1,1,0,8,10
20120303-M-Dubai-F-Andy_Murray-Roger_Federer,1,B-XC,27,11,2,1,8,10,17
20120303-M-Dubai-F-Andy_Murray-Roger_Federer,1,B-DTM,41,5,0,2,3,17,24
20120303-M-Dubai-F-Andy_Murray-Roger_Federer,1,B-DTL,7,5,2,1,2,5,2
20120303-M-Dubai-F-Andy_Murray-Roger_Federer,1,B-IO,3,1,0,0,1,1,2
20120303-M-Dubai-F-Andy_Murray-Roger_Federer,1,S-XC,6,0,0,0,0,2,4
20120303-M-Dubai-F-Andy_Murray-Roger_Federer,1,S-DTM,3,0,0,0,0,0,3
20120303-M-Dubai-F-Andy_Murray-Roger_Federer,1,S-DTL,4,0,0,0,0,2,2
20120303-M-Dubai-F-Andy_Murray-Roger_Federer,2,F-XC,25,12,4,3,5,17,8
20120303-M-Dubai-F-Andy_Murray-Roger_Federer,2,F-DTM,30,1,0,0,1,14,16
20120303-M-Dubai-F-Andy_Murray-Roger_Federer,2,F-DTL,10,3,1,0,2,5,5
20120303-M-Dubai-F-Andy_Murray-Roger_Federer,2,F-IO,33,12,4,5,2,25,8
20120303-M-Dubai-F-Andy_Murray-Roger_Federer,2,F-II,1,0,0,0,0,0,1
20120303-M-Dubai-F-Andy_Murray-Roger_Federer,2,B-XC,11,2,1,1,0,6,5
20120303-M-Dubai-F-Andy_Murray-Roger_Federer,2,B-DTM,19,2,0,0,2,13,6
20120303-M-Dubai-F-Andy_Murray-Roger_Federer,2,B-DTL,4,2,1,0,1,2,2
20120303-M-Dubai-F-Andy_Murray-Roger_Federer,2,B-IO,2,2,0,1,1,1,1
20120303-M-Dubai-F-Andy_Murray-Roger_Federer,2,S-XC,9,0,0,0,0,4,5
20120303-M-Dubai-F-Andy_Murray-Roger_Federer,2,S-DTM,8,2,0,0,2,3,5
20120720-M-Hamburg-QF-Jeremy_Chardy-Juan_Monaco,1,F-XC,35,7,0,2,5,15,20
20120720-M-Hamburg-QF-Jeremy_Chardy-Juan_Monaco,1,F-DTM,33,1,0,0,1,15,18
20120720-M-Hamburg-QF-Jeremy_Chardy-Juan_Monaco,1,F-DTL,7,2,0,0,2,3,4
20120720-M-Hamburg-QF-Jeremy_Chardy-Juan_Monaco,1,F-IO,41,10,2,1,7,21,20
20120720-M-Hamburg-QF-Jeremy_Chardy-Juan_Monaco,1,F-II,6,5,1,1,3,2,4
20120720-M-Hamburg-QF-Jeremy_Chardy-Juan_Monaco,1,B-XC,32,5,0,1,4,12,20
20120720-M-Hamburg-QF-Jeremy_Chardy-Juan_Monaco,1,B-DTM,26,4,0,0,4,11,15
20120720-M-Hamburg-QF-Jeremy_Chardy-Juan_Monaco,1,B-DTL,8,6,2,1,3,4,4
20120720-M-Hamburg-QF-Jeremy_Chardy-Juan_Monaco,1,B-IO,2,2,0,0,2,0,2
20120720-M-Hamburg-QF-Jeremy_Chardy-Juan_Monaco,1,S-XC,22,3,0,0,3,10,12
20120720-M-Hamburg-QF-Jeremy_Chardy-Juan_Monaco,1,S-DTM,7,1,0,0,1,3,4
20120720-M-Hamburg-QF-Jeremy_Chardy-Juan_Monaco,1,S-DTL,4,0,0,0,0,1,3
20120720-M-Hamburg-QF-Jeremy_Chardy-Juan_Monaco,1,S-IO,1,1,0,0,1,0,1
20120720-M-Hamburg-QF-Jeremy_Chardy-Juan_Monaco,2,F-XC,21,7,2,0,5,9,12
20120720-M-Hamburg-QF-Jeremy_Chardy-Juan_Monaco,2,F-DTM,46,1,0,0,1,31,15
20120720-M-Hamburg-QF-Jeremy_Chardy-Juan_Monaco,2,F-DTL,10,4,1,2,1,4,6
20120720-M-Hamburg-QF-Jeremy_Chardy-Juan_Monaco,2,F-IO,29,2,1,0,1,14,15
20120720-M-Hamburg-QF-Jeremy_Chardy-Juan_Monaco,2,F-II,5,1,1,0,0,3,2
20120720-M-Hamburg-QF-Jeremy_Chardy-Juan_Monaco,2,B-XC,44,5,0,2,3,25,19
20120720-M-Hamburg-QF-Jeremy_Chardy-Juan_Monaco,2,B-DTM,38,2,0,0,2,18,20
20120720-M-Hamburg-QF-Jeremy_Chardy-Juan_Monaco,2,B-DTL,2,2,0,1,1,1,1
20120720-M-Hamburg-QF-Jeremy_Chardy-Juan_Monaco,2,B-IO,1,1,0,0,1,0,1
20120720-M-Hamburg-QF-Jeremy_Chardy-Juan_Monaco,2,S-XC,4,2,0,1,1,2,2
20120720-M-Hamburg-QF-Jeremy_Chardy-Juan_Monaco,2,S-DTM,6,0,0,0,0,3,3
20120720-M-Hamburg-QF-Jeremy_Chardy-Juan_Monaco,2,S-DTL,2,0,0,0,0,1,1
20120316-M-Indian_Wells_Masters-SF-Roger_Federer-Rafael_Nadal,1,F-XC,54,12,1,9,2,42,12
20120316-M-Indian_Wells_Masters-SF-Roger_Federer-Rafael_Nadal,1,F-DTM,35,2,0,1,1,17,18
20120316-M-Indian_Wells_Masters-SF-Roger_Federer-Rafael_Nadal,1,F-DTL,4,2,2,0,0,4,0
20120316-M-Indian_Wells_Masters-SF-Roger_Federer-Rafael_Nadal,1,F-IO,15,4,2,1,1,11,4
20120316-M-Indian_Wells_Masters-SF-Roger_Federer-Rafael_Nadal,1,F-II,5,2,1,0,1,4,1
20120316-M-Indian_Wells_Masters-SF-Roger_Federer-Rafael_Nadal,1,B-XC,25,3,2,0,1,8,17
20120316-M-Indian_Wells_Masters-SF-Roger_Federer-Rafael_Nadal,1,B-DTM,31,1,0,0,1,11,20
20120316-M-Indian_Wells_Masters-SF-Roger_Federer-Rafael_Nadal,1,B-DTL,16,2,0,0,2,7,9
20120316-M-Indian_Wells_Masters-SF-Roger_Federer-Rafael_Nadal,1,B-IO,3,0,0,0,0,3,0
20120316-M-Indian_Wells_Masters-SF-Roger_Federer-Rafael_Nadal,1,S-XC,1,0,0,0,0,0,1
20120316-M-Indian_Wells_Masters-SF-Roger_Federer-Rafael_Nadal,1,S-DTM,1,0,0,0,0,0,1
20120316-M-Indian_Wells_Masters-SF-Roger_Federer-Rafael_Nadal,1,S-DTL,1,1,0,1,0,1,0
20120316-M-Indian_Wells_Masters-SF-Roger_Federer-Rafael_Nadal,2,F-XC,57,4,1,2,1,37,20
20120316-M-Indian_Wells_Masters-SF-Roger_Federer-Rafael_Nadal,2,F-DTM,31,0,0,0,0,18,13
20120316-M-Indian_Wells_Masters-SF-Roger_Federer-Rafael_Nadal,2,F-DTL,3,0,0,0,0,2,1
20120316-M-Indian_Wells_Masters-SF-Roger_Federer-Rafael_Nadal,2,F-IO,18,6,3,1,2,9,9
20120316-M-Indian_Wells_Masters-SF-Roger_Federer-Rafael_Nadal,2,F-II,2,0,0,0,0,0,2
20120316-M-Indian_Wells_Masters-SF-Roger_Federer-Rafael_Nadal,2,B-XC,19,3,1,1,1,6,13
20120316-M-Indian_Wells_Masters-SF-Roger_Federer-Rafael_Nadal,2,B-DTM,36,0,0,0,0,8,28
20120316-M-Indian_Wells_Masters-SF-Roger_Federer-Rafael_Nadal,2,B-DTL,19,1,0,0,1,11,8
20120316-M-Indian_Wells_Masters-SF-Roger_Federer-Rafael_Nadal,2,B-IO,6,0,0,0,0,3,3
20120316-M-Indian_Wells_Masters-SF-Roger_Federer-Rafael_Nadal,2,S-DTM,3,0,0,0,0,0,3
20120316-M-Indian_Wells_Masters-SF-Roger_Federer-Rafael_Nadal,2,S-DTL,3,0,0,0,0,0,3
20120316-M-Indian_Wells_Masters-SF-Roger_Federer-Rafael_Nadal,2,S-IO,1,0,0,0,0,1,0
20120313-M-Indian_Wells_Masters-R32-Ryan_Harrison-Guillermo_Garcia_Lopez,1,F-XC,51,9,3,4,2,30,21
20120313-M-Indian_Wells_Masters-R32-Ryan_Harrison-Guillermo_Garcia_Lopez,1,F-DTM,41,4,0,1,3,22,19
20120313-M-Indian_Wells_Masters-R32-Ryan_Harrison-Guillermo_Garcia_Lopez,1,F-DTL,8,3,2,1,0,7,1
20120313-M-Indian_Wells_Masters-R32-Ryan_Harrison-Guillermo_Garcia_Lopez,1,F-IO,27,7,2,2,3,17,10
20120313-M-Indian_Wells_Masters-R32-Ryan_Harrison-Guillermo_Garcia_Lopez,1,F-II,1,0,0,0,0,0,1
20120313-M-Indian_Wells_Masters-R32-Ryan_Harrison-Guillermo_Garcia_Lopez,1,B-XC,25,2,0,1,1,14,11
20120313-M-Indian_Wells_Masters-R32-Ryan_Harrison-Guillermo_Garcia_Lopez,1,B-DTM,42,4,0,0,4,19,23
20120313-M-Indian_Wells_Masters-R32-Ryan_Harrison-Guillermo_Garcia_Lopez,1,B-DTL,12,7,3,0,4,7,5
20120313-M-Indian_Wells_Masters-R32-Ryan_Harrison-Guillermo_Garcia_Lopez,1,B-IO,4,1,0,0,1,2,2
20120313-M-Indian_Wells_Masters-R32-Ryan_Harrison-Guillermo_Garcia_Lopez,1,S-XC,9,0,0,0,0,6,3
20120313-M-Indian_Wells_Masters-R32-Ryan_Harrison-Guillermo_Garcia_Lopez,1,S-DTM,24,1,0,0,1,16,8
20120313-M-Indian_Wells_Masters-R32-Ryan_Harrison-Guillermo_Garcia_Lopez,1,S-DTL,6,1,0,0,1,1,5
20120313-M-Indian_Wells_Masters-R32-Ryan_Harrison-Guillermo_Garcia_Lopez,2,F-XC,54,9,4,3,2,25,29
20120313-M-Indian_Wells_Masters-R32-Ryan_Harrison-Guillermo_Garcia_Lopez,2,F-DTM,58,9,1,0,8,20,38
20120313-M-Indian_Wells_Masters-R32-Ryan_Harrison-Guillermo_Garcia_Lopez,2,F-DTL,12,0,0,0,0,6,6
20120313-M-Indian_Wells_Masters-R32-Ryan_Harrison-Guillermo_Garcia_Lopez,2,F-IO,74,12,3,2,7,35,39
20120313-M-Indian_Wells_Masters-R32-Ryan_Harrison-Guillermo_Garcia_Lopez,2,F-II,3,0,0,0,0,1,2
20120313-M-Indian_Wells_Masters-R32-Ryan_Harrison-Guillermo_Garcia_Lopez,2,B-XC,25,1,0,0,1,10,15
20120313-M-Indian_Wells_Masters-R32-Ryan_Harrison-Guillermo_Garcia_Lopez,2,B-DTM,13,3,0,0,3,5,8
20120313-M-Indian_Wells_Masters-R32-Ryan_Harrison-Guillermo_Garcia_Lopez,2,B-DTL,1,0,0,0,0,1,0
20120313-M-Indian_Wells_Masters-R32-Ryan_Harrison-Guillermo_Garcia_Lopez,2,B-IO,3,2,1,0,1,1,2
20120313-M-Indian_Wells_Masters-R32-Ryan_Harrison-Guillermo_Garcia_Lopez,2,S-XC,10,1,0,0,1,5,5
20120313-M-Indian_Wells_Masters-R32-Ryan_Harrison-Guillermo_Garcia_Lopez,2,S-DTM,5,0,0,0,0,1,4
20120313-M-Indian_Wells_Masters-R32-Ryan_Harrison-Guillermo_Garcia_Lopez,2,S-DTL,2,1,0,0,1,0,2
20120313-M-Indian_Wells_Masters-R32-Ryan_Harrison-Guillermo_Garcia_Lopez,2,S-IO,1,0,0,0,0,1,0
20120510-M-Madrid-R16-Roger_Federer-Richard_Gasquet,1,F-XC,12,8,3,2,3,7,5
20120510-M-Madrid-R16-Roger_Federer-Richard_Gasquet,1,F-DTM,6,1,1,0,0,3,3
20120510-M-Madrid-R16-Roger_Federer-Richard_Gasquet,1,F-DTL,4,1,0,0,1,1,3
20120510-M-Madrid-R16-Roger_Federer-Richard_Gasquet,1,F-IO,26,6,2,1,3,16,10
20120510-M-Madrid-R16-Roger_Federer-Richard_Gasquet,1,F-II,4,1,1,0,0,3,1
20120510-M-Madrid-R16-Roger_Federer-Richard_Gasquet,1,B-XC,15,4,1,1,2,6,9
20120510-M-Madrid-R16-Roger_Federer-Richard_Gasquet,1,B-DTM,6,1,0,1,0,3,3
20120510-M-Madrid-R16-Roger_Federer-Richard_Gasquet,1,B-DTL,8,4,1,1,2,4,4
20120510-M-Madrid-R16-Roger_Federer-Richard_Gasquet,1,B-IO,1,1,1,0,0,1,0
20120510-M-Madrid-R16-Roger_Federer-Richard_Gasquet,1,S-XC,1,0,0,0,0,1,0
20120510-M-Madrid-R16-Roger_Federer-Richard_Gasquet,2,F-XC,7,2,1,0,1,4,3
20120510-M-Madrid-R16-Roger_Federer-Richard_Gasquet,2,F-DTM,7,0,0,0,0,2,5
20120510-M-Madrid-R16-Roger_Federer-Richard_Gasquet,2,F-DTL,4,2,0,1,1,3,1
20120510-M-Madrid-R16-Roger_Federer-Richard_Gasquet,2,F-IO,5,1,1,0,0,3,2
20120510-M-Madrid-R16-Roger_Federer-Richard_Gasquet,2,B-XC,21,5,0,1,4,12,9
20120510-M-Madrid-R16-Roger_Federer-Richard_Gasquet,2,B-DTM,16,0,0,0,0,6,10
20120510-M-Madrid-R16-Roger_Federer-Richard_Gasquet,2,B-DTL,5,2,1,0,1,3,2
20120510-M-Madrid-R16-Roger_Federer-Richard_Gasquet,2,B-IO,1,1,1,0,0,1,0
20120510-M-Madrid-R16-Roger_Federer-Richard_Gasquet,2,S-XC,5,0,0,0,0,1,4
20120510-M-Madrid-R16-Roger_Federer-Richard_Gasquet,2,S-DTM,5,0,0,0,0,1,4
20120505-M-Munich-F-Marin_Cilic-Philipp_Kohlschreiber,1,F-XC,37,10,5,1,4,17,20
20120505-M-Munich-F-Marin_Cilic-Philipp_Kohlschreiber,1,F-DTM,19,2,0,0,2,5,14
20120505-M-Munich-F-Marin_Cilic-Philipp_Kohlschreiber,1,F-DTL,9,2,0,1,1,2,7
20120505-M-Munich-F-Marin_Cilic-Philipp_Kohlschreiber,1,F-IO,14,6,3,0,3,9,5
20120505-M-Munich-F-Marin_Cilic-Philipp_Kohlschreiber,1,F-II,2,0,0,0,0,1,1
20120505-M-Munich-F-Marin_Cilic-Philipp_Kohlschreiber,1,B-XC,52,8,2,1,5,16,36
20120505-M-Munich-F-Marin_Cilic-Philipp_Kohlschreiber,1,B-DTM,22,3,0,0,3,3,19
20120505-M-Munich-F-Marin_Cilic-Philipp_Kohlschreiber,1,B-DTL,6,5,4,0,1,4,2
20120505-M-Munich-F-Marin_Cilic-Philipp_Kohlschreiber,1,S-XC,4,2,0,0,2,1,3
20120505-M-Munich-F-Marin_Cilic-Philipp_Kohlschreiber,1,S-DTM,2,1,0,0,1,0,2
20120505-M-Munich-F-Marin_Cilic-Philipp_Kohlschreiber,1,S-DTL,2,0,0,0,0,0,2
20120505-M-Munich-F-Marin_Cilic-Philipp_Kohlschreiber,2,F-XC,41,12,5,5,2,31,10
20120505-M-Munich-F-Marin_Cilic-Philipp_Kohlschreiber,2,F-DTM,25,2,0,0,2,16,9
20120505-M-Munich-F-Marin_Cilic-Philipp_Kohlschreiber,2,F-DTL,7,0,0,0,0,6,1
20120505-M-Munich-F-Marin_Cilic-Philipp_Kohlschreiber,2,F-IO,29,7,1,3,3,19,10
20120505-M-Munich-F-Marin_Cilic-Philipp_Kohlschreiber,2,F-II,6,1,1,0,0,4,2
20120505-M-Munich-F-Marin_Cilic-Philipp_Kohlschreiber,2,B-XC,26,2,0,1,1,19,7
20120505-M-Munich-F-Marin_Cilic-Philipp_Kohlschreiber,2,B-DTM,16,3,0,0,3,9,7
20120505-M-Munich-F-Marin_Cilic-Philipp_Kohlschreiber,2,B-DTL,9,5,2,1,2,6,3
20120505-M-Munich-F-Marin_Cilic-Philipp_Kohlschreiber,2,B-IO,2,0,0,0,0,1,1
20120505-M-Munich-F-Marin_Cilic-Philipp_Kohlschreiber,2,S-XC,14,2,0,1,1,9,5
20120505-M-Munich-F-Marin_Cilic-Philipp_Kohlschreiber,2,S-DTM,4,1,0,0,1,1,3
20121102-M-Paris_Masters-QF-Janko_Tipsarevic-Jerzy_Janowicz,1,F-XC,19,7,1,4,2,10,9
20121102-M-Paris_Masters-QF-Janko_Tipsarevic-Jerzy_Janowicz,1,F-DTM,28,3,0,0,3,10,18
20121102-M-Paris_Masters-QF-Janko_Tipsarevic-Jerzy_Janowicz,1,F-DTL,5,1,0,0,1,2,3
20121102-M-Paris_Masters-QF-Janko_Tipsarevic-Jerzy_Janowicz,1,F-IO,24,4,0,1,3,16,8
20121102-M-Paris_Masters-QF-Janko_Tipsarevic-Jerzy_Janowicz,1,F-II,1,0,0,0,0,1,0
20121102-M-Paris_Masters-QF-Janko_Tipsarevic-Jerzy_Janowicz,1,B-XC,32,3,0,0,3,18,14
20121102-M-Paris_Masters-QF-Janko_Tipsarevic-Jerzy_Janowicz,1,B-DTM,23,4,0,0,4,9,14
20121102-M-Paris_Masters-QF-Janko_Tipsarevic-Jerzy_Janowicz,1,B-DTL,4,1,0,0,1,1,3
20121102-M-Paris_Masters-QF-Janko_Tipsarevic-Jerzy_Janowicz,1,B-IO,4,2,1,0,1,2,2
20121102-M-Paris_Masters-QF-Janko_Tipsarevic-Jerzy_Janowicz,1,S-XC,5,1,0,1,0,2,3
20121102-M-Paris_Masters-QF-Janko_Tipsarevic-Jerzy_Janowicz,1,S-DTM,3,0,0,0,0,1,2
20121102-M-Paris_Masters-QF-Janko_Tipsarevic-Jerzy_Janowicz,1,S-DTL,1,0,0,0,0,1,0
20121102-M-Paris_Masters-QF-Janko_Tipsarevic-Jerzy_Janowicz,1,S-IO,1,0,0,0,0,0,1
20121102-M-Paris_Masters-QF-Janko_Tipsarevic-Jerzy_Janowicz,2,F-XC,29,12,2,4,6,19,10
20121102-M-Paris_Masters-QF-Janko_Tipsarevic-Jerzy_Janowicz,2,F-DTM,9,1,1,0,0,5,4
20121102-M-Paris_Masters-QF-Janko_Tipsarevic-Jerzy_Janowicz,2,F-DTL,4,4,3,1,0,4,0
20121102-M-Paris_Masters-QF-Janko_Tipsarevic-Jerzy_Janowicz,2,F-IO,12,8,2,2,4,5,7
20121102-M-Paris_Masters-QF-Janko_Tipsarevic-Jerzy_Janowicz,2,F-II,2,0,0,0,0,1,1
20121102-M-Paris_Masters-QF-Janko_Tipsarevic-Jerzy_Janowicz,2,B-XC,28,8,2,2,4,15,13
20121102-M-Paris_Masters-QF-Janko_Tipsarevic-Jerzy_Janowicz,2,B-DTM,28,3,0,0,3,12,16
20121102-M-Paris_Masters-QF-Janko_Tipsarevic-Jerzy_Janowicz,2,B-DTL,4,1,1,0,0,3,1
20121102-M-Paris_Masters-QF-Janko_Tipsarevic-Jerzy_Janowicz,2,S-XC,12,4,2,0,2,6,6
20121102-M-Paris_Masters-QF-Janko_Tipsarevic-Jerzy_Janowicz,2,S-DTM,8,0,0,0,0,4,4
20121031-M-Paris_Masters-R32-Sam_Querrey-Novak_Djokovic,1,F-XC,44,13,4,4,5,25,19
20121031-M-Paris_Masters-R32-Sam_Querrey-Novak_Djokovic,1,F-DTM,32,3,2,0,1,17,15
20121031-M-Paris_Masters-R32-Sam_Querrey-Novak_Djokovic,1,F-DTL,3,1,0,0,1,1,2
20121031-M-Paris_Masters-R32-Sam_Querrey-Novak_Djokovic,1,F-IO,24,6,3,0,3,12,12
20121031-M-Paris_Masters-R32-Sam_Querrey-Novak_Djokovic,1,F-II,2,0,0,0,0,2,0
20121031-M-Paris_Masters-R32-Sam_Querrey-Novak_Djokovic,1,B-XC,31,6,1,0,5,14,17
20121031-M-Paris_Masters-R32-Sam_Querrey-Novak_Djokovic,1,B-DTM,20,2,0,0,2,10,10
20121031-M-Paris_Masters-R32-Sam_Querrey-Novak_Djokovic,1,B-DTL,2,2,1,1,0,2,0
20121031-M-Paris_Masters-R32-Sam_Querrey-Novak_Djokovic,1,B-IO,3,1,0,1,0,2,1
20121031-M-Paris_Masters-R32-Sam_Querrey-Novak_Djokovic,1,S-XC,3,0,0,0,0,1,2
20121031-M-Paris_Masters-R32-Sam_Querrey-Novak_Djokovic,1,S-DTM,3,0,0,0,0,2,1
20121031-M-Paris_Masters-R32-Sam_Querrey-Novak_Djokovic,2,F-XC,36,13,5,3,5,18,18
20121031-M-Paris_Masters-R32-Sam_Querrey-Novak_Djokovic,2,F-DTM,28,2,1,0,1,11,17
20121031-M-Paris_Masters-R32-Sam_Querrey-Novak_Djokovic,2,F-DTL,6,4,1,1,2,3,3
20121031-M-Paris_Masters-R32-Sam_Querrey-Novak_Djokovic,2,F-IO,7,4,1,1,2,3,4
20121031-M-Paris_Masters-R32-Sam_Querrey-Novak_Djokovic,2,F-II,2,1,1,0,0,2,0
20121031-M-Paris_Masters-R32-Sam_Querrey-Novak_Djokovic,2,B-XC,43,10,2,3,5,18,25
20121031-M-Paris_Masters-R32-Sam_Querrey-Novak_Djokovic,2,B-DTM,29,2,0,0,2,16,13
20121031-M-Paris_Masters-R32-Sam_Querrey-Novak_Djokovic,2,B-DTL,7,4,2,1,1,4,3
20121031-M-Paris_Masters-R32-Sam_Querrey-Novak_Djokovic,2,B-IO,10,7,3,0,4,5,5
20121031-M-Paris_Masters-R32-Sam_Querrey-Novak_Djokovic,2,S-XC,3,0,0,0,0,1,2
20121031-M-Paris_Masters-R32-Sam_Querrey-Novak_Djokovic,2,S-DTM,4,0,0,0,0,2,2
20120516-M-Rome_Masters-R32-Roger_Federer-Carlos_Berlocq,1,F-XC,29,8,3,2,3,17,12
20120516-M-Rome_Masters-R32-Roger_Federer-Carlos_Berlocq,1,F-DTM,20,3,0,1,2,12,8
20120516-M-Rome_Masters-R32-Roger_Federer-Carlos_Berlocq,1,F-DTL,5,1,0,0,1,2,3
20120516-M-Rome_Masters-R32-Roger_Federer-Carlos_Berlocq,1,F-IO,34,14,5,5,4,27,7
20120516-M-Rome_Masters-R32-Roger_Federer-Carlos_Berlocq,1,F-II,5,3,1,1,1,4,1
20120516-M-Rome_Masters-R32-Roger_Federer-Carlos_Berlocq,1,B-XC,17,3,0,1,2,11,6
20120516-M-Rome_Masters-R32-Roger_Federer-Carlos_Berlocq,1,B-DTM,13,1,0,0,1,6,7
20120516-M-Rome_Masters-R32-Roger_Federer-Carlos_Berlocq,1,B-DTL,5,1,0,1,0,4,1
20120516-M-Rome_Masters-R32-Roger_Federer-Carlos_Berlocq,1,B-IO,1,1,0,1,0,1,0
20120516-M-Rome_Masters-R32-Roger_Federer-Carlos_Berlocq,1,S-XC,2,0,0,0,0,1,1
20120516-M-Rome_Masters-R32-Roger_Federer-Carlos_Berlocq,1,S-DTM,3,1,0,0,1,1,2
20120516-M-Rome_Masters-R32-Roger_Federer-Carlos_Berlocq,2,F-XC,15,4,1,2,1,9,6
20120516-M-Rome_Masters-R32-Roger_Federer-Carlos_Berlocq,2,F-DTM,21,1,0,0,1,7,14
20120516-M-Rome_Masters-R32-Roger_Federer-Carlos_Berlocq,2,F-DTL,11,1,1,0,0,6,5
20120516-M-Rome_Masters-R32-Roger_Federer-Carlos_Berlocq,2,F-IO,18,3,2,0,1,8,10
20120516-M-Rome_Masters-R32-Roger_Federer-Carlos_Berlocq,2,B-XC,9,2,0,0,2,3,6
20120516-M-Rome_Masters-R32-Roger_Federer-Carlos_Berlocq,2,B-DTM,30,3,0,0,3,9,21
20120516-M-Rome_Masters-R32-Roger_Federer-Carlos_Berlocq,2,B-DTL,4,2,0,0,2,1,3
20120516-M-Rome_Masters-R32-Roger_Federer-Carlos_Berlocq,2,B-IO,3,3,3,0,0,3,0
20120516-M-Rome_Masters-R32-Roger_Federer-Carlos_Berlocq,2,S-DTM,11,0,0,0,0,3,8
20120516-M-Rome_Masters-R32-Roger_Federer-Carlos_Berlocq,2,S-DTL,1,0,0,0,0,0,1
20120219-M-Rotterdam-F-Roger_Federer-Juan_Martin_Del_Potro,1,F-XC,30,4,3,0,1,18,12
20120219-M-Rotterdam-F-Roger_Federer-Juan_Martin_Del_Potro,1,F-DTM,22,4,1,0,3,12,10
20120219-M-Rotterdam-F-Roger_Federer-Juan_Martin_Del_Potro,1,F-DTL,9,3,0,2,1,6,3
20120219-M-Rotterdam-F-Roger_Federer-Juan_Martin_Del_Potro,1,F-IO,36,11,4,2,5,19,17
20120219-M-Rotterdam-F-Roger_Federer-Juan_Martin_Del_Potro,1,F-II,5,2,1,0,1,4,1
20120219-M-Rotterdam-F-Roger_Federer-Juan_Martin_Del_Potro,1,B-XC,31,4,3,0,1,19,12
20120219-M-Rotterdam-F-Roger_Federer-Juan_Martin_Del_Potro,1,B-DTM,25,1,0,0,1,17,8
20120219-M-Rotterdam-F-Roger_Federer-Juan_Martin_Del_Potro,1,B-DTL,10,2,0,0,2,4,6
20120219-M-Rotterdam-F-Roger_Federer-Juan_Martin_Del_Potro,1,B-IO,4,2,1,0,1,2,2
20120219-M-Rotterdam-F-Roger_Federer-Juan_Martin_Del_Potro,1,S-XC,9,0,0,0,0,5,4
20120219-M-Rotterdam-F-Roger_Federer-Juan_Martin_Del_Potro,1,S-DTM,13,0,0,0,0,8,5
20120219-M-Rotterdam-F-Roger_Federer-Juan_Martin_Del_Potro,1,S-DTL,9,0,0,0,0,6,3
20120219-M-Rotterdam-F-Roger_Federer-Juan_Martin_Del_Potro,1,S-IO,1,0,0,0,0,1,0
20120219-M-Rotterdam-F-Roger_Federer-Juan_Martin_Del_Potro,2,F-XC,33,11,2,3,6,16,17
20120219-M-Rotterdam-F-Roger_Federer-Juan_Martin_Del_Potro,2,F-DTM,25,5,0,2,3,10,15
20120219-M-Rotterdam-F-Roger_Federer-Juan_Martin_Del_Potro,2,F-DTL,19,4,1,0,3,6,13
20120219-M-Rotterdam-F-Roger_Federer-Juan_Martin_Del_Potro,2,F-IO,19,1,0,1,0,8,11
20120219-M-Rotterdam-F-Roger_Federer-Juan_Martin_Del_Potro,2,B-XC,51,5,0,2,3,21,30
20120219-M-Rotterdam-F-Roger_Federer-Juan_Martin_Del_Potro,2,B-DTM,28,2,0,0,2,6,22
20120219-M-Rotterdam-F-Roger_Federer-Juan_Martin_Del_Potro,2,B-DTL,6,1,1,0,0,3,3
20120219-M-Rotterdam-F-Roger_Federer-Juan_Martin_Del_Potro,2,B-IO,1,0,0,0,0,0,1
20120219-M-Rotterdam-F-Roger_Federer-Juan_Martin_Del_Potro,2,S-XC,11,2,0,1,1,6,5
20120219-M-Rotterdam-F-Roger_Federer-Juan_Martin_Del_Potro,2,S-DTM,2,0,0,0,0,1,1
20120219-M-Rotterdam-F-Roger_Federer-Juan_Martin_Del_Potro,2,S-DTL,2,0,0,0,0,2,0
20121011-M-Shanghai_Masters-R16-Alexandr_Dolgopolov-Andy_Murray,1,F-XC,30,11,0,2,9,11,19
20121011-M-Shanghai_Masters-R16-Alexandr_Dolgopolov-Andy_Murray,1,F-DTM,10,0,0,0,0,2,8
20121011-M-Shanghai_Masters-R16-Alexandr_Dolgopolov-Andy_Murray,1,F-DTL,8,3,0,0,3,2,6
20121011-M-Shanghai_Masters-R16-Alexandr_Dolgopolov-Andy_Murray,1,F-IO,9,2,1,0,1,2,7
20121011-M-Shanghai_Masters-R16-Alexandr_Dolgopolov-Andy_Murray,1,B-XC,32,9,1,0,8,11,21
20121011-M-Shanghai_Masters-R16-Alexandr_Dolgopolov-Andy_Murray,1,B-DTM,26,1,0,0,1,7,19
20121011-M-Shanghai_Masters-R16-Alexandr_Dolgopolov-Andy_Murray,1,B-DTL,4,2,1,1,0,2,2
20121011-M-Shanghai_Masters-R16-Alexandr_Dolgopolov-Andy_Murray,1,B-IO,5,2,0,0,2,2,3
20121011-M-Shanghai_Masters-R16-Alexandr_Dolgopolov-Andy_Murray,1,S-XC,1,1,0,0,1,0,1
20121011-M-Shanghai_Masters-R16-Alexandr_Dolgopolov-Andy_Murray,1,S-DTM,3,1,0,0,1,1,2
20121011-M-Shanghai_Masters-R16-Alexandr_Dolgopolov-Andy_Murray,2,F-XC,24,6,2,2,2,17,7
20121011-M-Shanghai_Masters-R16-Alexandr_Dolgopolov-Andy_Murray,2,F-DTM,15,2,0,0,2,12,3
20121011-M-Shanghai_Masters-R16-Alexandr_Dolgopolov-Andy_Murray,2,F-DTL,9,2,0,0,2,4,5
20121011-M-Shanghai_Masters-R16-Alexandr_Dolgopolov-Andy_Murray,2,F-IO,9,1,0,1,0,7,2
20121011-M-Shanghai_Masters-R16-Alexandr_Dolgopolov-Andy_Murray,2,B-XC,9,0,0,0,0,5,4
20121011-M-Shanghai_Masters-R16-Alexandr_Dolgopolov-Andy_Murray,2,B-DTM,16,2,0,0,2,6,10
20121011-M-Shanghai_Masters-R16-Alexandr_Dolgopolov-Andy_Murray,2,B-DTL,2,0,0,0,0,2,0
20121011-M-Shanghai_Masters-R16-Alexandr_Dolgopolov-Andy_Murray,2,B-IO,4,1,0,0,1,3,1
20121011-M-Shanghai_Masters-R16-Alexandr_Dolgopolov-Andy_Murray,2,S-XC,21,1,0,0,1,14,7
20121011-M-Shanghai_Masters-R16-Alexandr_Dolgopolov-Andy_Murray,2,S-DTM,8,0,0,0,0,5,3
20121011-M-Shanghai_Masters-R16-Alexandr_Dolgopolov-Andy_Murray,2,S-DTL,2,0,0,0,0,2,0
20121011-M-Shanghai_Masters-R16-Alexandr_Dolgopolov-Andy_Murray,2,S-IO,2,1,0,0,1,1,1
20120706-M-Wimbledon-SF-Roger_Federer-Novak_Djokovic,1,F-XC,53,17,4,7,6,30,23
20120706-M-Wimbledon-SF-Roger_Federer-Novak_Djokovic,1,F-DTM,36,3,1,0,2,14,22
20120706-M-Wimbledon-SF-Roger_Federer-Novak_Djokovic,1,F-DTL,17,6,2,0,4,6,11
20120706-M-Wimbledon-SF-Roger_Federer-Novak_Djokovic,1,F-IO,27,12,2,4,6,17,10
20120706-M-Wimbledon-SF-Roger_Federer-Novak_Djokovic,1,F-II,2,0,0,0,0,1,1
20120706-M-Wimbledon-SF-Roger_Federer-Novak_Djokovic,1,B-XC,30,6,3,3,0,20,10
20120706-M-Wimbledon-SF-Roger_Federer-Novak_Djokovic,1,B-DTM,20,2,0,1,1,8,12
20120706-M-Wimbledon-SF-Roger_Federer-Novak_Djokovic,1,B-DTL,5,2,0,1,1,3,2
20120706-M-Wimbledon-SF-Roger_Federer-Novak_Djokovic,1,B-IO,2,1,1,0,0,2,0
20120706-M-Wimbledon-SF-Roger_Federer-Novak_Djokovic,1,S-XC,20,2,0,1,1,8,12
20120706-M-Wimbledon-SF-Roger_Federer-Novak_Djokovic,1,S-DTM,8,1,0,0,1,3,5
20120706-M-Wimbledon-SF-Roger_Federer-Novak_Djokovic,1,S-DTL,4,0,0,0,0,1,3
20120706-M-Wimbledon-SF-Roger_Federer-Novak_Djokovic,1,S-II,1,0,0,0,0,1,0
20120706-M-Wimbledon-SF-Roger_Federer-Novak_Djokovic,2,F-XC,47,13,5,5,3,29,18
20120706-M-Wimbledon-SF-Roger_Federer-Novak_Djokovic,2,F-DTM,25,2,0,0,2,14,11
20120706-M-Wimbledon-SF-Roger_Federer-Novak_Djokovic,2,F-DTL,9,3,0,1,2,5,4
20120706-M-Wimbledon-SF-Roger_Federer-Novak_Djokovic,2,F-IO,26,7,3,1,3,15,11
20120706-M-Wimbledon-SF-Roger_Federer-Novak_Djokovic,2,F-II,4,1,0,0,1,3,1
20120706-M-Wimbledon-SF-Roger_Federer-Novak_Djokovic,2,B-XC,48,8,2,3,3,22,26
20120706-M-Wimbledon-SF-Roger_Federer-Novak_Djokovic,2,B-DTM,35,6,0,1,5,11,24
20120706-M-Wimbledon-SF-Roger_Federer-Novak_Djokovic,2,B-DTL,26,13,2,6,5,14,12
20120706-M-Wimbledon-SF-Roger_Federer-Novak_Djokovic,2,B-IO,16,8,2,3,3,11,5
20120706-M-Wimbledon-SF-Roger_Federer-Novak_Djokovic,2,S-XC,4,0,0,0,0,1,3
20120706-M-Wimbledon-SF-Roger_Federer-Novak_Djokovic,2,S-DTM,5,0,0,0,0,2,3
20120706-M-Wimbledon-SF-Roger_Federer-Novak_Djokovic,2,S-II,1,0,0,0,0,1,0
19800705-M-Wimbledon-F-John_Mcenroe-Bjorn_Borg,1,F-XC,12,4,1,0,3,7,5
19800705-M-Wimbledon-F-John_Mcenroe-Bjorn_Borg,1,F-DTM,7,1,1,0,0,3,4
19800705-M-Wimbledon-F-John_Mcenroe-Bjorn_Borg,1,F-DTL,12,7,3,0,4,3,9
19800705-M-Wimbledon-F-John_Mcenroe-Bjorn_Borg,1,F-IO,6,4,1,1,2,4,2
19800705-M-Wimbledon-F-John_Mcenroe-Bjorn_Borg,1,B-XC,25,10,6,1,3,13,12
19800705-M-Wimbledon-F-John_Mcenroe-Bjorn_Borg,1,B-DTM,16,4,0,0,4,7,9
19800705-M-Wimbledon-F-John_Mcenroe-Bjorn_Borg,1,B-DTL,16,10,1,1,8,5,11
19800705-M-Wimbledon-F-John_Mcenroe-Bjorn_Borg,1,B-IO,11,6,3,1,2,5,6
19800705-M-Wimbledon-F-John_Mcenroe-Bjorn_Borg,1,B-II,2,1,0,0,1,0,2
19800705-M-Wimbledon-F-John_Mcenroe-Bjorn_Borg,1,S-XC,6,0,0,0,0,3,3
19800705-M-Wimbledon-F-John_Mcenroe-Bjorn_Borg,1,S-DTM,2,1,0,0,1,1,1
19800705-M-Wimbledon-F-John_Mcenroe-Bjorn_Borg,1,S-DTL,12,4,0,0,4,5,7
19800705-M-Wimbledon-F-John_Mcenroe-Bjorn_Borg,2,F-XC,36,7,3,1,3,20,16
19800705-M-Wimbledon-F-John_Mcenroe-Bjorn_Borg,2,F-DTM,14,3,2,0,1,8,6
19800705-M-Wimbledon-F-John_Mcenroe-Bjorn_Borg,2,F-DTL,15,8,7,0,1,13,2
19800705-M-Wimbledon-F-John_Mcenroe-Bjorn_Borg,2,F-IO,12,5,1,1,3,7,5
19800705-M-Wimbledon-F-John_Mcenroe-Bjorn_Borg,2,B-XC,21,12,4,5,3,13,8
19800705-M-Wimbledon-F-John_Mcenroe-Bjorn_Borg,2,B-DTM,10,3,1,0,2,3,7
19800705-M-Wimbledon-F-John_Mcenroe-Bjorn_Borg,2,B-DTL,15,4,1,0,3,7,8
19800705-M-Wimbledon-F-John_Mcenroe-Bjorn_Borg,2,B-IO,4,2,0,1,1,3,1
19800705-M-Wimbledon-F-John_Mcenroe-Bjorn_Borg,2,S-XC,1,0,0,0,0,1,0
19800705-M-Wimbledon-F-John_Mcenroe-Bjorn_Borg,2,S-DTM,5,0,0,0,0,2,3
19800705-M-Wimbledon-F-John_Mcenroe-Bjorn_Borg,2,S-DTL,6,0,0,0,0,2,4
19800705-M-Wimbledon-F-John_Mcenroe-Bjorn_Borg,2,S-IO,2,1,0,0,1,0,2
20140114-M-Australian_Open-R128-Nick_Kyrgios-Benjamin_Becker,1,F-XC,29,13,6,1,6,14,15
20140114-M-Australian_Open-R128-Nick_Kyrgios-Benjamin_Becker,1,F-DTM,34,6,1,1,4,17,17
20140114-M-Australian_Open-R128-Nick_Kyrgios-Benjamin_Becker,1,F-DTL,2,1,0,0,1,1,1
20140114-M-Australian_Open-R128-Nick_Kyrgios-Benjamin_Becker,1,F-IO,24,12,8,0,4,14,10
20140114-M-Australian_Open-R128-Nick_Kyrgios-Benjamin_Becker,1,F-II,2,0,0,0,0,1,1
20140114-M-Australian_Open-R128-Nick_Kyrgios-Benjamin_Becker,1,B-XC,35,6,4,0,2,14,21
20140114-M-Australian_Open-R128-Nick_Kyrgios-Benjamin_Becker,1,B-DTM,34,5,0,0,5,11,23
20140114-M-Australian_Open-R128-Nick_Kyrgios-Benjamin_Becker,1,B-DTL,6,4,3,0,1,4,2
20140114-M-Australian_Open-R128-Nick_Kyrgios-Benjamin_Becker,1,B-IO,4,3,0,0,3,1,3
20140114-M-Australian_Open-R128-Nick_Kyrgios-Benjamin_Becker,1,S-XC,2,1,0,0,1,0,2
20140114-M-Australian_Open-R128-Nick_Kyrgios-Benjamin_Becker,1,S-DTM,1,0,0,0,0,0,1
20140114-M-Australian_Open-R128-Nick_Kyrgios-Benjamin_Becker,1,S-DTL,1,0,0,0,0,0,1
20140114-M-Australian_Open-R128-Nick_Kyrgios-Benjamin_Becker,2,F-XC,21,10,5,0,5,10,11
20140114-M-Australian_Open-R128-Nick_Kyrgios-Benjamin_Becker,2,F-DTM,35,5,0,0,5,19,16
20140114-M-Australian_Open-R128-Nick_Kyrgios-Benjamin_Becker,2,F-DTL,3,2,1,0,1,2,1
20140114-M-Australian_Open-R128-Nick_Kyrgios-Benjamin_Becker,2,F-IO,26,5,2,1,2,15,11
20140114-M-Australian_Open-R128-Nick_Kyrgios-Benjamin_Becker,2,B-XC,21,0,0,0,0,13,8
20140114-M-Australian_Open-R128-Nick_Kyrgios-Benjamin_Becker,2,B-DTM,32,5,1,0,4,16,16
20140114-M-Australian_Open-R128-Nick_Kyrgios-Benjamin_Becker,2,B-DTL,5,5,2,0,3,2,3
20140114-M-Australian_Open-R128-Nick_Kyrgios-Benjamin_Becker,2,B-IO,6,4,2,0,2,4,2
20140114-M-Australian_Open-R128-Nick_Kyrgios-Benjamin_Becker,2,S-XC,15,2,0,0,2,9,6
20140114-M-Australian_Open-R128-Nick_Kyrgios-Benjamin_Becker,2,S-DTM,10,1,0,0,1,3,7
20140114-M-Australian_Open-R128-Nick_Kyrgios-Benjamin_Becker,2,S-DTL,2,1,1,0,0,2,0
20140124-M-Australian_Open-SF-Roger_Federer-Rafael_Nadal,1,F-XC,81,18,7,5,6,39,42
20140124-M-Australian_Open-SF-Roger_Federer-Rafael_Nadal,1,F-DTM,50,6,0,0,6,15,35
20140124-M-Australian_Open-SF-Roger_Federer-Rafael_Nadal,1,F-DTL,7,2,0,0,2,1,6
20140124-M-Australian_Open-SF-Roger_Federer-Rafael_Nadal,1,F-IO,36,15,5,5,5,17,19
20140124-M-Australian_Open-SF-Roger_Federer-Rafael_Nadal,1,F-II,2,2,0,1,1,1,1
20140124-M-Australian_Open-SF-Roger_Federer-Rafael_Nadal,1,B-XC,36,11,1,1,9,8,28
20140124-M-Australian_Open-SF-Roger_Federer-Rafael_Nadal,1,B-DTM,44,4,0,0,4,13,31
20140124-M-Australian_Open-SF-Roger_Federer-Rafael_Nadal,1,B-DTL,8,3,0,1,2,1,7
20140124-M-Australian_Open-SF-Roger_Federer-Rafael_Nadal,1,B-IO,6,1,0,0,1,2,4
20140124-M-Australian_Open-SF-Roger_Federer-Rafael_Nadal,1,S-XC,11,1,0,0,1,3,8
20140124-M-Australian_Open-SF-Roger_Federer-Rafael_Nadal,1,S-DTM,6,0,0,0,0,1,5
20140124-M-Australian_Open-SF-Roger_Federer-Rafael_Nadal,1,S-DTL,2,0,0,0,0,0,2
20140124-M-Australian_Open-SF-Roger_Federer-Rafael_Nadal,2,F-XC,89,6,1,2,3,66,23
20140124-M-Australian_Open-SF-Roger_Federer-Rafael_Nadal,2,F-DTM,38,6,0,2,4,19,19
20140124-M-Australian_Open-SF-Roger_Federer-Rafael_Nadal,2,F-DTL,16,10,5,4,1,14,2
20140124-M-Australian_Open-SF-Roger_Federer-Rafael_Nadal,2,F-IO,21,8,3,2,3,16,5
20140124-M-Australian_Open-SF-Roger_Federer-Rafael_Nadal,2,F-II,1,0,0,0,0,1,0
20140124-M-Australian_Open-SF-Roger_Federer-Rafael_Nadal,2,B-XC,43,5,2,0,3,25,18
20140124-M-Australian_Open-SF-Roger_Federer-Rafael_Nadal,2,B-DTM,50,1,0,0,1,34,16
20140124-M-Australian_Open-SF-Roger_Federer-Rafael_Nadal,2,B-DTL,19,10,3,2,5,11,8
20140124-M-Australian_Open-SF-Roger_Federer-Rafael_Nadal,2,B-IO,2,0,0,0,0,2,0
20140124-M-Australian_Open-SF-Roger_Federer-Rafael_Nadal,2,S-XC,2,0,0,0,0,0,2
20140124-M-Australian_Open-SF-Roger_Federer-Rafael_Nadal,2,S-DTM,8,0,0,0,0,4,4
20140124-M-Australian_Open-SF-Roger_Federer-Rafael_Nadal,2,S-DTL,2,0,0,0,0,1,1
20140124-M-Australian_Open-SF-Roger_Federer-Rafael_Nadal,2,S-IO,2,1,0,0,1,1,1
20130121-M-Australian_Open-R16-Roger_Federer-Milos_Raonic,1,F-XC,30,6,1,2,3,21,9
20130121-M-Australian_Open-R16-Roger_Federer-Milos_Raonic,1,F-DTM,22,2,0,0,2,14,8
20130121-M-Australian_Open-R16-Roger_Federer-Milos_Raonic,1,F-DTL,10,5,3,1,1,9,1
20130121-M-Australian_Open-R16-Roger_Federer-Milos_Raonic,1,F-IO,24,10,7,3,0,22,2
20130121-M-Australian_Open-R16-Roger_Federer-Milos_Raonic,1,F-II,5,3,1,2,0,5,0
20130121-M-Australian_Open-R16-Roger_Federer-Milos_Raonic,1,B-XC,34,3,0,0,3,26,8
20130121-M-Australian_Open-R16-Roger_Federer-Milos_Raonic,1,B-DTM,13,2,0,0,2,8,5
20130121-M-Australian_Open-R16-Roger_Federer-Milos_Raonic,1,B-DTL,4,3,1,1,1,3,1
20130121-M-Australian_Open-R16-Roger_Federer-Milos_Raonic,1,B-IO,2,1,1,0,0,2,0
20130121-M-Australian_Open-R16-Roger_Federer-Milos_Raonic,1,S-XC,11,1,0,0,1,7,4
20130121-M-Australian_Open-R16-Roger_Federer-Milos_Raonic,1,S-DTM,5,0,0,0,0,3,2
20130121-M-Australian_Open-R16-Roger_Federer-Milos_Raonic,1,S-DTL,3,0,0,0,0,2,1
20130121-M-Australian_Open-R16-Roger_Federer-Milos_Raonic,2,F-XC,21,8,1,1,6,6,15
20130121-M-Australian_Open-R16-Roger_Federer-Milos_Raonic,2,F-DTM,21,2,0,0,2,6,15
20130121-M-Australian_Open-R16-Roger_Federer-Milos_Raonic,2,F-DTL,11,6,1,1,4,4,7
20130121-M-Australian_Open-R16-Roger_Federer-Milos_Raonic,2,F-IO,54,22,4,7,11,21,33
20130121-M-Australian_Open-R16-Roger_Federer-Milos_Raonic,2,F-II,5,2,1,0,1,2,3
20130121-M-Australian_Open-R16-Roger_Federer-Milos_Raonic,2,B-XC,28,4,0,0,4,7,21
20130121-M-Australian_Open-R16-Roger_Federer-Milos_Raonic,2,B-DTM,15,4,0,0,4,2,13
20130121-M-Australian_Open-R16-Roger_Federer-Milos_Raonic,2,B-DTL,6,2,0,0,2,0,6
20130121-M-Australian_Open-R16-Roger_Federer-Milos_Raonic,2,S-XC,6,1,0,0,1,0,6
20130121-M-Australian_Open-R16-Roger_Federer-Milos_Raonic,2,S-DTM,3,0,0,0,0,0,3
20130121-M-Australian_Open-R16-Roger_Federer-Milos_Raonic,2,S-DTL,1,0,0,0,0,0,1
20140122-M-Australian_Open-QF-Grigor_Dimitrov-Rafael_Nadal,1,F-XC,96,12,2,3,7,50,46
20140122-M-Australian_Open-QF-Grigor_Dimitrov-Rafael_Nadal,1,F-DTM,70,4,0,0,4,28,42
20140122-M-Australian_Open-QF-Grigor_Dimitrov-Rafael_Nadal,1,F-DTL,16,7,2,1,4,7,9
20140122-M-Australian_Open-QF-Grigor_Dimitrov-Rafael_Nadal,1,F-IO,57,28,10,6,12,31,26
20140122-M-Australian_Open-QF-Grigor_Dimitrov-Rafael_Nadal,1,F-II,22,4,1,1,2,12,10
20140122-M-Australian_Open-QF-Grigor_Dimitrov-Rafael_Nadal,1,B-XC,31,9,3,3,3,16,15
20140122-M-Australian_Open-QF-Grigor_Dimitrov-Rafael_Nadal,1,B-DTM,59,3,0,0,3,19,40
20140122-M-Australian_Open-QF-Grigor_Dimitrov-Rafael_Nadal,1,B-DTL,10,3,0,1,2,5,5
20140122-M-Australian_Open-QF-Grigor_Dimitrov-Rafael_Nadal,1,B-IO,4,0,0,0,0,1,3
20140122-M-Australian_Open-QF-Grigor_Dimitrov-Rafael_Nadal,1,S-XC,11,2,0,0,2,3,8
20140122-M-Australian_Open-QF-Grigor_Dimitrov-Rafael_Nadal,1,S-DTM,20,0,0,0,0,5,15
20140122-M-Australian_Open-QF-Grigor_Dimitrov-Rafael_Nadal,1,S-DTL,13,4,0,0,4,3,10
20140122-M-Australian_Open-QF-Grigor_Dimitrov-Rafael_Nadal,1,S-IO,3,0,0,0,0,2,1
20140122-M-Australian_Open-QF-Grigor_Dimitrov-Rafael_Nadal,1,S-II,1,0,0,0,0,0,1
20140122-M-Australian_Open-QF-Grigor_Dimitrov-Rafael_Nadal,2,F-XC,113,18,4,7,7,69,44
20140122-M-Australian_Open-QF-Grigor_Dimitrov-Rafael_Nadal,2,F-DTM,50,4,0,0,4,28,22
20140122-M-Australian_Open-QF-Grigor_Dimitrov-Rafael_Nadal,2,F-DTL,22,6,5,0,1,16,6
20140122-M-Australian_Open-QF-Grigor_Dimitrov-Rafael_Nadal,2,F-IO,73,29,8,10,11,48,25
20140122-M-Australian_Open-QF-Grigor_Dimitrov-Rafael_Nadal,2,F-II,13,1,0,0,1,7,6
20140122-M-Australian_Open-QF-Grigor_Dimitrov-Rafael_Nadal,2,B-XC,48,11,0,6,5,25,23
20140122-M-Australian_Open-QF-Grigor_Dimitrov-Rafael_Nadal,2,B-DTM,33,1,0,0,1,15,18
20140122-M-Australian_Open-QF-Grigor_Dimitrov-Rafael_Nadal,2,B-DTL,30,5,2,2,1,19,11
20140122-M-Australian_Open-QF-Grigor_Dimitrov-Rafael_Nadal,2,B-IO,11,2,1,0,1,8,3
20140122-M-Australian_Open-QF-Grigor_Dimitrov-Rafael_Nadal,2,S-XC,1,0,0,0,0,0,1
20140122-M-Australian_Open-QF-Grigor_Dimitrov-Rafael_Nadal,2,S-DTM,16,1,0,1,0,8,8
20140122-M-Australian_Open-QF-Grigor_Dimitrov-Rafael_Nadal,2,S-DTL,7,0,0,0,0,2,5
20140122-M-Australian_Open-QF-Grigor_Dimitrov-Rafael_Nadal,2,S-IO,2,0,0,0,0,2,0
20140118-M-Australian_Open-R32-Gael_Monfils-Rafael_Nadal,1,F-XC,60,10,2,1,7,24,36
20140118-M-Australian_Open-R32-Gael_Monfils-Rafael_Nadal,1,F-DTM,50,8,0,1,7,17,33
20140118-M-Australian_Open-R32-Gael_Monfils-Rafael_Nadal,1,F-DTL,17,9,3,3,3,9,8
20140118-M-Australian_Open-R32-Gael_Monfils-Rafael_Nadal,1,F-IO,21,10,5,0,5,11,10
20140118-M-Australian_Open-R32-Gael_Monfils-Rafael_Nadal,1,F-II,9,2,2,0,0,5,4
20140118-M-Australian_Open-R32-Gael_Monfils-Rafael_Nadal,1,B-XC,50,10,2,1,7,17,33
20140118-M-Australian_Open-R32-Gael_Monfils-Rafael_Nadal,1,B-DTM,36,4,0,0,4,13,23
20140118-M-Australian_Open-R32-Gael_Monfils-Rafael_Nadal,1,B-DTL,22,8,1,2,5,9,13
20140118-M-Australian_Open-R32-Gael_Monfils-Rafael_Nadal,1,B-IO,9,3,3,0,0,4,5
20140118-M-Australian_Open-R32-Gael_Monfils-Rafael_Nadal,1,S-DTM,5,1,0,0,1,1,4
20140118-M-Australian_Open-R32-Gael_Monfils-Rafael_Nadal,1,S-DTL,1,0,0,0,0,0,1
20140118-M-Australian_Open-R32-Gael_Monfils-Rafael_Nadal,2,F-XC,72,6,1,4,1,44,28
20140118-M-Australian_Open-R32-Gael_Monfils-Rafael_Nadal,2,F-DTM,32,4,1,0,3,21,11
20140118-M-Australian_Open-R32-Gael_Monfils-Rafael_Nadal,2,F-DTL,18,6,3,0,3,11,7
20140118-M-Australian_Open-R32-Gael_Monfils-Rafael_Nadal,2,F-IO,45,13,3,7,3,32,13
20140118-M-Australian_Open-R32-Gael_Monfils-Rafael_Nadal,2,F-II,6,1,0,1,0,5,1
20140118-M-Australian_Open-R32-Gael_Monfils-Rafael_Nadal,2,B-XC,34,9,1,7,1,24,10
20140118-M-Australian_Open-R32-Gael_Monfils-Rafael_Nadal,2,B-DTM,27,4,0,0,4,11,16
20140118-M-Australian_Open-R32-Gael_Monfils-Rafael_Nadal,2,B-DTL,8,1,0,0,1,3,5
20140118-M-Australian_Open-R32-Gael_Monfils-Rafael_Nadal,2,B-IO,3,0,0,0,0,3,0
20140118-M-Australian_Open-R32-Gael_Monfils-Rafael_Nadal,2,B-II,1,1,1,0,0,1,0
20140118-M-Australian_Open-R32-Gael_Monfils-Rafael_Nadal,2,S-XC,3,1,0,0,1,0,3
20140118-M-Australian_Open-R32-Gael_Monfils-Rafael_Nadal,2,S-DTM,12,1,0,1,0,8,4
20140118-M-Australian_Open-R32-Gael_Monfils-Rafael_Nadal,2,S-DTL,7,0,0,0,0,5,2
20140120-M-Australian_Open-R16-Kei_Nishikori-Rafael_Nadal,1,F-XC,106,17,3,4,10,49,57
20140120-M-Australian_Open-R16-Kei_Nishikori-Rafael_Nadal,1,F-DTM,46,8,0,1,7,20,26
20140120-M-Australian_Open-R16-Kei_Nishikori-Rafael_Nadal,1,F-DTL,21,5,2,1,2,11,10
20140120-M-Australian_Open-R16-Kei_Nishikori-Rafael_Nadal,1,F-IO,44,15,7,2,6,23,21
20140120-M-Australian_Open-R16-Kei_Nishikori-Rafael_Nadal,1,F-II,4,2,0,0,2,2,2
20140120-M-Australian_Open-R16-Kei_Nishikori-Rafael_Nadal,1,B-XC,58,14,5,2,7,33,25
20140120-M-Australian_Open-R16-Kei_Nishikori-Rafael_Nadal,1,B-DTM,35,5,0,0,5,14,21
20140120-M-Australian_Open-R16-Kei_Nishikori-Rafael_Nadal,1,B-DTL,30,10,4,2,4,18,12
20140120-M-Australian_Open-R16-Kei_Nishikori-Rafael_Nadal,1,B-IO,8,3,1,1,1,4,4
20140120-M-Australian_Open-R16-Kei_Nishikori-Rafael_Nadal,1,S-XC,2,1,0,0,1,1,1
20140120-M-Australian_Open-R16-Kei_Nishikori-Rafael_Nadal,1,S-DTM,5,0,0,0,0,3,2
20140120-M-Australian_Open-R16-Kei_Nishikori-Rafael_Nadal,1,S-DTL,2,0,0,0,0,1,1
20140120-M-Australian_Open-R16-Kei_Nishikori-Rafael_Nadal,1,S-IO,2,0,0,0,0,1,1
20140120-M-Australian_Open-R16-Kei_Nishikori-Rafael_Nadal,2,F-XC,77,12,1,2,9,30,47
20140120-M-Australian_Open-R16-Kei_Nishikori-Rafael_Nadal,2,F-DTM,41,3,0,1,2,23,18
20140120-M-Australian_Open-R16-Kei_Nishikori-Rafael_Nadal,2,F-DTL,24,8,2,1,5,10,14
20140120-M-Australian_Open-R16-Kei_Nishikori-Rafael_Nadal,2,F-IO,38,16,6,7,3,28,10
20140120-M-Australian_Open-R16-Kei_Nishikori-Rafael_Nadal,2,F-II,4,1,0,1,0,3,1
20140120-M-Australian_Open-R16-Kei_Nishikori-Rafael_Nadal,2,B-XC,42,8,1,3,4,21,21
20140120-M-Australian_Open-R16-Kei_Nishikori-Rafael_Nadal,2,B-DTM,42,4,0,0,4,21,21
20140120-M-Australian_Open-R16-Kei_Nishikori-Rafael_Nadal,2,B-DTL,13,2,2,0,0,9,4
20140120-M-Australian_Open-R16-Kei_Nishikori-Rafael_Nadal,2,B-IO,2,0,0,0,0,2,0
20140120-M-Australian_Open-R16-Kei_Nishikori-Rafael_Nadal,2,S-XC,7,0,0,0,0,3,4
20140120-M-Australian_Open-R16-Kei_Nishikori-Rafael_Nadal,2,S-DTM,39,2,1,0,1,17,22
20140120-M-Australian_Open-R16-Kei_Nishikori-Rafael_Nadal,2,S-DTL,7,0,0,0,0,1,6
20140120-M-Australian_Open-R16-Kei_Nishikori-Rafael_Nadal,2,S-IO,2,0,0,0,0,0,2
20140126-M-Australian_Open-F-Stanislas_Wawrinka-Rafael_Nadal,1,F-XC,75,18,8,3,7,46,29
20140126-M-Australian_Open-F-Stanislas_Wawrinka-Rafael_Nadal,1,F-DTM,34,4,0,1,3,16,18
20140126-M-Australian_Open-F-Stanislas_Wawrinka-Rafael_Nadal,1,F-DTL,8,7,4,1,2,6,2
20140126-M-Australian_Open-F-Stanislas_Wawrinka-Rafael_Nadal,1,F-IO,25,9,3,1,5,12,13
20140126-M-Australian_Open-F-Stanislas_Wawrinka-Rafael_Nadal,1,F-II,9,5,4,1,0,8,1
20140126-M-Australian_Open-F-Stanislas_Wawrinka-Rafael_Nadal,1,B-XC,41,12,4,1,7,26,15
20140126-M-Australian_Open-F-Stanislas_Wawrinka-Rafael_Nadal,1,B-DTM,9,0,0,0,0,5,4
20140126-M-Australian_Open-F-Stanislas_Wawrinka-Rafael_Nadal,1,B-DTL,11,7,4,2,1,10,1
20140126-M-Australian_Open-F-Stanislas_Wawrinka-Rafael_Nadal,1,B-IO,5,1,0,0,1,2,3
20140126-M-Australian_Open-F-Stanislas_Wawrinka-Rafael_Nadal,1,S-XC,2,1,0,1,0,2,0
20140126-M-Australian_Open-F-Stanislas_Wawrinka-Rafael_Nadal,1,S-DTM,7,0,0,0,0,4,3
20140126-M-Australian_Open-F-Stanislas_Wawrinka-Rafael_Nadal,1,S-DTL,2,1,0,0,1,1,1
20140126-M-Australian_Open-F-Stanislas_Wawrinka-Rafael_Nadal,2,F-XC,55,10,4,3,3,23,32
20140126-M-Australian_Open-F-Stanislas_Wawrinka-Rafael_Nadal,2,F-DTM,32,2,0,0,2,10,22
20140126-M-Australian_Open-F-Stanislas_Wawrinka-Rafael_Nadal,2,F-DTL,10,5,0,3,2,5,5
20140126-M-Australian_Open-F-Stanislas_Wawrinka-Rafael_Nadal,2,F-IO,41,14,6,4,4,23,18
20140126-M-Australian_Open-F-Stanislas_Wawrinka-Rafael_Nadal,2,F-II,4,1,1,0,0,2,2
20140126-M-Australian_Open-F-Stanislas_Wawrinka-Rafael_Nadal,2,B-XC,31,6,2,1,3,13,18
20140126-M-Australian_Open-F-Stanislas_Wawrinka-Rafael_Nadal,2,B-DTM,28,2,0,0,2,16,12
20140126-M-Australian_Open-F-Stanislas_Wawrinka-Rafael_Nadal,2,B-DTL,14,3,0,0,3,4,10
20140126-M-Australian_Open-F-Stanislas_Wawrinka-Rafael_Nadal,2,B-IO,5,1,1,0,0,2,3
20140126-M-Australian_Open-F-Stanislas_Wawrinka-Rafael_Nadal,2,B-II,1,0,0,0,0,1,0
20140126-M-Australian_Open-F-Stanislas_Wawrinka-Rafael_Nadal,2,S-XC,3,1,0,0,1,0,3
20140126-M-Australian_Open-F-Stanislas_Wawrinka-Rafael_Nadal,2,S-DTM,11,1,0,0,1,4,7
20140126-M-Australian_Open-F-Stanislas_Wawrinka-Rafael_Nadal,2,S-DTL,3,0,0,0,0,0,3
20140113-M-Australian_Open-R128-Bernard_Tomic-Rafael_Nadal,1,F-XC,8,4,2,1,1,5,3
20140113-M-Australian_Open-R128-Bernard_Tomic-Rafael_Nadal,1,F-DTM,12,0,0,0,0,1,11
20140113-M-Australian_Open-R128-Bernard_Tomic-Rafael_Nadal,1,F-DTL,2,1,1,0,0,1,1
20140113-M-Australian_Open-R128-Bernard_Tomic-Rafael_Nadal,1,F-IO,10,6,4,0,2,6,4
20140113-M-Australian_Open-R128-Bernard_Tomic-Rafael_Nadal,1,F-II,1,0,0,0,0,1,0
20140113-M-Australian_Open-R128-Bernard_Tomic-Rafael_Nadal,1,B-XC,3,0,0,0,0,0,3
20140113-M-Australian_Open-R128-Bernard_Tomic-Rafael_Nadal,1,B-DTM,7,0,0,0,0,1,6
20140113-M-Australian_Open-R128-Bernard_Tomic-Rafael_Nadal,1,B-DTL,4,1,1,0,0,4,0
20140113-M-Australian_Open-R128-Bernard_Tomic-Rafael_Nadal,1,B-IO,1,0,0,0,0,0,1
20140113-M-Australian_Open-R128-Bernard_Tomic-Rafael_Nadal,1,S-XC,1,1,0,0,1,0,1
20140113-M-Australian_Open-R128-Bernard_Tomic-Rafael_Nadal,1,S-DTM,4,0,0,0,0,0,4
20140113-M-Australian_Open-R128-Bernard_Tomic-Rafael_Nadal,1,S-DTL,1,0,0,0,0,0,1
20140113-M-Australian_Open-R128-Bernard_Tomic-Rafael_Nadal,2,F-XC,15,4,3,1,0,13,2
20140113-M-Australian_Open-R128-Bernard_Tomic-Rafael_Nadal,2,F-DTM,9,1,0,0,1,8,1
20140113-M-Australian_Open-R128-Bernard_Tomic-Rafael_Nadal,2,F-DTL,1,1,1,0,0,1,0
20140113-M-Australian_Open-R128-Bernard_Tomic-Rafael_Nadal,2,F-IO,9,2,1,1,0,7,2
20140113-M-Australian_Open-R128-Bernard_Tomic-Rafael_Nadal,2,F-II,1,0,0,0,0,0,1
20140113-M-Australian_Open-R128-Bernard_Tomic-Rafael_Nadal,2,B-XC,2,1,1,0,0,1,1
20140113-M-Australian_Open-R128-Bernard_Tomic-Rafael_Nadal,2,B-DTM,2,1,0,0,1,1,1
20140113-M-Australian_Open-R128-Bernard_Tomic-Rafael_Nadal,2,B-IO,1,0,0,0,0,1,0
20140113-M-Australian_Open-R128-Bernard_Tomic-Rafael_Nadal,2,S-XC,1,0,0,0,0,1,0
20140113-M-Australian_Open-R128-Bernard_Tomic-Rafael_Nadal,2,S-DTM,5,0,0,0,0,2,3
20140113-M-Australian_Open-R128-Bernard_Tomic-Rafael_Nadal,2,S-DTL,1,0,0,0,0,0,1
20130810-M-Aptos_CH-SF-Bradley_Klahn-Evgeny_Donskoy,1,F-XC,70,8,3,2,3,48,22
20130810-M-Aptos_CH-SF-Bradley_Klahn-Evgeny_Donskoy,1,F-DTM,41,2,0,1,1,28,13
20130810-M-Aptos_CH-SF-Bradley_Klahn-Evgeny_Donskoy,1,F-DTL,9,4,3,0,1,7,2
20130810-M-Aptos_CH-SF-Bradley_Klahn-Evgeny_Donskoy,1,F-IO,24,8,1,3,4,13,11
20130810-M-Aptos_CH-SF-Bradley_Klahn-Evgeny_Donskoy,1,F-II,3,2,0,1,1,2,1
20130810-M-Aptos_CH-SF-Bradley_Klahn-Evgeny_Donskoy,1,B-XC,6,1,0,0,1,2,4
20130810-M-Aptos_CH-SF-Bradley_Klahn-Evgeny_Donskoy,1,B-DTM,30,4,0,0,4,11,19
20130810-M-Aptos_CH-SF-Bradley_Klahn-Evgeny_Donskoy,1,B-DTL,10,8,0,0,8,2,8
20130810-M-Aptos_CH-SF-Bradley_Klahn-Evgeny_Donskoy,1,B-IO,4,1,0,0,1,2,2
20130810-M-Aptos_CH-SF-Bradley_Klahn-Evgeny_Donskoy,1,S-XC,5,1,0,0,1,2,3
20130810-M-Aptos_CH-SF-Bradley_Klahn-Evgeny_Donskoy,1,S-DTM,17,3,0,0,3,7,10
20130810-M-Aptos_CH-SF-Bradley_Klahn-Evgeny_Donskoy,1,S-DTL,2,0,0,0,0,1,1
20130810-M-Aptos_CH-SF-Bradley_Klahn-Evgeny_Donskoy,1,S-IO,8,0,0,0,0,5,3
20130810-M-Aptos_CH-SF-Bradley_Klahn-Evgeny_Donskoy,2,F-XC,59,13,1,3,9,31,28
20130810-M-Aptos_CH-SF-Bradley_Klahn-Evgeny_Donskoy,2,F-DTM,34,8,0,0,8,10,24
20130810-M-Aptos_CH-SF-Bradley_Klahn-Evgeny_Donskoy,2,F-DTL,7,5,2,1,2,3,4
20130810-M-Aptos_CH-SF-Bradley_Klahn-Evgeny_Donskoy,2,F-IO,17,8,0,2,6,7,10
20130810-M-Aptos_CH-SF-Bradley_Klahn-Evgeny_Donskoy,2,F-II,3,0,0,0,0,2,1
20130810-M-Aptos_CH-SF-Bradley_Klahn-Evgeny_Donskoy,2,B-XC,48,11,2,1,8,13,35
20130810-M-Aptos_CH-SF-Bradley_Klahn-Evgeny_Donskoy,2,B-DTM,44,3,0,0,3,18,26
20130810-M-Aptos_CH-SF-Bradley_Klahn-Evgeny_Donskoy,2,B-DTL,6,2,0,0,2,2,4
20130810-M-Aptos_CH-SF-Bradley_Klahn-Evgeny_Donskoy,2,B-IO,6,1,0,0,1,4,2
20130810-M-Aptos_CH-SF-Bradley_Klahn-Evgeny_Donskoy,2,S-XC,2,1,0,0,1,0,2
20130810-M-Aptos_CH-SF-Bradley_Klahn-Evgeny_Donskoy,2,S-DTM,6,0,0,0,0,0,6
20130810-M-Aptos_CH-SF-Bradley_Klahn-Evgeny_Donskoy,2,S-DTL,3,0,0,0,0,2,1
20130810-M-Aptos_CH-SF-Bradley_Klahn-Evgeny_Donskoy,2,S-IO,1,0,0,0,0,1,0
20140110-M-Auckland-SF-David_Ferrer-Yen_Hsun_Lu,1,F-XC,37,9,3,1,5,19,18
20140110-M-Auckland-SF-David_Ferrer-Yen_Hsun_Lu,1,F-DTM,36,8,1,0,7,14,22
20140110-M-Auckland-SF-David_Ferrer-Yen_Hsun_Lu,1,F-DTL,4,2,1,0,1,2,2
20140110-M-Auckland-SF-David_Ferrer-Yen_Hsun_Lu,1,F-IO,28,7,3,0,4,12,16
20140110-M-Auckland-SF-David_Ferrer-Yen_Hsun_Lu,1,F-II,2,1,0,0,1,0,2
20140110-M-Auckland-SF-David_Ferrer-Yen_Hsun_Lu,1,B-XC,31,5,0,1,4,16,15
20140110-M-Auckland-SF-David_Ferrer-Yen_Hsun_Lu,1,B-DTM,40,6,0,0,6,15,25
20140110-M-Auckland-SF-David_Ferrer-Yen_Hsun_Lu,1,B-DTL,2,1,0,0,1,1,1
20140110-M-Auckland-SF-David_Ferrer-Yen_Hsun_Lu,1,B-IO,1,1,0,1,0,1,0
20140110-M-Auckland-SF-David_Ferrer-Yen_Hsun_Lu,1,S-XC,3,0,0,0,0,3,0
20140110-M-Auckland-SF-David_Ferrer-Yen_Hsun_Lu,1,S-DTL,2,0,0,0,0,0,2
20140110-M-Auckland-SF-David_Ferrer-Yen_Hsun_Lu,2,F-XC,28,10,1,1,8,15,13
20140110-M-Auckland-SF-David_Ferrer-Yen_Hsun_Lu,2,F-DTM,22,0,0,0,0,14,8
20140110-M-Auckland-SF-David_Ferrer-Yen_Hsun_Lu,2,F-DTL,7,4,1,0,3,3,4
20140110-M-Auckland-SF-David_Ferrer-Yen_Hsun_Lu,2,F-IO,26,6,3,0,3,14,12
20140110-M-Auckland-SF-David_Ferrer-Yen_Hsun_Lu,2,F-II,3,1,0,0,1,0,3
20140110-M-Auckland-SF-David_Ferrer-Yen_Hsun_Lu,2,B-XC,37,8,1,2,5,20,17
20140110-M-Auckland-SF-David_Ferrer-Yen_Hsun_Lu,2,B-DTM,26,3,0,0,3,10,16
20140110-M-Auckland-SF-David_Ferrer-Yen_Hsun_Lu,2,B-DTL,12,4,0,2,2,9,3
20140110-M-Auckland-SF-David_Ferrer-Yen_Hsun_Lu,2,B-IO,4,1,0,1,0,3,1
20140110-M-Auckland-SF-David_Ferrer-Yen_Hsun_Lu,2,S-XC,3,0,0,0,0,2,1
20140110-M-Auckland-SF-David_Ferrer-Yen_Hsun_Lu,2,S-DTM,3,1,0,0,1,1,2
20140110-M-Auckland-SF-David_Ferrer-Yen_Hsun_Lu,2,S-DTL,3,2,0,0,2,0,3
20140110-M-Auckland-SF-David_Ferrer-Yen_Hsun_Lu,2,S-IO,1,1,0,0,1,0,1
20140107-M-Auckland-R32-Michal_Przysiezny-Benoit_Paire,1,F-XC,10,2,1,0,1,6,4
20140107-M-Auckland-R32-Michal_Przysiezny-Benoit_Paire,1,F-DTM,18,7,0,0,7,2,16
20140107-M-Auckland-R32-Michal_Przysiezny-Benoit_Paire,1,F-DTL,1,0,0,0,0,1,0
20140107-M-Auckland-R32-Michal_Przysiezny-Benoit_Paire,1,F-IO,8,2,0,0,2,4,4
20140107-M-Auckland-R32-Michal_Przysiezny-Benoit_Paire,1,F-II,2,2,0,0,2,0,2
20140107-M-Auckland-R32-Michal_Przysiezny-Benoit_Paire,1,B-XC,5,2,0,0,2,2,3
20140107-M-Auckland-R32-Michal_Przysiezny-Benoit_Paire,1,B-DTM,7,2,0,0,2,1,6
20140107-M-Auckland-R32-Michal_Przysiezny-Benoit_Paire,1,B-DTL,3,3,1,0,2,1,2
20140107-M-Auckland-R32-Michal_Przysiezny-Benoit_Paire,1,B-IO,2,1,0,0,1,1,1
20140107-M-Auckland-R32-Michal_Przysiezny-Benoit_Paire,1,S-XC,2,1,0,0,1,1,1
20140107-M-Auckland-R32-Michal_Przysiezny-Benoit_Paire,1,S-DTM,2,0,0,0,0,0,2
20140107-M-Auckland-R32-Michal_Przysiezny-Benoit_Paire,1,S-DTL,3,1,0,0,1,1,2
20140107-M-Auckland-R32-Michal_Przysiezny-Benoit_Paire,1,S-IO,1,0,0,0,0,0,1
20140107-M-Auckland-R32-Michal_Przysiezny-Benoit_Paire,2,F-XC,9,3,1,0,2,6,3
20140107-M-Auckland-R32-Michal_Przysiezny-Benoit_Paire,2,F-DTM,9,1,0,0,1,6,3
20140107-M-Auckland-R32-Michal_Przysiezny-Benoit_Paire,2,F-DTL,2,2,1,0,1,1,1
20140107-M-Auckland-R32-Michal_Przysiezny-Benoit_Paire,2,F-IO,6,4,3,0,1,5,1
20140107-M-Auckland-R32-Michal_Przysiezny-Benoit_Paire,2,B-XC,11,1,0,0,1,8,3
20140107-M-Auckland-R32-Michal_Przysiezny-Benoit_Paire,2,B-DTM,4,0,0,0,0,3,1
20140107-M-Auckland-R32-Michal_Przysiezny-Benoit_Paire,2,B-DTL,2,2,0,0,2,0,2
20140107-M-Auckland-R32-Michal_Przysiezny-Benoit_Paire,2,B-IO,2,1,1,0,0,2,0
20140107-M-Auckland-R32-Michal_Przysiezny-Benoit_Paire,2,S-XC,1,0,0,0,0,0,1
20140107-M-Auckland-R32-Michal_Przysiezny-Benoit_Paire,2,S-DTM,1,1,0,0,1,0,1
20140107-M-Auckland-R32-Michal_Przysiezny-Benoit_Paire,2,S-II,1,0,0,0,0,1,0
20140108-M-Auckland-R16-Tommy_Haas-Jack_Sock,1,F-XC,27,12,3,4,5,15,12
20140108-M-Auckland-R16-Tommy_Haas-Jack_Sock,1,F-DTM,21,3,0,0,3,11,10
20140108-M-Auckland-R16-Tommy_Haas-Jack_Sock,1,F-DTL,1,0,0,0,0,1,0
20140108-M-Auckland-R16-Tommy_Haas-Jack_Sock,1,F-IO,13,4,1,0,3,4,9
20140108-M-Auckland-R16-Tommy_Haas-Jack_Sock,1,F-II,2,2,0,2,0,2,0
20140108-M-Auckland-R16-Tommy_Haas-Jack_Sock,1,B-XC,14,2,0,0,2,8,6
20140108-M-Auckland-R16-Tommy_Haas-Jack_Sock,1,B-DTM,11,0,0,0,0,6,5
20140108-M-Auckland-R16-Tommy_Haas-Jack_Sock,1,B-DTL,4,2,1,0,1,3,1
20140108-M-Auckland-R16-Tommy_Haas-Jack_Sock,1,B-IO,3,2,1,0,1,1,2
20140108-M-Auckland-R16-Tommy_Haas-Jack_Sock,1,S-XC,12,0,0,0,0,11,1
20140108-M-Auckland-R16-Tommy_Haas-Jack_Sock,1,S-DTM,4,0,0,0,0,2,2
20140108-M-Auckland-R16-Tommy_Haas-Jack_Sock,1,S-DTL,3,0,0,0,0,2,1
20140108-M-Auckland-R16-Tommy_Haas-Jack_Sock,2,F-XC,12,7,2,3,2,8,4
20140108-M-Auckland-R16-Tommy_Haas-Jack_Sock,2,F-DTM,25,2,0,0,2,8,17
20140108-M-Auckland-R16-Tommy_Haas-Jack_Sock,2,F-DTL,5,4,2,0,2,3,2
20140108-M-Auckland-R16-Tommy_Haas-Jack_Sock,2,F-IO,23,3,2,0,1,10,13
20140108-M-Auckland-R16-Tommy_Haas-Jack_Sock,2,F-II,3,0,0,0,0,0,3
20140108-M-Auckland-R16-Tommy_Haas-Jack_Sock,2,B-XC,3,1,0,0,1,0,3
20140108-M-Auckland-R16-Tommy_Haas-Jack_Sock,2,B-DTM,14,2,0,0,2,10,4
20140108-M-Auckland-R16-Tommy_Haas-Jack_Sock,2,B-DTL,1,0,0,0,0,1,0
20140108-M-Auckland-R16-Tommy_Haas-Jack_Sock,2,B-IO,2,2,1,0,1,1,1
20140108-M-Auckland-R16-Tommy_Haas-Jack_Sock,2,S-XC,8,2,1,0,1,4,4
20140108-M-Auckland-R16-Tommy_Haas-Jack_Sock,2,S-DTM,8,1,0,0,1,4,4
20140108-M-Auckland-R16-Tommy_Haas-Jack_Sock,2,S-DTL,1,1,0,0,1,0,1
20140109-M-Auckland-QF-Roberto_Bautista_Agut-Jack_Sock,1,F-XC,34,7,2,0,5,21,13
20140109-M-Auckland-QF-Roberto_Bautista_Agut-Jack_Sock,1,F-DTM,12,1,0,1,0,11,1
20140109-M-Auckland-QF-Roberto_Bautista_Agut-Jack_Sock,1,F-DTL,16,6,3,2,1,11,5
20140109-M-Auckland-QF-Roberto_Bautista_Agut-Jack_Sock,1,F-IO,40,4,1,1,2,31,9
20140109-M-Auckland-QF-Roberto_Bautista_Agut-Jack_Sock,1,F-II,3,2,1,0,1,2,1
20140109-M-Auckland-QF-Roberto_Bautista_Agut-Jack_Sock,1,B-XC,11,0,0,0,0,6,5
20140109-M-Auckland-QF-Roberto_Bautista_Agut-Jack_Sock,1,B-DTM,14,0,0,0,0,6,8
20140109-M-Auckland-QF-Roberto_Bautista_Agut-Jack_Sock,1,B-DTL,4,3,1,1,1,3,1
20140109-M-Auckland-QF-Roberto_Bautista_Agut-Jack_Sock,1,B-II,1,0,0,0,0,1,0
20140109-M-Auckland-QF-Roberto_Bautista_Agut-Jack_Sock,1,S-XC,3,1,0,0,1,0,3
20140109-M-Auckland-QF-Roberto_Bautista_Agut-Jack_Sock,1,S-DTM,3,0,0,0,0,3,0
20140109-M-Auckland-QF-Roberto_Bautista_Agut-Jack_Sock,1,S-DTL,1,0,0,0,0,1,0
20140109-M-Auckland-QF-Roberto_Bautista_Agut-Jack_Sock,2,F-XC,19,4,1,0,3,7,12
20140109-M-Auckland-QF-Roberto_Bautista_Agut-Jack_Sock,2,F-DTM,14,2,0,0,2,5,9
20140109-M-Auckland-QF-Roberto_Bautista_Agut-Jack_Sock,2,F-DTL,10,3,1,0,2,3,7
20140109-M-Auckland-QF-Roberto_Bautista_Agut-Jack_Sock,2,F-IO,26,11,3,0,8,11,15
20140109-M-Auckland-QF-Roberto_Bautista_Agut-Jack_Sock,2,F-II,3,1,0,0,1,0,3
20140109-M-Auckland-QF-Roberto_Bautista_Agut-Jack_Sock,2,B-XC,9,5,1,0,3,5,4
20140109-M-Auckland-QF-Roberto_Bautista_Agut-Jack_Sock,2,B-DTM,23,3,0,0,3,7,16
20140109-M-Auckland-QF-Roberto_Bautista_Agut-Jack_Sock,2,B-DTL,9,5,2,0,3,3,6
20140109-M-Auckland-QF-Roberto_Bautista_Agut-Jack_Sock,2,B-IO,2,0,0,0,0,0,2
20140109-M-Auckland-QF-Roberto_Bautista_Agut-Jack_Sock,2,S-XC,6,0,0,0,0,1,5
20140109-M-Auckland-QF-Roberto_Bautista_Agut-Jack_Sock,2,S-DTM,15,3,0,0,3,1,14
20140109-M-Auckland-QF-Roberto_Bautista_Agut-Jack_Sock,2,S-DTL,4,0,0,0,0,1,3
20140109-M-Auckland-QF-Roberto_Bautista_Agut-Jack_Sock,2,S-IO,2,0,0,0,0,2,0
20140107-M-Auckland-R32-Jose_Rubin_Statham-Lukas_Lacko,1,F-XC,12,3,1,1,1,4,8
20140107-M-Auckland-R32-Jose_Rubin_Statham-Lukas_Lacko,1,F-DTM,33,5,0,0,5,12,21
20140107-M-Auckland-R32-Jose_Rubin_Statham-Lukas_Lacko,1,F-DTL,11,1,0,0,1,8,3
20140107-M-Auckland-R32-Jose_Rubin_Statham-Lukas_Lacko,1,F-IO,33,3,0,0,3,17,16
20140107-M-Auckland-R32-Jose_Rubin_Statham-Lukas_Lacko,1,F-II,1,1,0,0,1,0,1
20140107-M-Auckland-R32-Jose_Rubin_Statham-Lukas_Lacko,1,B-XC,44,7,0,0,7,16,28
20140107-M-Auckland-R32-Jose_Rubin_Statham-Lukas_Lacko,1,B-DTM,34,1,0,0,1,13,21
20140107-M-Auckland-R32-Jose_Rubin_Statham-Lukas_Lacko,1,B-DTL,6,3,2,0,1,3,3
20140107-M-Auckland-R32-Jose_Rubin_Statham-Lukas_Lacko,1,B-IO,7,3,2,0,1,5,2
20140107-M-Auckland-R32-Jose_Rubin_Statham-Lukas_Lacko,1,B-II,1,0,0,0,0,0,1
20140107-M-Auckland-R32-Jose_Rubin_Statham-Lukas_Lacko,1,S-XC,3,0,0,0,0,2,1
20140107-M-Auckland-R32-Jose_Rubin_Statham-Lukas_Lacko,1,S-DTM,5,0,0,0,0,0,5
20140107-M-Auckland-R32-Jose_Rubin_Statham-Lukas_Lacko,1,S-IO,1,0,0,0,0,1,0
20140107-M-Auckland-R32-Jose_Rubin_Statham-Lukas_Lacko,2,F-XC,47,12,5,2,5,30,17
20140107-M-Auckland-R32-Jose_Rubin_Statham-Lukas_Lacko,2,F-DTM,32,4,2,0,2,19,13
20140107-M-Auckland-R32-Jose_Rubin_Statham-Lukas_Lacko,2,F-DTL,6,3,3,0,0,6,0
20140107-M-Auckland-R32-Jose_Rubin_Statham-Lukas_Lacko,2,F-IO,16,7,3,1,3,8,8
20140107-M-Auckland-R32-Jose_Rubin_Statham-Lukas_Lacko,2,F-II,4,1,0,0,1,2,2
20140107-M-Auckland-R32-Jose_Rubin_Statham-Lukas_Lacko,2,B-XC,58,6,2,0,4,32,26
20140107-M-Auckland-R32-Jose_Rubin_Statham-Lukas_Lacko,2,B-DTM,19,3,0,1,2,6,13
20140107-M-Auckland-R32-Jose_Rubin_Statham-Lukas_Lacko,2,B-DTL,10,7,1,0,6,2,8
20140107-M-Auckland-R32-Jose_Rubin_Statham-Lukas_Lacko,2,B-IO,2,1,1,0,0,1,1
20140107-M-Auckland-R32-Jose_Rubin_Statham-Lukas_Lacko,2,S-XC,5,0,0,0,0,3,2
20140107-M-Auckland-R32-Jose_Rubin_Statham-Lukas_Lacko,2,S-DTM,2,0,0,0,0,2,0
20130830-M-US_Open-R64-Kevin_Anderson-Marcos_Baghdatis,1,F-XC,9,2,1,0,1,3,6
20130830-M-US_Open-R64-Kevin_Anderson-Marcos_Baghdatis,1,F-DTM,15,4,1,0,3,5,10
20130830-M-US_Open-R64-Kevin_Anderson-Marcos_Baghdatis,1,F-DTL,1,0,0,0,0,0,1
20130830-M-US_Open-R64-Kevin_Anderson-Marcos_Baghdatis,1,F-IO,5,4,0,1,3,1,4
20130830-M-US_Open-R64-Kevin_Anderson-Marcos_Baghdatis,1,B-XC,6,2,0,0,2,1,5
20130830-M-US_Open-R64-Kevin_Anderson-Marcos_Baghdatis,1,B-DTM,4,0,0,0,0,1,3
20130830-M-US_Open-R64-Kevin_Anderson-Marcos_Baghdatis,1,B-DTL,1,1,0,0,1,0,1
20130830-M-US_Open-R64-Kevin_Anderson-Marcos_Baghdatis,1,S-XC,13,0,0,0,0,2,11
20130830-M-US_Open-R64-Kevin_Anderson-Marcos_Baghdatis,1,S-DTM,6,2,0,0,2,2,4
20130830-M-US_Open-R64-Kevin_Anderson-Marcos_Baghdatis,1,S-DTL,1,0,0,0,0,1,0
20130830-M-US_Open-R64-Kevin_Anderson-Marcos_Baghdatis,1,S-IO,6,3,0,0,3,2,4
20130830-M-US_Open-R64-Kevin_Anderson-Marcos_Baghdatis,2,F-XC,7,2,2,0,0,5,2
20130830-M-US_Open-R64-Kevin_Anderson-Marcos_Baghdatis,2,F-DTM,22,3,0,0,3,10,12
20130830-M-US_Open-R64-Kevin_Anderson-Marcos_Baghdatis,2,F-DTL,2,1,1,0,0,2,0
20130830-M-US_Open-R64-Kevin_Anderson-Marcos_Baghdatis,2,F-IO,9,1,1,0,0,9,0
20130830-M-US_Open-R64-Kevin_Anderson-Marcos_Baghdatis,2,F-II,4,3,3,0,0,4,0
20130830-M-US_Open-R64-Kevin_Anderson-Marcos_Baghdatis,2,B-XC,6,2,0,0,2,4,2
20130830-M-US_Open-R64-Kevin_Anderson-Marcos_Baghdatis,2,B-DTM,9,0,0,0,0,8,1
20130830-M-US_Open-R64-Kevin_Anderson-Marcos_Baghdatis,2,B-DTL,4,4,3,0,1,3,1
20130830-M-US_Open-R64-Kevin_Anderson-Marcos_Baghdatis,2,B-IO,1,1,0,0,1,0,1
20130830-M-US_Open-R64-Kevin_Anderson-Marcos_Baghdatis,2,S-XC,4,0,0,0,0,3,1
20130830-M-US_Open-R64-Kevin_Anderson-Marcos_Baghdatis,2,S-DTM,2,1,0,0,1,1,1
20130830-M-US_Open-R64-Kevin_Anderson-Marcos_Baghdatis,2,S-DTL,2,1,1,0,0,2,0
20130828-M-US_Open-R128-Lleyton_Hewitt-Brian_Baker,1,F-XC,52,13,5,2,6,28,24
20130828-M-US_Open-R128-Lleyton_Hewitt-Brian_Baker,1,F-DTM,35,5,0,2,3,20,15
20130828-M-US_Open-R128-Lleyton_Hewitt-Brian_Baker,1,F-DTL,5,1,1,0,0,4,1
20130828-M-US_Open-R128-Lleyton_Hewitt-Brian_Baker,1,F-IO,13,2,0,0,2,7,6
20130828-M-US_Open-R128-Lleyton_Hewitt-Brian_Baker,1,F-II,3,2,0,0,2,0,3
20130828-M-US_Open-R128-Lleyton_Hewitt-Brian_Baker,1,B-XC,35,6,1,2,3,16,19
20130828-M-US_Open-R128-Lleyton_Hewitt-Brian_Baker,1,B-DTM,37,3,0,0,2,15,22
20130828-M-US_Open-R128-Lleyton_Hewitt-Brian_Baker,1,B-IO,8,2,2,0,0,3,5
20130828-M-US_Open-R128-Lleyton_Hewitt-Brian_Baker,1,S-XC,24,2,0,0,2,13,11
20130828-M-US_Open-R128-Lleyton_Hewitt-Brian_Baker,1,S-DTM,19,0,0,0,0,8,11
20130828-M-US_Open-R128-Lleyton_Hewitt-Brian_Baker,1,S-DTL,1,0,0,0,0,0,1
20130828-M-US_Open-R128-Lleyton_Hewitt-Brian_Baker,1,S-IO,2,0,0,0,0,1,1
20130828-M-US_Open-R128-Lleyton_Hewitt-Brian_Baker,2,F-XC,28,9,2,0,7,11,17
20130828-M-US_Open-R128-Lleyton_Hewitt-Brian_Baker,2,F-DTM,42,8,0,0,8,20,22
20130828-M-US_Open-R128-Lleyton_Hewitt-Brian_Baker,2,F-DTL,15,7,6,0,1,10,5
20130828-M-US_Open-R128-Lleyton_Hewitt-Brian_Baker,2,F-IO,15,4,0,1,3,5,10
20130828-M-US_Open-R128-Lleyton_Hewitt-Brian_Baker,2,F-II,2,1,0,0,1,0,2
20130828-M-US_Open-R128-Lleyton_Hewitt-Brian_Baker,2,B-XC,29,4,1,1,2,18,11
20130828-M-US_Open-R128-Lleyton_Hewitt-Brian_Baker,2,B-DTM,24,4,0,0,4,9,15
20130828-M-US_Open-R128-Lleyton_Hewitt-Brian_Baker,2,B-DTL,16,11,6,0,5,7,9
20130828-M-US_Open-R128-Lleyton_Hewitt-Brian_Baker,2,B-IO,9,5,2,0,3,4,5
20130828-M-US_Open-R128-Lleyton_Hewitt-Brian_Baker,2,B-II,1,0,0,0,0,1,0
20130828-M-US_Open-R128-Lleyton_Hewitt-Brian_Baker,2,S-XC,18,1,0,0,1,11,7
20130828-M-US_Open-R128-Lleyton_Hewitt-Brian_Baker,2,S-DTM,24,1,0,0,1,9,15
20130828-M-US_Open-R128-Lleyton_Hewitt-Brian_Baker,2,S-DTL,3,0,0,0,0,0,3
20140424-M-Barcelona-R16-Ivan_Dodig-Rafael_Nadal,1,F-XC,44,3,1,1,1,21,23
20140424-M-Barcelona-R16-Ivan_Dodig-Rafael_Nadal,1,F-DTM,20,4,0,0,4,4,16
20140424-M-Barcelona-R16-Ivan_Dodig-Rafael_Nadal,1,F-DTL,15,6,1,3,2,7,8
20140424-M-Barcelona-R16-Ivan_Dodig-Rafael_Nadal,1,F-IO,6,3,0,0,3,0,6
20140424-M-Barcelona-R16-Ivan_Dodig-Rafael_Nadal,1,F-II,3,0,0,0,0,1,2
20140424-M-Barcelona-R16-Ivan_Dodig-Rafael_Nadal,1,B-XC,28,3,0,1,2,10,18
20140424-M-Barcelona-R16-Ivan_Dodig-Rafael_Nadal,1,B-DTM,34,1,0,0,1,6,28
20140424-M-Barcelona-R16-Ivan_Dodig-Rafael_Nadal,1,B-DTL,11,3,0,0,3,2,9
20140424-M-Barcelona-R16-Ivan_Dodig-Rafael_Nadal,1,B-IO,2,0,0,0,0,1,1
20140424-M-Barcelona-R16-Ivan_Dodig-Rafael_Nadal,1,S-DTM,9,1,0,0,1,3,6
20140424-M-Barcelona-R16-Ivan_Dodig-Rafael_Nadal,1,S-DTL,3,0,0,0,0,0,3
20140424-M-Barcelona-R16-Ivan_Dodig-Rafael_Nadal,2,F-XC,74,11,2,3,6,56,18
20140424-M-Barcelona-R16-Ivan_Dodig-Rafael_Nadal,2,F-DTM,18,0,0,0,0,10,8
20140424-M-Barcelona-R16-Ivan_Dodig-Rafael_Nadal,2,F-DTL,8,5,2,2,1,7,1
20140424-M-Barcelona-R16-Ivan_Dodig-Rafael_Nadal,2,F-IO,35,14,3,10,1,26,9
20140424-M-Barcelona-R16-Ivan_Dodig-Rafael_Nadal,2,F-II,8,2,1,0,1,4,4
20140424-M-Barcelona-R16-Ivan_Dodig-Rafael_Nadal,2,B-XC,26,6,0,3,3,15,11
20140424-M-Barcelona-R16-Ivan_Dodig-Rafael_Nadal,2,B-DTM,14,2,0,0,2,8,6
20140424-M-Barcelona-R16-Ivan_Dodig-Rafael_Nadal,2,B-DTL,8,2,1,1,0,7,1
20140424-M-Barcelona-R16-Ivan_Dodig-Rafael_Nadal,2,B-IO,1,0,0,0,0,0,1
20140424-M-Barcelona-R16-Ivan_Dodig-Rafael_Nadal,2,S-XC,2,1,0,0,1,1,1
20140424-M-Barcelona-R16-Ivan_Dodig-Rafael_Nadal,2,S-DTM,1,0,0,0,0,1,0
20140425-M-Barcelona-QF-Nicolas_Almagro-Rafael_Nadal,1,F-XC,133,18,4,6,8,70,63
20140425-M-Barcelona-QF-Nicolas_Almagro-Rafael_Nadal,1,F-DTM,31,2,0,2,0,13,18
20140425-M-Barcelona-QF-Nicolas_Almagro-Rafael_Nadal,1,F-DTL,31,22,6,1,15,13,18
20140425-M-Barcelona-QF-Nicolas_Almagro-Rafael_Nadal,1,F-IO,22,12,4,4,4,15,7
20140425-M-Barcelona-QF-Nicolas_Almagro-Rafael_Nadal,1,F-II,7,1,1,0,0,5,2
20140425-M-Barcelona-QF-Nicolas_Almagro-Rafael_Nadal,1,B-XC,56,21,9,4,8,31,25
20140425-M-Barcelona-QF-Nicolas_Almagro-Rafael_Nadal,1,B-DTM,39,3,0,1,2,16,23
20140425-M-Barcelona-QF-Nicolas_Almagro-Rafael_Nadal,1,B-DTL,23,8,2,0,6,11,12
20140425-M-Barcelona-QF-Nicolas_Almagro-Rafael_Nadal,1,B-IO,12,4,1,2,1,7,5
20140425-M-Barcelona-QF-Nicolas_Almagro-Rafael_Nadal,1,S-XC,1,0,0,0,0,1,0
20140425-M-Barcelona-QF-Nicolas_Almagro-Rafael_Nadal,1,S-DTM,6,0,0,0,0,1,5
20140425-M-Barcelona-QF-Nicolas_Almagro-Rafael_Nadal,1,S-DTL,2,1,0,0,1,0,2
20140425-M-Barcelona-QF-Nicolas_Almagro-Rafael_Nadal,2,F-XC,67,7,1,0,6,32,35
20140425-M-Barcelona-QF-Nicolas_Almagro-Rafael_Nadal,2,F-DTM,24,3,0,0,3,11,13
20140425-M-Barcelona-QF-Nicolas_Almagro-Rafael_Nadal,2,F-DTL,16,3,3,0,0,11,5
20140425-M-Barcelona-QF-Nicolas_Almagro-Rafael_Nadal,2,F-IO,45,12,6,3,3,27,18
20140425-M-Barcelona-QF-Nicolas_Almagro-Rafael_Nadal,2,F-II,11,4,2,1,1,6,5
20140425-M-Barcelona-QF-Nicolas_Almagro-Rafael_Nadal,2,B-XC,71,10,4,3,3,37,34
20140425-M-Barcelona-QF-Nicolas_Almagro-Rafael_Nadal,2,B-DTM,42,1,0,0,1,18,24
20140425-M-Barcelona-QF-Nicolas_Almagro-Rafael_Nadal,2,B-DTL,31,5,2,1,2,17,14
20140425-M-Barcelona-QF-Nicolas_Almagro-Rafael_Nadal,2,B-IO,5,0,0,0,0,4,1
20140425-M-Barcelona-QF-Nicolas_Almagro-Rafael_Nadal,2,B-II,1,0,0,0,0,1,0
20140425-M-Barcelona-QF-Nicolas_Almagro-Rafael_Nadal,2,S-XC,2,0,0,0,0,1,1
20140425-M-Barcelona-QF-Nicolas_Almagro-Rafael_Nadal,2,S-DTM,11,1,0,1,0,3,8
20140425-M-Barcelona-QF-Nicolas_Almagro-Rafael_Nadal,2,S-DTL,3,1,0,1,0,2,1
20140425-M-Barcelona-QF-Nicolas_Almagro-Rafael_Nadal,2,S-IO,1,0,0,0,0,1,0
20140423-M-Barcelona-R32-Albert_Ramos-Rafael_Nadal,1,F-XC,63,17,7,2,8,32,31
20140423-M-Barcelona-R32-Albert_Ramos-Rafael_Nadal,1,F-DTM,38,3,0,1,2,17,21
20140423-M-Barcelona-R32-Albert_Ramos-Rafael_Nadal,1,F-DTL,10,2,0,0,2,3,7
20140423-M-Barcelona-R32-Albert_Ramos-Rafael_Nadal,1,F-IO,37,11,4,1,6,17,20
20140423-M-Barcelona-R32-Albert_Ramos-Rafael_Nadal,1,F-II,2,1,0,0,1,0,2
20140423-M-Barcelona-R32-Albert_Ramos-Rafael_Nadal,1,B-XC,70,8,0,0,8,26,44
20140423-M-Barcelona-R32-Albert_Ramos-Rafael_Nadal,1,B-DTM,38,2,0,0,2,14,24
20140423-M-Barcelona-R32-Albert_Ramos-Rafael_Nadal,1,B-DTL,10,3,2,0,1,4,6
20140423-M-Barcelona-R32-Albert_Ramos-Rafael_Nadal,1,B-IO,2,0,0,0,0,1,1
20140423-M-Barcelona-R32-Albert_Ramos-Rafael_Nadal,1,S-XC,5,0,0,0,0,3,2
20140423-M-Barcelona-R32-Albert_Ramos-Rafael_Nadal,1,S-DTM,5,0,0,0,0,0,5
20140423-M-Barcelona-R32-Albert_Ramos-Rafael_Nadal,1,S-DTL,1,0,0,0,0,1,0
20140423-M-Barcelona-R32-Albert_Ramos-Rafael_Nadal,2,F-XC,56,12,3,5,4,33,23
20140423-M-Barcelona-R32-Albert_Ramos-Rafael_Nadal,2,F-DTM,36,4,0,0,4,22,14
20140423-M-Barcelona-R32-Albert_Ramos-Rafael_Nadal,2,F-DTL,19,5,1,1,3,10,9
20140423-M-Barcelona-R32-Albert_Ramos-Rafael_Nadal,2,F-IO,70,10,2,4,4,47,23
20140423-M-Barcelona-R32-Albert_Ramos-Rafael_Nadal,2,F-II,14,8,3,2,3,10,4
20140423-M-Barcelona-R32-Albert_Ramos-Rafael_Nadal,2,B-XC,44,2,0,0,2,24,20
20140423-M-Barcelona-R32-Albert_Ramos-Rafael_Nadal,2,B-DTM,22,2,0,0,2,12,10
20140423-M-Barcelona-R32-Albert_Ramos-Rafael_Nadal,2,B-DTL,10,4,1,1,2,4,6
20140423-M-Barcelona-R32-Albert_Ramos-Rafael_Nadal,2,B-IO,6,0,0,0,0,3,3
20140423-M-Barcelona-R32-Albert_Ramos-Rafael_Nadal,2,S-XC,5,2,0,1,1,1,4
20140423-M-Barcelona-R32-Albert_Ramos-Rafael_Nadal,2,S-DTM,2,0,0,0,0,0,2
20140423-M-Barcelona-R32-Albert_Ramos-Rafael_Nadal,2,S-DTL,1,0,0,0,0,0,1
20130426-M-Barcelona-QF-Tomas_Berdych-Tommy_Robredo,1,F-XC,69,20,6,7,7,31,38
20130426-M-Barcelona-QF-Tomas_Berdych-Tommy_Robredo,1,F-DTM,43,5,0,1,4,19,24
20130426-M-Barcelona-QF-Tomas_Berdych-Tommy_Robredo,1,F-DTL,7,5,1,0,4,2,5
20130426-M-Barcelona-QF-Tomas_Berdych-Tommy_Robredo,1,F-IO,46,11,6,2,3,25,21
20130426-M-Barcelona-QF-Tomas_Berdych-Tommy_Robredo,1,F-II,7,5,0,2,3,3,4
20130426-M-Barcelona-QF-Tomas_Berdych-Tommy_Robredo,1,B-XC,70,8,0,2,6,24,46
20130426-M-Barcelona-QF-Tomas_Berdych-Tommy_Robredo,1,B-DTM,52,6,0,0,6,14,38
20130426-M-Barcelona-QF-Tomas_Berdych-Tommy_Robredo,1,B-DTL,6,2,0,0,2,2,4
20130426-M-Barcelona-QF-Tomas_Berdych-Tommy_Robredo,1,B-IO,2,1,0,1,0,2,0
20130426-M-Barcelona-QF-Tomas_Berdych-Tommy_Robredo,1,S-XC,5,1,0,0,1,1,4
20130426-M-Barcelona-QF-Tomas_Berdych-Tommy_Robredo,1,S-DTM,3,0,0,0,0,0,3
20130426-M-Barcelona-QF-Tomas_Berdych-Tommy_Robredo,2,F-XC,62,19,6,7,6,41,21
20130426-M-Barcelona-QF-Tomas_Berdych-Tommy_Robredo,2,F-DTM,57,3,0,0,3,34,23
20130426-M-Barcelona-QF-Tomas_Berdych-Tommy_Robredo,2,F-DTL,10,3,0,2,1,7,3
20130426-M-Barcelona-QF-Tomas_Berdych-Tommy_Robredo,2,F-IO,75,9,0,3,6,51,24
20130426-M-Barcelona-QF-Tomas_Berdych-Tommy_Robredo,2,F-II,6,4,3,1,0,4,2
20130426-M-Barcelona-QF-Tomas_Berdych-Tommy_Robredo,2,B-XC,29,5,1,1,3,16,13
20130426-M-Barcelona-QF-Tomas_Berdych-Tommy_Robredo,2,B-DTM,21,3,0,0,3,9,12
20130426-M-Barcelona-QF-Tomas_Berdych-Tommy_Robredo,2,B-DTL,3,2,0,0,2,0,3
20130426-M-Barcelona-QF-Tomas_Berdych-Tommy_Robredo,2,B-IO,2,0,0,0,0,0,2
20130426-M-Barcelona-QF-Tomas_Berdych-Tommy_Robredo,2,S-XC,16,2,0,1,1,13,3
20130426-M-Barcelona-QF-Tomas_Berdych-Tommy_Robredo,2,S-DTM,17,1,0,0,1,8,9
20130426-M-Barcelona-QF-Tomas_Berdych-Tommy_Robredo,2,S-DTL,2,1,0,0,1,1,1
20140427-M-Barcelona-F-Santiago_Giraldo-Kei_Nishikori,1,F-XC,24,5,2,0,3,8,16
20140427-M-Barcelona-F-Santiago_Giraldo-Kei_Nishikori,1,F-DTM,33,1,0,0,1,14,19
20140427-M-Barcelona-F-Santiago_Giraldo-Kei_Nishikori,1,F-DTL,9,3,0,0,3,0,9
20140427-M-Barcelona-F-Santiago_Giraldo-Kei_Nishikori,1,F-IO,15,3,2,0,1,10,5
20140427-M-Barcelona-F-Santiago_Giraldo-Kei_Nishikori,1,F-II,2,1,1,0,0,1,1
20140427-M-Barcelona-F-Santiago_Giraldo-Kei_Nishikori,1,B-XC,27,2,0,0,2,10,17
20140427-M-Barcelona-F-Santiago_Giraldo-Kei_Nishikori,1,B-DTM,34,1,0,0,1,15,19
20140427-M-Barcelona-F-Santiago_Giraldo-Kei_Nishikori,1,B-DTL,9,5,2,1,2,4,5
20140427-M-Barcelona-F-Santiago_Giraldo-Kei_Nishikori,1,B-IO,3,1,0,1,0,1,2
20140427-M-Barcelona-F-Santiago_Giraldo-Kei_Nishikori,1,S-XC,8,1,0,0,1,4,4
20140427-M-Barcelona-F-Santiago_Giraldo-Kei_Nishikori,1,S-DTM,6,1,0,1,0,6,0
20140427-M-Barcelona-F-Santiago_Giraldo-Kei_Nishikori,1,S-DTL,1,0,0,0,0,0,1
20140427-M-Barcelona-F-Santiago_Giraldo-Kei_Nishikori,2,F-XC,30,6,3,2,1,22,8
20140427-M-Barcelona-F-Santiago_Giraldo-Kei_Nishikori,2,F-DTM,24,2,0,0,2,10,14
20140427-M-Barcelona-F-Santiago_Giraldo-Kei_Nishikori,2,F-DTL,8,3,2,0,1,5,3
20140427-M-Barcelona-F-Santiago_Giraldo-Kei_Nishikori,2,F-IO,23,6,2,1,3,13,10
20140427-M-Barcelona-F-Santiago_Giraldo-Kei_Nishikori,2,F-II,2,0,0,0,0,1,1
20140427-M-Barcelona-F-Santiago_Giraldo-Kei_Nishikori,2,B-XC,47,13,2,4,7,22,25
20140427-M-Barcelona-F-Santiago_Giraldo-Kei_Nishikori,2,B-DTM,25,3,0,0,3,14,11
20140427-M-Barcelona-F-Santiago_Giraldo-Kei_Nishikori,2,B-DTL,3,3,2,0,1,2,1
20140427-M-Barcelona-F-Santiago_Giraldo-Kei_Nishikori,2,B-IO,4,2,1,0,1,3,1
20140427-M-Barcelona-F-Santiago_Giraldo-Kei_Nishikori,2,S-XC,3,0,0,0,0,3,0
20140427-M-Barcelona-F-Santiago_Giraldo-Kei_Nishikori,2,S-DTL,1,0,0,0,0,0,1
20131025-M-Basel-QF-Grigor_Dimitrov-Roger_Federer,1,F-XC,30,7,2,1,4,10,20
20131025-M-Basel-QF-Grigor_Dimitrov-Roger_Federer,1,F-DTM,13,2,0,0,2,3,10
20131025-M-Basel-QF-Grigor_Dimitrov-Roger_Federer,1,F-DTL,3,0,0,0,0,2,1
20131025-M-Basel-QF-Grigor_Dimitrov-Roger_Federer,1,F-IO,26,12,3,3,6,16,10
20131025-M-Basel-QF-Grigor_Dimitrov-Roger_Federer,1,F-II,6,3,1,0,2,3,3
20131025-M-Basel-QF-Grigor_Dimitrov-Roger_Federer,1,B-XC,29,5,0,0,5,5,24
20131025-M-Basel-QF-Grigor_Dimitrov-Roger_Federer,1,B-DTM,7,1,0,0,1,2,5
20131025-M-Basel-QF-Grigor_Dimitrov-Roger_Federer,1,B-DTL,1,1,0,0,1,0,1
20131025-M-Basel-QF-Grigor_Dimitrov-Roger_Federer,1,B-II,1,0,0,0,0,0,1
20131025-M-Basel-QF-Grigor_Dimitrov-Roger_Federer,1,S-XC,15,4,0,0,4,3,12
20131025-M-Basel-QF-Grigor_Dimitrov-Roger_Federer,1,S-DTM,4,0,0,0,0,1,3
20131025-M-Basel-QF-Grigor_Dimitrov-Roger_Federer,1,S-DTL,3,0,0,0,0,2,1
20131025-M-Basel-QF-Grigor_Dimitrov-Roger_Federer,2,F-XC,29,14,6,3,5,20,9
20131025-M-Basel-QF-Grigor_Dimitrov-Roger_Federer,2,F-DTM,9,0,0,0,0,9,0
20131025-M-Basel-QF-Grigor_Dimitrov-Roger_Federer,2,F-DTL,13,5,1,1,3,8,5
20131025-M-Basel-QF-Grigor_Dimitrov-Roger_Federer,2,F-IO,30,8,3,3,2,24,6
20131025-M-Basel-QF-Grigor_Dimitrov-Roger_Federer,2,F-II,6,2,1,0,1,4,2
20131025-M-Basel-QF-Grigor_Dimitrov-Roger_Federer,2,B-XC,28,5,0,1,4,19,9
20131025-M-Basel-QF-Grigor_Dimitrov-Roger_Federer,2,B-DTM,7,2,0,0,2,2,5
20131025-M-Basel-QF-Grigor_Dimitrov-Roger_Federer,2,B-DTL,4,1,0,0,1,3,1
20131025-M-Basel-QF-Grigor_Dimitrov-Roger_Federer,2,B-IO,1,0,0,0,0,0,1
20131025-M-Basel-QF-Grigor_Dimitrov-Roger_Federer,2,S-XC,6,0,0,0,0,2,4
20131025-M-Basel-QF-Grigor_Dimitrov-Roger_Federer,2,S-DTM,1,0,0,0,0,0,1
20131027-M-Basel-F-Juan_Martin_Del_Potro-Roger_Federer,1,F-XC,43,10,6,1,3,30,13
20131027-M-Basel-F-Juan_Martin_Del_Potro-Roger_Federer,1,F-DTM,24,1,0,0,1,11,13
20131027-M-Basel-F-Juan_Martin_Del_Potro-Roger_Federer,1,F-DTL,11,3,0,0,3,7,4
20131027-M-Basel-F-Juan_Martin_Del_Potro-Roger_Federer,1,F-IO,44,5,2,0,3,29,15
20131027-M-Basel-F-Juan_Martin_Del_Potro-Roger_Federer,1,F-II,5,1,1,0,0,2,3
20131027-M-Basel-F-Juan_Martin_Del_Potro-Roger_Federer,1,B-XC,35,3,0,0,3,20,15
20131027-M-Basel-F-Juan_Martin_Del_Potro-Roger_Federer,1,B-DTM,34,3,0,0,3,25,9
20131027-M-Basel-F-Juan_Martin_Del_Potro-Roger_Federer,1,B-DTL,8,4,3,0,1,4,4
20131027-M-Basel-F-Juan_Martin_Del_Potro-Roger_Federer,1,B-IO,10,4,3,1,0,8,2
20131027-M-Basel-F-Juan_Martin_Del_Potro-Roger_Federer,1,S-XC,14,2,0,1,1,10,4
20131027-M-Basel-F-Juan_Martin_Del_Potro-Roger_Federer,1,S-DTM,6,0,0,0,0,3,3
20131027-M-Basel-F-Juan_Martin_Del_Potro-Roger_Federer,1,S-DTL,3,0,0,0,0,0,3
20131027-M-Basel-F-Juan_Martin_Del_Potro-Roger_Federer,1,S-IO,1,0,0,0,0,1,0
20131027-M-Basel-F-Juan_Martin_Del_Potro-Roger_Federer,2,F-XC,39,8,3,0,5,18,21
20131027-M-Basel-F-Juan_Martin_Del_Potro-Roger_Federer,2,F-DTM,39,5,0,0,5,8,31
20131027-M-Basel-F-Juan_Martin_Del_Potro-Roger_Federer,2,F-DTL,12,5,3,0,2,7,5
20131027-M-Basel-F-Juan_Martin_Del_Potro-Roger_Federer,2,F-IO,32,16,9,2,5,17,15
20131027-M-Basel-F-Juan_Martin_Del_Potro-Roger_Federer,2,F-II,5,2,1,0,1,2,3
20131027-M-Basel-F-Juan_Martin_Del_Potro-Roger_Federer,2,B-XC,28,4,1,0,3,16,12
20131027-M-Basel-F-Juan_Martin_Del_Potro-Roger_Federer,2,B-DTM,27,3,0,0,2,9,18
20131027-M-Basel-F-Juan_Martin_Del_Potro-Roger_Federer,2,B-DTL,7,5,5,0,0,5,2
20131027-M-Basel-F-Juan_Martin_Del_Potro-Roger_Federer,2,B-IO,4,0,0,0,0,2,2
20131027-M-Basel-F-Juan_Martin_Del_Potro-Roger_Federer,2,S-XC,22,4,0,0,4,4,18
20131027-M-Basel-F-Juan_Martin_Del_Potro-Roger_Federer,2,S-DTM,24,0,0,0,0,6,18
20131027-M-Basel-F-Juan_Martin_Del_Potro-Roger_Federer,2,S-DTL,5,2,0,0,2,0,5
20131027-M-Basel-F-Juan_Martin_Del_Potro-Roger_Federer,2,S-II,1,1,1,0,0,1,0
20130714-M-Bastad-F-Carlos_Berlocq-Fernando_Verdasco,1,F-XC,64,11,2,8,1,46,18
20130714-M-Bastad-F-Carlos_Berlocq-Fernando_Verdasco,1,F-DTM,34,0,0,0,0,21,13
20130714-M-Bastad-F-Carlos_Berlocq-Fernando_Verdasco,1,F-DTL,4,1,1,0,0,3,1
20130714-M-Bastad-F-Carlos_Berlocq-Fernando_Verdasco,1,F-IO,14,5,2,1,2,9,5
20130714-M-Bastad-F-Carlos_Berlocq-Fernando_Verdasco,1,F-II,4,0,0,0,0,3,1
20130714-M-Bastad-F-Carlos_Berlocq-Fernando_Verdasco,1,B-XC,29,7,1,3,3,17,12
20130714-M-Bastad-F-Carlos_Berlocq-Fernando_Verdasco,1,B-DTM,45,4,0,0,4,26,19
20130714-M-Bastad-F-Carlos_Berlocq-Fernando_Verdasco,1,B-DTL,7,1,0,0,1,1,6
20130714-M-Bastad-F-Carlos_Berlocq-Fernando_Verdasco,1,B-IO,9,2,1,0,1,6,3
20130714-M-Bastad-F-Carlos_Berlocq-Fernando_Verdasco,1,B-II,1,0,0,0,0,0,1
20130714-M-Bastad-F-Carlos_Berlocq-Fernando_Verdasco,1,S-XC,4,3,1,1,1,3,1
20130714-M-Bastad-F-Carlos_Berlocq-Fernando_Verdasco,1,S-DTM,17,0,0,0,0,8,9
20130714-M-Bastad-F-Carlos_Berlocq-Fernando_Verdasco,1,S-DTL,4,0,0,0,0,0,4
20130714-M-Bastad-F-Carlos_Berlocq-Fernando_Verdasco,1,S-IO,1,0,0,0,0,0,1
20130714-M-Bastad-F-Carlos_Berlocq-Fernando_Verdasco,2,F-XC,80,16,3,5,8,39,41
20130714-M-Bastad-F-Carlos_Berlocq-Fernando_Verdasco,2,F-DTM,38,2,0,0,2,13,25
20130714-M-Bastad-F-Carlos_Berlocq-Fernando_Verdasco,2,F-DTL,2,1,0,1,0,2,0
20130714-M-Bastad-F-Carlos_Berlocq-Fernando_Verdasco,2,F-IO,26,10,5,2,3,16,10
20130714-M-Bastad-F-Carlos_Berlocq-Fernando_Verdasco,2,F-II,4,1,0,0,1,1,3
20130714-M-Bastad-F-Carlos_Berlocq-Fernando_Verdasco,2,B-XC,32,8,4,0,4,12,20
20130714-M-Bastad-F-Carlos_Berlocq-Fernando_Verdasco,2,B-DTM,52,0,0,0,0,14,38
20130714-M-Bastad-F-Carlos_Berlocq-Fernando_Verdasco,2,B-DTL,6,1,1,0,0,3,3
20130714-M-Bastad-F-Carlos_Berlocq-Fernando_Verdasco,2,B-IO,7,3,0,1,2,4,3
20130714-M-Bastad-F-Carlos_Berlocq-Fernando_Verdasco,2,S-DTL,2,1,0,1,0,1,1
20131004-M-Beijing-QF-Fabio_Fognini-Rafael_Nadal,1,F-XC,72,13,6,1,6,37,35
20131004-M-Beijing-QF-Fabio_Fognini-Rafael_Nadal,1,F-DTM,31,5,0,0,5,10,21
20131004-M-Beijing-QF-Fabio_Fognini-Rafael_Nadal,1,F-DTL,15,10,5,0,5,5,10
20131004-M-Beijing-QF-Fabio_Fognini-Rafael_Nadal,1,F-IO,24,13,7,2,4,12,12
20131004-M-Beijing-QF-Fabio_Fognini-Rafael_Nadal,1,F-II,4,2,0,0,2,1,3
20131004-M-Beijing-QF-Fabio_Fognini-Rafael_Nadal,1,B-XC,54,14,2,4,8,29,25
20131004-M-Beijing-QF-Fabio_Fognini-Rafael_Nadal,1,B-DTM,37,5,0,0,5,17,20
20131004-M-Beijing-QF-Fabio_Fognini-Rafael_Nadal,1,B-DTL,26,7,2,0,5,11,15
20131004-M-Beijing-QF-Fabio_Fognini-Rafael_Nadal,1,B-IO,10,2,0,0,2,4,6
20131004-M-Beijing-QF-Fabio_Fognini-Rafael_Nadal,1,B-II,1,0,0,0,0,1,0
20131004-M-Beijing-QF-Fabio_Fognini-Rafael_Nadal,1,S-XC,4,1,1,0,0,3,1
20131004-M-Beijing-QF-Fabio_Fognini-Rafael_Nadal,1,S-DTM,2,0,0,0,0,1,1
20131004-M-Beijing-QF-Fabio_Fognini-Rafael_Nadal,1,S-DTL,3,1,1,0,0,2,1
20131004-M-Beijing-QF-Fabio_Fognini-Rafael_Nadal,2,F-XC,76,9,1,1,7,35,41
20131004-M-Beijing-QF-Fabio_Fognini-Rafael_Nadal,2,F-DTM,23,4,0,1,3,11,12
20131004-M-Beijing-QF-Fabio_Fognini-Rafael_Nadal,2,F-DTL,12,6,4,0,2,6,6
20131004-M-Beijing-QF-Fabio_Fognini-Rafael_Nadal,2,F-IO,20,6,1,3,2,13,7
20131004-M-Beijing-QF-Fabio_Fognini-Rafael_Nadal,2,F-II,15,6,1,2,3,9,6
20131004-M-Beijing-QF-Fabio_Fognini-Rafael_Nadal,2,B-XC,42,3,0,0,3,24,18
20131004-M-Beijing-QF-Fabio_Fognini-Rafael_Nadal,2,B-DTM,40,5,0,1,4,17,23
20131004-M-Beijing-QF-Fabio_Fognini-Rafael_Nadal,2,B-DTL,18,6,2,1,3,10,8
20131004-M-Beijing-QF-Fabio_Fognini-Rafael_Nadal,2,B-IO,5,0,0,0,0,4,1
20131004-M-Beijing-QF-Fabio_Fognini-Rafael_Nadal,2,S-XC,2,0,0,0,0,1,1
20131004-M-Beijing-QF-Fabio_Fognini-Rafael_Nadal,2,S-DTM,4,0,0,0,0,1,3
20131004-M-Beijing-QF-Fabio_Fognini-Rafael_Nadal,2,S-DTL,8,0,0,0,0,2,6
20131004-M-Beijing-QF-Fabio_Fognini-Rafael_Nadal,2,S-IO,2,0,0,0,0,1,1
20130901-M-US_Open-R32-Tomas_Berdych-Julien_Benneteau,1,F-XC,30,13,6,2,5,21,9
20130901-M-US_Open-R32-Tomas_Berdych-Julien_Benneteau,1,F-DTM,27,2,0,0,2,15,12
20130901-M-US_Open-R32-Tomas_Berdych-Julien_Benneteau,1,F-DTL,7,2,1,0,1,4,3
20130901-M-US_Open-R32-Tomas_Berdych-Julien_Benneteau,1,F-IO,15,4,1,2,1,13,2
20130901-M-US_Open-R32-Tomas_Berdych-Julien_Benneteau,1,F-II,1,0,0,0,0,1,0
20130901-M-US_Open-R32-Tomas_Berdych-Julien_Benneteau,1,B-XC,10,2,1,0,1,7,3
20130901-M-US_Open-R32-Tomas_Berdych-Julien_Benneteau,1,B-DTM,20,2,0,0,2,11,9
20130901-M-US_Open-R32-Tomas_Berdych-Julien_Benneteau,1,B-DTL,1,0,0,0,0,0,1
20130901-M-US_Open-R32-Tomas_Berdych-Julien_Benneteau,1,B-IO,5,2,0,1,1,4,1
20130901-M-US_Open-R32-Tomas_Berdych-Julien_Benneteau,1,B-II,1,0,0,0,0,1,0
20130901-M-US_Open-R32-Tomas_Berdych-Julien_Benneteau,1,S-XC,2,0,0,0,0,2,0
20130901-M-US_Open-R32-Tomas_Berdych-Julien_Benneteau,1,S-DTM,4,1,0,0,1,1,3
20130901-M-US_Open-R32-Tomas_Berdych-Julien_Benneteau,1,S-DTL,3,0,0,0,0,2,1
20130901-M-US_Open-R32-Tomas_Berdych-Julien_Benneteau,2,F-XC,37,14,1,1,12,14,23
20130901-M-US_Open-R32-Tomas_Berdych-Julien_Benneteau,2,F-DTM,35,3,0,0,3,11,24
20130901-M-US_Open-R32-Tomas_Berdych-Julien_Benneteau,2,F-DTL,3,1,0,1,0,2,1
20130901-M-US_Open-R32-Tomas_Berdych-Julien_Benneteau,2,F-IO,6,1,0,1,0,4,2
20130901-M-US_Open-R32-Tomas_Berdych-Julien_Benneteau,2,B-XC,15,5,2,0,3,7,8
20130901-M-US_Open-R32-Tomas_Berdych-Julien_Benneteau,2,B-DTM,21,4,0,1,3,7,14
20130901-M-US_Open-R32-Tomas_Berdych-Julien_Benneteau,2,B-DTL,4,4,1,1,2,2,2
20130901-M-US_Open-R32-Tomas_Berdych-Julien_Benneteau,2,B-IO,5,2,1,1,0,2,3
20130901-M-US_Open-R32-Tomas_Berdych-Julien_Benneteau,2,S-XC,3,0,0,0,0,0,3
20130901-M-US_Open-R32-Tomas_Berdych-Julien_Benneteau,2,S-DTM,8,0,0,0,0,0,8
20130927-M-Bangkok-QF-Feliciano_Lopez-Milos_Raonic,1,F-XC,16,3,0,0,3,6,10
20130927-M-Bangkok-QF-Feliciano_Lopez-Milos_Raonic,1,F-DTM,10,1,0,0,1,6,4
20130927-M-Bangkok-QF-Feliciano_Lopez-Milos_Raonic,1,F-DTL,2,0,0,0,0,0,2
20130927-M-Bangkok-QF-Feliciano_Lopez-Milos_Raonic,1,F-IO,8,4,2,1,1,4,4
20130927-M-Bangkok-QF-Feliciano_Lopez-Milos_Raonic,1,B-XC,2,0,0,0,0,2,0
20130927-M-Bangkok-QF-Feliciano_Lopez-Milos_Raonic,1,B-DTM,5,0,0,0,0,2,3
20130927-M-Bangkok-QF-Feliciano_Lopez-Milos_Raonic,1,B-DTL,3,2,1,0,1,2,1
20130927-M-Bangkok-QF-Feliciano_Lopez-Milos_Raonic,1,S-XC,5,1,1,0,0,4,1
20130927-M-Bangkok-QF-Feliciano_Lopez-Milos_Raonic,1,S-DTM,5,0,0,0,0,3,2
20130927-M-Bangkok-QF-Feliciano_Lopez-Milos_Raonic,1,S-DTL,3,1,0,0,1,1,2
20130927-M-Bangkok-QF-Feliciano_Lopez-Milos_Raonic,1,S-IO,1,0,0,0,0,0,1
20130927-M-Bangkok-QF-Feliciano_Lopez-Milos_Raonic,2,F-XC,19,9,3,2,4,10,9
20130927-M-Bangkok-QF-Feliciano_Lopez-Milos_Raonic,2,F-DTM,5,0,0,0,0,0,5
20130927-M-Bangkok-QF-Feliciano_Lopez-Milos_Raonic,2,F-DTL,6,3,2,0,1,2,4
20130927-M-Bangkok-QF-Feliciano_Lopez-Milos_Raonic,2,F-IO,11,7,2,3,2,7,4
20130927-M-Bangkok-QF-Feliciano_Lopez-Milos_Raonic,2,B-XC,8,5,3,0,2,3,5
20130927-M-Bangkok-QF-Feliciano_Lopez-Milos_Raonic,2,B-DTM,7,0,0,0,0,5,2
20130927-M-Bangkok-QF-Feliciano_Lopez-Milos_Raonic,2,B-DTL,5,3,2,0,1,3,2
20130927-M-Bangkok-QF-Feliciano_Lopez-Milos_Raonic,2,B-IO,3,1,1,0,0,1,2
20130927-M-Bangkok-QF-Feliciano_Lopez-Milos_Raonic,2,S-XC,1,0,0,0,0,0,1
20130927-M-Bangkok-QF-Feliciano_Lopez-Milos_Raonic,2,S-DTM,2,0,0,0,0,0,2
20130927-M-Bangkok-QF-Feliciano_Lopez-Milos_Raonic,2,S-DTL,1,0,0,0,0,0,1
20130927-M-Bangkok-QF-Feliciano_Lopez-Milos_Raonic,2,S-IO,1,0,0,0,0,0,1
20130622-M-s_Hertogenbosch-F-Nicolas_Mahut-Stanislas_Wawrinka,1,F-XC,11,2,1,0,1,8,3
20130622-M-s_Hertogenbosch-F-Nicolas_Mahut-Stanislas_Wawrinka,1,F-DTM,25,3,0,0,3,12,13
20130622-M-s_Hertogenbosch-F-Nicolas_Mahut-Stanislas_Wawrinka,1,F-DTL,1,1,1,0,0,1,0
20130622-M-s_Hertogenbosch-F-Nicolas_Mahut-Stanislas_Wawrinka,1,F-IO,15,3,2,0,1,12,3
20130622-M-s_Hertogenbosch-F-Nicolas_Mahut-Stanislas_Wawrinka,1,B-XC,4,2,1,0,1,1,3
20130622-M-s_Hertogenbosch-F-Nicolas_Mahut-Stanislas_Wawrinka,1,B-DTM,5,0,0,0,0,3,2
20130622-M-s_Hertogenbosch-F-Nicolas_Mahut-Stanislas_Wawrinka,1,B-DTL,3,2,0,0,2,1,2
20130622-M-s_Hertogenbosch-F-Nicolas_Mahut-Stanislas_Wawrinka,1,S-XC,7,0,0,0,0,2,5
20130622-M-s_Hertogenbosch-F-Nicolas_Mahut-Stanislas_Wawrinka,1,S-DTM,14,2,0,1,1,5,9
20130622-M-s_Hertogenbosch-F-Nicolas_Mahut-Stanislas_Wawrinka,1,S-DTL,1,1,0,0,1,0,1
20130622-M-s_Hertogenbosch-F-Nicolas_Mahut-Stanislas_Wawrinka,1,S-IO,1,0,0,0,0,0,1
20130622-M-s_Hertogenbosch-F-Nicolas_Mahut-Stanislas_Wawrinka,2,F-XC,18,8,4,0,4,10,8
20130622-M-s_Hertogenbosch-F-Nicolas_Mahut-Stanislas_Wawrinka,2,F-DTM,15,1,0,0,1,5,10
20130622-M-s_Hertogenbosch-F-Nicolas_Mahut-Stanislas_Wawrinka,2,F-DTL,4,4,1,1,2,2,2
20130622-M-s_Hertogenbosch-F-Nicolas_Mahut-Stanislas_Wawrinka,2,F-IO,7,1,0,0,1,5,2
20130622-M-s_Hertogenbosch-F-Nicolas_Mahut-Stanislas_Wawrinka,2,B-XC,17,5,0,2,3,10,7
20130622-M-s_Hertogenbosch-F-Nicolas_Mahut-Stanislas_Wawrinka,2,B-DTM,11,0,0,0,0,4,7
20130622-M-s_Hertogenbosch-F-Nicolas_Mahut-Stanislas_Wawrinka,2,B-DTL,6,5,3,1,1,4,2
20130622-M-s_Hertogenbosch-F-Nicolas_Mahut-Stanislas_Wawrinka,2,B-IO,5,2,1,0,1,2,3
20130622-M-s_Hertogenbosch-F-Nicolas_Mahut-Stanislas_Wawrinka,2,S-XC,9,1,0,1,0,6,3
20130622-M-s_Hertogenbosch-F-Nicolas_Mahut-Stanislas_Wawrinka,2,S-DTM,11,1,0,0,1,4,7
20130622-M-s_Hertogenbosch-F-Nicolas_Mahut-Stanislas_Wawrinka,2,S-IO,1,1,0,0,1,0,1
20140105-M-Brisbane-F-Roger_Federer-Lleyton_Hewitt,1,F-XC,22,6,3,1,2,13,9
20140105-M-Brisbane-F-Roger_Federer-Lleyton_Hewitt,1,F-DTM,40,10,0,0,10,10,30
20140105-M-Brisbane-F-Roger_Federer-Lleyton_Hewitt,1,F-DTL,5,4,2,0,2,2,3
20140105-M-Brisbane-F-Roger_Federer-Lleyton_Hewitt,1,F-IO,23,13,4,2,7,9,14
20140105-M-Brisbane-F-Roger_Federer-Lleyton_Hewitt,1,F-II,1,1,0,0,1,0,1
20140105-M-Brisbane-F-Roger_Federer-Lleyton_Hewitt,1,B-XC,28,6,0,1,5,8,20
20140105-M-Brisbane-F-Roger_Federer-Lleyton_Hewitt,1,B-DTM,33,5,1,0,4,13,20
20140105-M-Brisbane-F-Roger_Federer-Lleyton_Hewitt,1,B-DTL,6,5,2,0,3,2,4
20140105-M-Brisbane-F-Roger_Federer-Lleyton_Hewitt,1,B-IO,2,1,0,1,0,1,1
20140105-M-Brisbane-F-Roger_Federer-Lleyton_Hewitt,1,S-XC,11,1,0,0,1,2,9
20140105-M-Brisbane-F-Roger_Federer-Lleyton_Hewitt,1,S-DTM,10,2,0,0,2,1,9
20140105-M-Brisbane-F-Roger_Federer-Lleyton_Hewitt,2,F-XC,24,6,2,2,2,15,9
20140105-M-Brisbane-F-Roger_Federer-Lleyton_Hewitt,2,F-DTM,26,5,0,0,5,15,11
20140105-M-Brisbane-F-Roger_Federer-Lleyton_Hewitt,2,F-DTL,4,3,3,0,0,4,0
20140105-M-Brisbane-F-Roger_Federer-Lleyton_Hewitt,2,F-IO,39,11,3,5,3,27,12
20140105-M-Brisbane-F-Roger_Federer-Lleyton_Hewitt,2,F-II,2,2,0,2,0,2,0
20140105-M-Brisbane-F-Roger_Federer-Lleyton_Hewitt,2,B-XC,27,4,1,1,2,20,7
20140105-M-Brisbane-F-Roger_Federer-Lleyton_Hewitt,2,B-DTM,34,9,0,0,9,13,21
20140105-M-Brisbane-F-Roger_Federer-Lleyton_Hewitt,2,B-DTL,1,1,0,0,1,0,1
20140105-M-Brisbane-F-Roger_Federer-Lleyton_Hewitt,2,B-IO,7,3,2,0,1,5,2
20140105-M-Brisbane-F-Roger_Federer-Lleyton_Hewitt,2,S-XC,15,0,0,0,0,10,5
20140105-M-Brisbane-F-Roger_Federer-Lleyton_Hewitt,2,S-DTM,5,0,0,0,0,4,1
20140105-M-Brisbane-F-Roger_Federer-Lleyton_Hewitt,2,S-DTL,1,0,0,0,0,1,0
20140105-M-Brisbane-F-Roger_Federer-Lleyton_Hewitt,2,S-IO,2,0,0,0,0,1,1
20140104-M-Brisbane-SF-Lleyton_Hewitt-Kei_Nishikori,1,F-XC,32,8,5,3,0,23,9
20140104-M-Brisbane-SF-Lleyton_Hewitt-Kei_Nishikori,1,F-DTM,33,3,0,0,3,14,19
20140104-M-Brisbane-SF-Lleyton_Hewitt-Kei_Nishikori,1,F-DTL,4,2,0,1,1,2,2
20140104-M-Brisbane-SF-Lleyton_Hewitt-Kei_Nishikori,1,F-IO,27,9,4,3,2,16,11
20140104-M-Brisbane-SF-Lleyton_Hewitt-Kei_Nishikori,1,B-XC,41,9,0,0,9,16,25
20140104-M-Brisbane-SF-Lleyton_Hewitt-Kei_Nishikori,1,B-DTM,49,10,0,0,10,23,26
20140104-M-Brisbane-SF-Lleyton_Hewitt-Kei_Nishikori,1,B-DTL,3,2,1,0,1,1,2
20140104-M-Brisbane-SF-Lleyton_Hewitt-Kei_Nishikori,1,B-IO,9,4,1,1,2,6,3
20140104-M-Brisbane-SF-Lleyton_Hewitt-Kei_Nishikori,1,S-XC,15,0,0,0,0,7,8
20140104-M-Brisbane-SF-Lleyton_Hewitt-Kei_Nishikori,1,S-DTM,20,4,0,0,4,4,16
20140104-M-Brisbane-SF-Lleyton_Hewitt-Kei_Nishikori,1,S-IO,1,0,0,0,0,1,0
20140104-M-Brisbane-SF-Lleyton_Hewitt-Kei_Nishikori,2,F-XC,36,10,4,1,5,18,18
20140104-M-Brisbane-SF-Lleyton_Hewitt-Kei_Nishikori,2,F-DTM,37,7,0,0,7,17,20
20140104-M-Brisbane-SF-Lleyton_Hewitt-Kei_Nishikori,2,F-DTL,9,4,3,1,0,5,4
20140104-M-Brisbane-SF-Lleyton_Hewitt-Kei_Nishikori,2,F-IO,20,9,5,1,3,11,9
20140104-M-Brisbane-SF-Lleyton_Hewitt-Kei_Nishikori,2,F-II,5,3,1,0,2,2,3
20140104-M-Brisbane-SF-Lleyton_Hewitt-Kei_Nishikori,2,B-XC,60,10,3,2,5,34,26
20140104-M-Brisbane-SF-Lleyton_Hewitt-Kei_Nishikori,2,B-DTM,41,4,0,0,4,18,23
20140104-M-Brisbane-SF-Lleyton_Hewitt-Kei_Nishikori,2,B-DTL,9,8,4,0,4,4,5
20140104-M-Brisbane-SF-Lleyton_Hewitt-Kei_Nishikori,2,B-IO,5,4,1,1,2,2,3
20140104-M-Brisbane-SF-Lleyton_Hewitt-Kei_Nishikori,2,S-XC,12,1,0,0,1,9,3
20140104-M-Brisbane-SF-Lleyton_Hewitt-Kei_Nishikori,2,S-DTM,7,1,0,0,1,2,5
20140104-M-Brisbane-SF-Lleyton_Hewitt-Kei_Nishikori,2,S-DTL,3,0,0,0,0,2,1
20140201-M-Burnie_CH-F-Hiroki_Moriya-Matt_Reid,1,F-XC,32,8,1,2,5,16,16
20140201-M-Burnie_CH-F-Hiroki_Moriya-Matt_Reid,1,F-DTM,38,3,0,0,3,18,20
20140201-M-Burnie_CH-F-Hiroki_Moriya-Matt_Reid,1,F-DTL,6,3,1,1,1,5,1
20140201-M-Burnie_CH-F-Hiroki_Moriya-Matt_Reid,1,F-IO,16,7,1,0,6,5,11
20140201-M-Burnie_CH-F-Hiroki_Moriya-Matt_Reid,1,B-XC,38,8,5,0,3,23,15
20140201-M-Burnie_CH-F-Hiroki_Moriya-Matt_Reid,1,B-DTM,20,3,0,0,3,12,8
20140201-M-Burnie_CH-F-Hiroki_Moriya-Matt_Reid,1,B-DTL,3,1,0,0,1,1,2
20140201-M-Burnie_CH-F-Hiroki_Moriya-Matt_Reid,1,B-IO,6,3,0,0,3,1,5
20140201-M-Burnie_CH-F-Hiroki_Moriya-Matt_Reid,1,S-DTM,1,0,0,0,0,0,1
20140201-M-Burnie_CH-F-Hiroki_Moriya-Matt_Reid,1,S-IO,1,1,0,0,1,0,1
20140201-M-Burnie_CH-F-Hiroki_Moriya-Matt_Reid,2,F-XC,28,10,4,1,5,14,14
20140201-M-Burnie_CH-F-Hiroki_Moriya-Matt_Reid,2,F-DTM,38,4,0,0,4,20,18
20140201-M-Burnie_CH-F-Hiroki_Moriya-Matt_Reid,2,F-DTL,8,3,3,0,0,4,4
20140201-M-Burnie_CH-F-Hiroki_Moriya-Matt_Reid,2,F-IO,20,7,0,4,3,13,7
20140201-M-Burnie_CH-F-Hiroki_Moriya-Matt_Reid,2,F-II,2,1,1,0,0,2,0
20140201-M-Burnie_CH-F-Hiroki_Moriya-Matt_Reid,2,B-XC,9,1,0,0,1,3,6
20140201-M-Burnie_CH-F-Hiroki_Moriya-Matt_Reid,2,B-DTM,25,2,0,0,2,8,17
20140201-M-Burnie_CH-F-Hiroki_Moriya-Matt_Reid,2,B-DTL,7,1,0,0,1,4,3
20140201-M-Burnie_CH-F-Hiroki_Moriya-Matt_Reid,2,B-IO,3,1,0,0,1,2,1
20140201-M-Burnie_CH-F-Hiroki_Moriya-Matt_Reid,2,S-XC,2,0,0,0,0,1,1
20140201-M-Burnie_CH-F-Hiroki_Moriya-Matt_Reid,2,S-DTM,7,2,0,0,2,1,6
20140201-M-Burnie_CH-F-Hiroki_Moriya-Matt_Reid,2,S-DTL,1,0,0,0,0,0,1
20140201-M-Burnie_CH-F-Hiroki_Moriya-Matt_Reid,2,S-IO,3,0,0,0,0,2,1
20140515-M-Busan_CH-R16-Amir_Weintraub-Daniel_Smethurst,1,F-XC,21,7,2,2,3,10,11
20140515-M-Busan_CH-R16-Amir_Weintraub-Daniel_Smethurst,1,F-DTM,12,3,0,0,3,4,8
20140515-M-Busan_CH-R16-Amir_Weintraub-Daniel_Smethurst,1,F-DTL,30,6,0,1,5,11,19
20140515-M-Busan_CH-R16-Amir_Weintraub-Daniel_Smethurst,1,F-IO,17,4,1,1,2,5,12
20140515-M-Busan_CH-R16-Amir_Weintraub-Daniel_Smethurst,1,B-XC,47,13,4,2,7,22,25
20140515-M-Busan_CH-R16-Amir_Weintraub-Daniel_Smethurst,1,B-DTM,18,3,0,0,3,8,10
20140515-M-Busan_CH-R16-Amir_Weintraub-Daniel_Smethurst,1,B-DTL,5,4,1,1,2,2,3
20140515-M-Busan_CH-R16-Amir_Weintraub-Daniel_Smethurst,1,B-IO,13,6,3,1,2,6,7
20140515-M-Busan_CH-R16-Amir_Weintraub-Daniel_Smethurst,1,S-XC,8,2,0,1,1,3,5
20140515-M-Busan_CH-R16-Amir_Weintraub-Daniel_Smethurst,1,S-DTM,6,0,0,0,0,1,5
20140515-M-Busan_CH-R16-Amir_Weintraub-Daniel_Smethurst,1,S-DTL,3,1,0,1,0,1,2
20140515-M-Busan_CH-R16-Amir_Weintraub-Daniel_Smethurst,2,F-XC,26,9,4,2,3,19,7
20140515-M-Busan_CH-R16-Amir_Weintraub-Daniel_Smethurst,2,F-DTM,17,4,1,0,3,8,9
20140515-M-Busan_CH-R16-Amir_Weintraub-Daniel_Smethurst,2,F-DTL,11,5,2,0,3,6,5
20140515-M-Busan_CH-R16-Amir_Weintraub-Daniel_Smethurst,2,F-IO,17,7,2,2,3,11,6
20140515-M-Busan_CH-R16-Amir_Weintraub-Daniel_Smethurst,2,F-II,6,1,0,0,1,3,3
20140515-M-Busan_CH-R16-Amir_Weintraub-Daniel_Smethurst,2,B-XC,6,1,0,0,1,1,5
20140515-M-Busan_CH-R16-Amir_Weintraub-Daniel_Smethurst,2,B-DTM,4,1,0,0,1,2,2
20140515-M-Busan_CH-R16-Amir_Weintraub-Daniel_Smethurst,2,B-DTL,2,1,0,0,1,1,1
20140515-M-Busan_CH-R16-Amir_Weintraub-Daniel_Smethurst,2,B-IO,1,1,1,0,0,1,0
20140515-M-Busan_CH-R16-Amir_Weintraub-Daniel_Smethurst,2,S-XC,25,3,0,0,3,14,11
20140515-M-Busan_CH-R16-Amir_Weintraub-Daniel_Smethurst,2,S-DTM,27,1,0,0,1,15,12
20140515-M-Busan_CH-R16-Amir_Weintraub-Daniel_Smethurst,2,S-DTL,13,1,0,0,1,8,5
20140515-M-Busan_CH-R16-Amir_Weintraub-Daniel_Smethurst,2,S-IO,4,0,0,0,0,3,1
20140429-M-Cali_CH-R32-Mathias_Bourgue-Gonzalo_Lama,1,F-XC,35,15,5,3,7,18,17
20140429-M-Cali_CH-R32-Mathias_Bourgue-Gonzalo_Lama,1,F-DTM,8,0,0,0,0,4,4
20140429-M-Cali_CH-R32-Mathias_Bourgue-Gonzalo_Lama,1,F-DTL,6,4,1,0,3,2,4
20140429-M-Cali_CH-R32-Mathias_Bourgue-Gonzalo_Lama,1,F-IO,8,4,1,1,2,6,2
20140429-M-Cali_CH-R32-Mathias_Bourgue-Gonzalo_Lama,1,F-II,3,2,1,1,0,2,1
20140429-M-Cali_CH-R32-Mathias_Bourgue-Gonzalo_Lama,1,B-XC,26,6,2,1,3,13,13
20140429-M-Cali_CH-R32-Mathias_Bourgue-Gonzalo_Lama,1,B-DTM,20,1,0,0,1,7,13
20140429-M-Cali_CH-R32-Mathias_Bourgue-Gonzalo_Lama,1,B-DTL,6,1,0,0,1,2,4
20140429-M-Cali_CH-R32-Mathias_Bourgue-Gonzalo_Lama,1,B-IO,6,4,1,1,2,2,4
20140429-M-Cali_CH-R32-Mathias_Bourgue-Gonzalo_Lama,1,S-XC,3,2,0,0,2,0,3
20140429-M-Cali_CH-R32-Mathias_Bourgue-Gonzalo_Lama,1,S-DTM,3,0,0,0,0,1,2
20140429-M-Cali_CH-R32-Mathias_Bourgue-Gonzalo_Lama,2,F-XC,32,9,2,3,4,20,12
20140429-M-Cali_CH-R32-Mathias_Bourgue-Gonzalo_Lama,2,F-DTM,16,0,0,0,0,12,4
20140429-M-Cali_CH-R32-Mathias_Bourgue-Gonzalo_Lama,2,F-DTL,16,2,0,2,0,10,6
20140429-M-Cali_CH-R32-Mathias_Bourgue-Gonzalo_Lama,2,F-IO,25,7,2,2,3,13,12
20140429-M-Cali_CH-R32-Mathias_Bourgue-Gonzalo_Lama,2,F-II,2,2,0,2,0,2,0
20140429-M-Cali_CH-R32-Mathias_Bourgue-Gonzalo_Lama,2,B-XC,6,0,0,0,0,3,3
20140429-M-Cali_CH-R32-Mathias_Bourgue-Gonzalo_Lama,2,B-DTM,10,0,0,0,0,6,4
20140429-M-Cali_CH-R32-Mathias_Bourgue-Gonzalo_Lama,2,B-DTL,2,1,0,1,0,2,0
20140429-M-Cali_CH-R32-Mathias_Bourgue-Gonzalo_Lama,2,S-XC,3,0,0,0,0,2,1
20140429-M-Cali_CH-R32-Mathias_Bourgue-Gonzalo_Lama,2,S-DTM,3,1,0,0,1,1,2
20140429-M-Cali_CH-R32-Mathias_Bourgue-Gonzalo_Lama,2,S-DTL,1,0,0,0,0,0,1
20131112-M-Champaign_CH-R32-Tennys_Sandgren-Filip_Peliwo,1,F-XC,14,1,0,1,0,12,2
20131112-M-Champaign_CH-R32-Tennys_Sandgren-Filip_Peliwo,1,F-DTM,16,1,0,0,1,14,2
20131112-M-Champaign_CH-R32-Tennys_Sandgren-Filip_Peliwo,1,F-DTL,5,1,0,1,0,4,1
20131112-M-Champaign_CH-R32-Tennys_Sandgren-Filip_Peliwo,1,F-IO,6,3,1,0,2,2,4
20131112-M-Champaign_CH-R32-Tennys_Sandgren-Filip_Peliwo,1,B-XC,15,1,0,0,1,11,4
20131112-M-Champaign_CH-R32-Tennys_Sandgren-Filip_Peliwo,1,B-DTM,18,2,0,0,2,13,5
20131112-M-Champaign_CH-R32-Tennys_Sandgren-Filip_Peliwo,1,B-DTL,5,2,2,0,0,4,1
20131112-M-Champaign_CH-R32-Tennys_Sandgren-Filip_Peliwo,1,B-IO,6,0,0,0,0,6,0
20131112-M-Champaign_CH-R32-Tennys_Sandgren-Filip_Peliwo,1,S-XC,2,0,0,0,0,2,0
20131112-M-Champaign_CH-R32-Tennys_Sandgren-Filip_Peliwo,1,S-DTM,2,0,0,0,0,0,2
20131112-M-Champaign_CH-R32-Tennys_Sandgren-Filip_Peliwo,1,S-DTL,1,0,0,0,0,1,0
20131112-M-Champaign_CH-R32-Tennys_Sandgren-Filip_Peliwo,2,F-XC,27,9,2,0,7,5,22
20131112-M-Champaign_CH-R32-Tennys_Sandgren-Filip_Peliwo,2,F-DTM,23,6,0,0,6,4,19
20131112-M-Champaign_CH-R32-Tennys_Sandgren-Filip_Peliwo,2,F-DTL,3,1,0,0,1,1,2
20131112-M-Champaign_CH-R32-Tennys_Sandgren-Filip_Peliwo,2,F-IO,13,4,1,0,3,4,9
20131112-M-Champaign_CH-R32-Tennys_Sandgren-Filip_Peliwo,2,F-II,1,0,0,0,0,0,1
20131112-M-Champaign_CH-R32-Tennys_Sandgren-Filip_Peliwo,2,B-XC,19,4,1,0,3,4,15
20131112-M-Champaign_CH-R32-Tennys_Sandgren-Filip_Peliwo,2,B-DTM,13,2,0,0,2,2,11
20131112-M-Champaign_CH-R32-Tennys_Sandgren-Filip_Peliwo,2,B-DTL,1,0,0,0,0,0,1
20131112-M-Champaign_CH-R32-Tennys_Sandgren-Filip_Peliwo,2,S-DTM,1,0,0,0,0,1,0
20131112-M-Champaign_CH-R32-Marcos_Giron-Rajeev_Ram,1,F-XC,27,8,3,1,4,15,12
20131112-M-Champaign_CH-R32-Marcos_Giron-Rajeev_Ram,1,F-DTM,29,3,0,0,3,11,18
20131112-M-Champaign_CH-R32-Marcos_Giron-Rajeev_Ram,1,F-DTL,2,2,1,0,1,1,1
20131112-M-Champaign_CH-R32-Marcos_Giron-Rajeev_Ram,1,F-IO,34,9,3,2,4,17,17
20131112-M-Champaign_CH-R32-Marcos_Giron-Rajeev_Ram,1,F-II,4,4,1,0,3,1,3
20131112-M-Champaign_CH-R32-Marcos_Giron-Rajeev_Ram,1,B-XC,25,4,1,1,2,12,13
20131112-M-Champaign_CH-R32-Marcos_Giron-Rajeev_Ram,1,B-DTM,24,1,0,0,1,7,17
20131112-M-Champaign_CH-R32-Marcos_Giron-Rajeev_Ram,1,B-DTL,3,1,0,0,1,2,1
20131112-M-Champaign_CH-R32-Marcos_Giron-Rajeev_Ram,1,B-IO,1,0,0,0,0,0,1
20131112-M-Champaign_CH-R32-Marcos_Giron-Rajeev_Ram,1,S-XC,3,0,0,0,0,0,3
20131112-M-Champaign_CH-R32-Marcos_Giron-Rajeev_Ram,1,S-DTM,3,0,0,0,0,0,3
20131112-M-Champaign_CH-R32-Marcos_Giron-Rajeev_Ram,1,S-DTL,2,2,1,0,1,1,1
20131112-M-Champaign_CH-R32-Marcos_Giron-Rajeev_Ram,2,F-XC,21,4,2,0,2,12,9
20131112-M-Champaign_CH-R32-Marcos_Giron-Rajeev_Ram,2,F-DTM,24,2,0,0,2,9,15
20131112-M-Champaign_CH-R32-Marcos_Giron-Rajeev_Ram,2,F-DTL,6,1,0,1,0,4,2
20131112-M-Champaign_CH-R32-Marcos_Giron-Rajeev_Ram,2,F-IO,10,3,2,0,1,6,4
20131112-M-Champaign_CH-R32-Marcos_Giron-Rajeev_Ram,2,F-II,1,1,1,0,0,1,0
20131112-M-Champaign_CH-R32-Marcos_Giron-Rajeev_Ram,2,B-XC,35,2,1,0,1,22,13
20131112-M-Champaign_CH-R32-Marcos_Giron-Rajeev_Ram,2,B-DTM,16,0,0,0,0,9,7
20131112-M-Champaign_CH-R32-Marcos_Giron-Rajeev_Ram,2,B-DTL,3,2,2,0,0,3,0
20131112-M-Champaign_CH-R32-Marcos_Giron-Rajeev_Ram,2,B-IO,4,2,0,1,1,2,2
20131112-M-Champaign_CH-R32-Marcos_Giron-Rajeev_Ram,2,S-XC,12,1,0,0,1,5,7
20131112-M-Champaign_CH-R32-Marcos_Giron-Rajeev_Ram,2,S-DTM,6,0,0,0,0,2,4
20131112-M-Champaign_CH-R32-Marcos_Giron-Rajeev_Ram,2,S-DTL,3,2,1,0,1,2,1
20131112-M-Champaign_CH-R32-Marcos_Giron-Rajeev_Ram,2,S-IO,2,0,0,0,0,1,1
20140104-M-Chennai-SF-Edouard_Roger_Vasselin-Marcel_Granollers,1,F-XC,73,11,2,3,6,38,35
20140104-M-Chennai-SF-Edouard_Roger_Vasselin-Marcel_Granollers,1,F-DTM,32,5,0,1,4,18,14
20140104-M-Chennai-SF-Edouard_Roger_Vasselin-Marcel_Granollers,1,F-DTL,16,6,3,0,3,7,9
20140104-M-Chennai-SF-Edouard_Roger_Vasselin-Marcel_Granollers,1,F-IO,41,13,1,4,8,17,24
20140104-M-Chennai-SF-Edouard_Roger_Vasselin-Marcel_Granollers,1,B-XC,30,6,1,2,3,16,14
20140104-M-Chennai-SF-Edouard_Roger_Vasselin-Marcel_Granollers,1,B-DTM,25,3,0,0,3,10,15
20140104-M-Chennai-SF-Edouard_Roger_Vasselin-Marcel_Granollers,1,B-DTL,7,4,3,0,1,4,3
20140104-M-Chennai-SF-Edouard_Roger_Vasselin-Marcel_Granollers,1,B-IO,10,4,3,1,0,6,4
20140104-M-Chennai-SF-Edouard_Roger_Vasselin-Marcel_Granollers,1,B-II,2,1,0,1,0,2,0
20140104-M-Chennai-SF-Edouard_Roger_Vasselin-Marcel_Granollers,1,S-XC,14,1,0,0,1,8,6
20140104-M-Chennai-SF-Edouard_Roger_Vasselin-Marcel_Granollers,1,S-DTM,6,0,0,0,0,4,2
20140104-M-Chennai-SF-Edouard_Roger_Vasselin-Marcel_Granollers,1,S-DTL,3,0,0,0,0,3,0
20140104-M-Chennai-SF-Edouard_Roger_Vasselin-Marcel_Granollers,1,S-IO,1,0,0,0,0,0,1
20140104-M-Chennai-SF-Edouard_Roger_Vasselin-Marcel_Granollers,2,F-XC,61,8,4,0,4,28,33
20140104-M-Chennai-SF-Edouard_Roger_Vasselin-Marcel_Granollers,2,F-DTM,39,5,0,1,4,19,20
20140104-M-Chennai-SF-Edouard_Roger_Vasselin-Marcel_Granollers,2,F-DTL,13,5,0,1,4,5,8
20140104-M-Chennai-SF-Edouard_Roger_Vasselin-Marcel_Granollers,2,F-IO,14,5,2,0,3,5,9
20140104-M-Chennai-SF-Edouard_Roger_Vasselin-Marcel_Granollers,2,F-II,1,1,0,0,1,0,1
20140104-M-Chennai-SF-Edouard_Roger_Vasselin-Marcel_Granollers,2,B-XC,27,6,2,1,3,11,16
20140104-M-Chennai-SF-Edouard_Roger_Vasselin-Marcel_Granollers,2,B-DTM,42,0,0,0,0,27,15
20140104-M-Chennai-SF-Edouard_Roger_Vasselin-Marcel_Granollers,2,B-DTL,3,0,0,0,0,1,2
20140104-M-Chennai-SF-Edouard_Roger_Vasselin-Marcel_Granollers,2,B-IO,2,2,1,0,1,1,1
20140104-M-Chennai-SF-Edouard_Roger_Vasselin-Marcel_Granollers,2,B-II,1,0,0,0,0,1,0
20140104-M-Chennai-SF-Edouard_Roger_Vasselin-Marcel_Granollers,2,S-XC,9,1,0,1,0,3,6
20140104-M-Chennai-SF-Edouard_Roger_Vasselin-Marcel_Granollers,2,S-DTM,26,1,0,0,1,12,14
20140104-M-Chennai-SF-Edouard_Roger_Vasselin-Marcel_Granollers,2,S-DTL,14,2,0,0,2,3,11
20140104-M-Chennai-SF-Edouard_Roger_Vasselin-Marcel_Granollers,2,S-IO,2,0,0,0,0,0,2
20140103-M-Chennai-QF-Aljaz_Bedene-Stanislas_Wawrinka,1,F-XC,19,4,2,0,2,7,12
20140103-M-Chennai-QF-Aljaz_Bedene-Stanislas_Wawrinka,1,F-DTM,17,4,0,0,4,5,12
20140103-M-Chennai-QF-Aljaz_Bedene-Stanislas_Wawrinka,1,F-DTL,6,4,2,1,1,5,1
20140103-M-Chennai-QF-Aljaz_Bedene-Stanislas_Wawrinka,1,F-IO,16,6,0,0,6,5,11
20140103-M-Chennai-QF-Aljaz_Bedene-Stanislas_Wawrinka,1,F-II,2,1,1,0,0,1,1
20140103-M-Chennai-QF-Aljaz_Bedene-Stanislas_Wawrinka,1,B-XC,14,0,0,0,0,5,9
20140103-M-Chennai-QF-Aljaz_Bedene-Stanislas_Wawrinka,1,B-DTM,16,2,0,1,1,6,10
20140103-M-Chennai-QF-Aljaz_Bedene-Stanislas_Wawrinka,1,B-DTL,1,0,0,0,0,1,0
20140103-M-Chennai-QF-Aljaz_Bedene-Stanislas_Wawrinka,1,S-XC,4,0,0,0,0,1,3
20140103-M-Chennai-QF-Aljaz_Bedene-Stanislas_Wawrinka,1,S-DTM,5,1,0,0,1,2,3
20140103-M-Chennai-QF-Aljaz_Bedene-Stanislas_Wawrinka,1,S-DTL,1,0,0,0,0,0,1
20140103-M-Chennai-QF-Aljaz_Bedene-Stanislas_Wawrinka,1,S-IO,1,0,0,0,0,0,1
20140103-M-Chennai-QF-Aljaz_Bedene-Stanislas_Wawrinka,1,S-II,1,0,0,0,0,0,1
20140103-M-Chennai-QF-Aljaz_Bedene-Stanislas_Wawrinka,2,F-XC,23,7,2,2,3,13,10
20140103-M-Chennai-QF-Aljaz_Bedene-Stanislas_Wawrinka,2,F-DTM,6,0,0,0,0,5,1
20140103-M-Chennai-QF-Aljaz_Bedene-Stanislas_Wawrinka,2,F-DTL,6,1,0,0,1,5,1
20140103-M-Chennai-QF-Aljaz_Bedene-Stanislas_Wawrinka,2,F-IO,15,3,0,2,1,9,6
20140103-M-Chennai-QF-Aljaz_Bedene-Stanislas_Wawrinka,2,B-XC,18,3,1,0,2,9,9
20140103-M-Chennai-QF-Aljaz_Bedene-Stanislas_Wawrinka,2,B-DTM,11,1,1,0,0,8,3
20140103-M-Chennai-QF-Aljaz_Bedene-Stanislas_Wawrinka,2,B-DTL,11,7,5,1,1,9,2
20140103-M-Chennai-QF-Aljaz_Bedene-Stanislas_Wawrinka,2,B-IO,5,3,1,0,2,2,3
20140103-M-Chennai-QF-Aljaz_Bedene-Stanislas_Wawrinka,2,B-II,1,0,0,0,0,1,0
20140103-M-Chennai-QF-Aljaz_Bedene-Stanislas_Wawrinka,2,S-XC,6,0,0,0,0,4,2
20140103-M-Chennai-QF-Aljaz_Bedene-Stanislas_Wawrinka,2,S-DTM,3,0,0,0,0,1,2
20140103-M-Chennai-QF-Aljaz_Bedene-Stanislas_Wawrinka,2,S-DTL,1,1,0,0,1,0,1
20140224-M-Cherbourg_CH-Q3-Rudy_Coco-Taro_Daniel,1,F-XC,34,14,6,2,6,18,16
20140224-M-Cherbourg_CH-Q3-Rudy_Coco-Taro_Daniel,1,F-DTM,18,5,0,0,5,7,11
20140224-M-Cherbourg_CH-Q3-Rudy_Coco-Taro_Daniel,1,F-DTL,8,4,0,2,2,4,4
20140224-M-Cherbourg_CH-Q3-Rudy_Coco-Taro_Daniel,1,F-IO,20,8,4,1,3,10,10
20140224-M-Cherbourg_CH-Q3-Rudy_Coco-Taro_Daniel,1,F-II,1,0,0,0,0,0,1
20140224-M-Cherbourg_CH-Q3-Rudy_Coco-Taro_Daniel,1,B-XC,36,10,2,0,8,14,22
20140224-M-Cherbourg_CH-Q3-Rudy_Coco-Taro_Daniel,1,B-DTM,15,1,0,0,1,5,10
20140224-M-Cherbourg_CH-Q3-Rudy_Coco-Taro_Daniel,1,B-DTL,8,6,0,1,5,2,6
20140224-M-Cherbourg_CH-Q3-Rudy_Coco-Taro_Daniel,1,B-IO,2,1,0,0,1,0,2
20140224-M-Cherbourg_CH-Q3-Rudy_Coco-Taro_Daniel,1,S-XC,2,1,0,0,1,0,2
20140224-M-Cherbourg_CH-Q3-Rudy_Coco-Taro_Daniel,1,S-DTM,1,0,0,0,0,0,1
20140224-M-Cherbourg_CH-Q3-Rudy_Coco-Taro_Daniel,1,S-DTL,1,0,0,0,0,0,1
20140224-M-Cherbourg_CH-Q3-Rudy_Coco-Taro_Daniel,2,F-XC,37,0,0,0,0,25,12
20140224-M-Cherbourg_CH-Q3-Rudy_Coco-Taro_Daniel,2,F-DTM,26,1,0,0,1,14,12
20140224-M-Cherbourg_CH-Q3-Rudy_Coco-Taro_Daniel,2,F-DTL,10,5,3,2,0,6,4
20140224-M-Cherbourg_CH-Q3-Rudy_Coco-Taro_Daniel,2,F-IO,11,5,3,1,1,6,5
20140224-M-Cherbourg_CH-Q3-Rudy_Coco-Taro_Daniel,2,B-XC,10,1,0,0,1,5,5
20140224-M-Cherbourg_CH-Q3-Rudy_Coco-Taro_Daniel,2,B-DTM,17,0,0,0,0,13,4
20140224-M-Cherbourg_CH-Q3-Rudy_Coco-Taro_Daniel,2,B-DTL,9,2,0,0,2,5,4
20140224-M-Cherbourg_CH-Q3-Rudy_Coco-Taro_Daniel,2,B-IO,4,0,0,0,0,3,1
20140224-M-Cherbourg_CH-Q3-Rudy_Coco-Taro_Daniel,2,S-XC,1,0,0,0,0,0,1
20140224-M-Cherbourg_CH-Q3-Rudy_Coco-Taro_Daniel,2,S-DTM,1,0,0,0,0,0,1
20130818-M-Cincinnati_Masters-F-John_Isner-Rafael_Nadal,1,F-XC,30,6,3,1,2,13,17
20130818-M-Cincinnati_Masters-F-John_Isner-Rafael_Nadal,1,F-DTM,26,5,0,2,3,8,18
20130818-M-Cincinnati_Masters-F-John_Isner-Rafael_Nadal,1,F-DTL,11,11,6,0,5,6,5
20130818-M-Cincinnati_Masters-F-John_Isner-Rafael_Nadal,1,F-IO,31,22,11,2,9,19,12
20130818-M-Cincinnati_Masters-F-John_Isner-Rafael_Nadal,1,F-II,6,2,1,1,0,2,4
20130818-M-Cincinnati_Masters-F-John_Isner-Rafael_Nadal,1,B-XC,8,2,0,0,2,2,6
20130818-M-Cincinnati_Masters-F-John_Isner-Rafael_Nadal,1,B-DTM,18,3,0,0,3,4,14
20130818-M-Cincinnati_Masters-F-John_Isner-Rafael_Nadal,1,B-DTL,10,3,0,0,3,2,8
20130818-M-Cincinnati_Masters-F-John_Isner-Rafael_Nadal,1,S-XC,2,0,0,0,0,1,1
20130818-M-Cincinnati_Masters-F-John_Isner-Rafael_Nadal,1,S-DTM,2,0,0,0,0,0,2
20130818-M-Cincinnati_Masters-F-John_Isner-Rafael_Nadal,1,S-DTL,5,2,0,0,2,3,2
20130818-M-Cincinnati_Masters-F-John_Isner-Rafael_Nadal,2,F-XC,52,10,3,5,2,37,15
20130818-M-Cincinnati_Masters-F-John_Isner-Rafael_Nadal,2,F-DTM,11,1,0,0,1,9,2
20130818-M-Cincinnati_Masters-F-John_Isner-Rafael_Nadal,2,F-DTL,3,2,1,0,1,1,2
20130818-M-Cincinnati_Masters-F-John_Isner-Rafael_Nadal,2,F-IO,23,12,7,2,3,16,7
20130818-M-Cincinnati_Masters-F-John_Isner-Rafael_Nadal,2,F-II,7,1,0,0,1,5,2
20130818-M-Cincinnati_Masters-F-John_Isner-Rafael_Nadal,2,B-XC,14,1,0,0,1,9,5
20130818-M-Cincinnati_Masters-F-John_Isner-Rafael_Nadal,2,B-DTM,14,0,0,0,0,8,6
20130818-M-Cincinnati_Masters-F-John_Isner-Rafael_Nadal,2,B-DTL,2,1,0,0,1,1,1
20130818-M-Cincinnati_Masters-F-John_Isner-Rafael_Nadal,2,B-IO,4,2,1,1,0,3,1
20130818-M-Cincinnati_Masters-F-John_Isner-Rafael_Nadal,2,S-XC,1,0,0,0,0,1,0
20130818-M-Cincinnati_Masters-F-John_Isner-Rafael_Nadal,2,S-DTM,4,0,0,0,0,3,1
20130818-M-Cincinnati_Masters-F-John_Isner-Rafael_Nadal,2,S-DTL,7,0,0,0,0,4,3
20131117-M-CH_Tour_Finals-F-Alejandro_Gonzalez-Filippo_Volandri,1,F-XC,52,7,2,1,4,22,30
20131117-M-CH_Tour_Finals-F-Alejandro_Gonzalez-Filippo_Volandri,1,F-DTM,46,3,0,0,3,19,27
20131117-M-CH_Tour_Finals-F-Alejandro_Gonzalez-Filippo_Volandri,1,F-DTL,23,7,1,2,4,8,15
20131117-M-CH_Tour_Finals-F-Alejandro_Gonzalez-Filippo_Volandri,1,F-IO,15,4,0,3,1,11,4
20131117-M-CH_Tour_Finals-F-Alejandro_Gonzalez-Filippo_Volandri,1,F-II,2,1,0,0,1,0,2
20131117-M-CH_Tour_Finals-F-Alejandro_Gonzalez-Filippo_Volandri,1,B-XC,51,14,2,1,11,17,34
20131117-M-CH_Tour_Finals-F-Alejandro_Gonzalez-Filippo_Volandri,1,B-DTM,48,1,0,0,1,20,28
20131117-M-CH_Tour_Finals-F-Alejandro_Gonzalez-Filippo_Volandri,1,B-DTL,30,11,3,1,7,11,19
20131117-M-CH_Tour_Finals-F-Alejandro_Gonzalez-Filippo_Volandri,1,B-IO,12,4,0,1,3,5,7
20131117-M-CH_Tour_Finals-F-Alejandro_Gonzalez-Filippo_Volandri,1,S-XC,18,1,0,1,0,5,13
20131117-M-CH_Tour_Finals-F-Alejandro_Gonzalez-Filippo_Volandri,1,S-DTM,12,1,0,0,1,4,8
20131117-M-CH_Tour_Finals-F-Alejandro_Gonzalez-Filippo_Volandri,1,S-IO,2,0,0,0,0,1,1
20131117-M-CH_Tour_Finals-F-Alejandro_Gonzalez-Filippo_Volandri,2,F-XC,76,13,6,1,6,44,32
20131117-M-CH_Tour_Finals-F-Alejandro_Gonzalez-Filippo_Volandri,2,F-DTM,25,3,0,0,3,14,11
20131117-M-CH_Tour_Finals-F-Alejandro_Gonzalez-Filippo_Volandri,2,F-DTL,20,6,1,0,5,10,10
20131117-M-CH_Tour_Finals-F-Alejandro_Gonzalez-Filippo_Volandri,2,F-IO,35,7,3,2,2,18,17
20131117-M-CH_Tour_Finals-F-Alejandro_Gonzalez-Filippo_Volandri,2,F-II,3,1,0,0,1,2,1
20131117-M-CH_Tour_Finals-F-Alejandro_Gonzalez-Filippo_Volandri,2,B-XC,76,12,4,1,7,49,27
20131117-M-CH_Tour_Finals-F-Alejandro_Gonzalez-Filippo_Volandri,2,B-DTM,32,1,0,0,1,18,14
20131117-M-CH_Tour_Finals-F-Alejandro_Gonzalez-Filippo_Volandri,2,B-DTL,12,6,2,0,4,6,6
20131117-M-CH_Tour_Finals-F-Alejandro_Gonzalez-Filippo_Volandri,2,B-IO,7,0,0,0,0,5,2
20131117-M-CH_Tour_Finals-F-Alejandro_Gonzalez-Filippo_Volandri,2,S-XC,8,0,0,0,0,5,3
20131117-M-CH_Tour_Finals-F-Alejandro_Gonzalez-Filippo_Volandri,2,S-DTM,2,0,0,0,0,1,1
20131116-M-CH_Tour_Finals-SF-Teymuraz_Gabashvili-Filippo_Volandri,1,F-XC,64,15,5,3,7,26,38
20131116-M-CH_Tour_Finals-SF-Teymuraz_Gabashvili-Filippo_Volandri,1,F-DTM,42,5,0,0,5,17,25
20131116-M-CH_Tour_Finals-SF-Teymuraz_Gabashvili-Filippo_Volandri,1,F-DTL,8,0,0,0,0,4,4
20131116-M-CH_Tour_Finals-SF-Teymuraz_Gabashvili-Filippo_Volandri,1,F-IO,23,6,1,0,5,13,10
20131116-M-CH_Tour_Finals-SF-Teymuraz_Gabashvili-Filippo_Volandri,1,F-II,3,1,1,0,0,2,1
20131116-M-CH_Tour_Finals-SF-Teymuraz_Gabashvili-Filippo_Volandri,1,B-XC,59,8,3,0,5,27,32
20131116-M-CH_Tour_Finals-SF-Teymuraz_Gabashvili-Filippo_Volandri,1,B-DTM,60,9,0,1,8,25,35
20131116-M-CH_Tour_Finals-SF-Teymuraz_Gabashvili-Filippo_Volandri,1,B-DTL,17,5,1,1,3,9,8
20131116-M-CH_Tour_Finals-SF-Teymuraz_Gabashvili-Filippo_Volandri,1,B-IO,10,1,0,0,1,5,5
20131116-M-CH_Tour_Finals-SF-Teymuraz_Gabashvili-Filippo_Volandri,1,S-XC,3,0,0,0,0,2,1
20131116-M-CH_Tour_Finals-SF-Teymuraz_Gabashvili-Filippo_Volandri,1,S-DTM,7,1,0,0,1,1,6
20131116-M-CH_Tour_Finals-SF-Teymuraz_Gabashvili-Filippo_Volandri,1,S-DTL,3,2,0,0,2,1,2
20131116-M-CH_Tour_Finals-SF-Teymuraz_Gabashvili-Filippo_Volandri,2,F-XC,58,7,1,2,4,31,27
20131116-M-CH_Tour_Finals-SF-Teymuraz_Gabashvili-Filippo_Volandri,2,F-DTM,57,4,0,0,4,29,28
20131116-M-CH_Tour_Finals-SF-Teymuraz_Gabashvili-Filippo_Volandri,2,F-DTL,14,8,4,0,4,7,7
20131116-M-CH_Tour_Finals-SF-Teymuraz_Gabashvili-Filippo_Volandri,2,F-IO,38,7,4,0,3,23,15
20131116-M-CH_Tour_Finals-SF-Teymuraz_Gabashvili-Filippo_Volandri,2,F-II,1,1,1,0,0,1,0
20131116-M-CH_Tour_Finals-SF-Teymuraz_Gabashvili-Filippo_Volandri,2,B-XC,65,11,3,0,8,32,33
20131116-M-CH_Tour_Finals-SF-Teymuraz_Gabashvili-Filippo_Volandri,2,B-DTM,28,6,0,1,5,18,10
20131116-M-CH_Tour_Finals-SF-Teymuraz_Gabashvili-Filippo_Volandri,2,B-DTL,6,4,1,1,2,4,2
20131116-M-CH_Tour_Finals-SF-Teymuraz_Gabashvili-Filippo_Volandri,2,B-IO,1,1,0,0,1,0,1
20131116-M-CH_Tour_Finals-SF-Teymuraz_Gabashvili-Filippo_Volandri,2,S-XC,7,4,1,0,3,3,4
20131116-M-CH_Tour_Finals-SF-Teymuraz_Gabashvili-Filippo_Volandri,2,S-DTM,8,0,0,0,0,3,5
20131114-M-CH_Tour_Finals-RR-Alejandro_Gonzalez-Jesse_Huta_Galung,1,F-XC,46,6,4,0,2,20,26
20131114-M-CH_Tour_Finals-RR-Alejandro_Gonzalez-Jesse_Huta_Galung,1,F-DTM,43,3,0,1,2,20,23
20131114-M-CH_Tour_Finals-RR-Alejandro_Gonzalez-Jesse_Huta_Galung,1,F-DTL,12,3,0,0,3,3,9
20131114-M-CH_Tour_Finals-RR-Alejandro_Gonzalez-Jesse_Huta_Galung,1,F-IO,26,4,0,1,3,13,13
20131114-M-CH_Tour_Finals-RR-Alejandro_Gonzalez-Jesse_Huta_Galung,1,F-II,2,1,0,1,0,2,0
20131114-M-CH_Tour_Finals-RR-Alejandro_Gonzalez-Jesse_Huta_Galung,1,B-XC,61,3,0,0,3,34,27
20131114-M-CH_Tour_Finals-RR-Alejandro_Gonzalez-Jesse_Huta_Galung,1,B-DTM,37,2,0,0,2,12,25
20131114-M-CH_Tour_Finals-RR-Alejandro_Gonzalez-Jesse_Huta_Galung,1,B-DTL,11,5,1,1,3,6,5
20131114-M-CH_Tour_Finals-RR-Alejandro_Gonzalez-Jesse_Huta_Galung,1,B-IO,2,1,0,0,1,1,1
20131114-M-CH_Tour_Finals-RR-Alejandro_Gonzalez-Jesse_Huta_Galung,1,S-XC,22,1,0,0,1,11,11
20131114-M-CH_Tour_Finals-RR-Alejandro_Gonzalez-Jesse_Huta_Galung,1,S-DTM,9,1,0,0,1,2,7
20131114-M-CH_Tour_Finals-RR-Alejandro_Gonzalez-Jesse_Huta_Galung,1,S-DTL,3,1,0,0,1,0,3
20131114-M-CH_Tour_Finals-RR-Alejandro_Gonzalez-Jesse_Huta_Galung,1,S-IO,1,0,0,0,0,0,1
20131114-M-CH_Tour_Finals-RR-Alejandro_Gonzalez-Jesse_Huta_Galung,2,F-XC,58,17,10,2,5,38,20
20131114-M-CH_Tour_Finals-RR-Alejandro_Gonzalez-Jesse_Huta_Galung,2,F-DTM,42,4,0,1,3,20,22
20131114-M-CH_Tour_Finals-RR-Alejandro_Gonzalez-Jesse_Huta_Galung,2,F-DTL,7,3,0,1,2,4,3
20131114-M-CH_Tour_Finals-RR-Alejandro_Gonzalez-Jesse_Huta_Galung,2,F-IO,35,5,4,0,1,20,15
20131114-M-CH_Tour_Finals-RR-Alejandro_Gonzalez-Jesse_Huta_Galung,2,F-II,5,3,1,0,2,2,3
20131114-M-CH_Tour_Finals-RR-Alejandro_Gonzalez-Jesse_Huta_Galung,2,B-XC,52,11,0,1,10,26,26
20131114-M-CH_Tour_Finals-RR-Alejandro_Gonzalez-Jesse_Huta_Galung,2,B-DTM,31,4,1,0,3,17,14
20131114-M-CH_Tour_Finals-RR-Alejandro_Gonzalez-Jesse_Huta_Galung,2,B-DTL,17,11,3,0,8,9,8
20131114-M-CH_Tour_Finals-RR-Alejandro_Gonzalez-Jesse_Huta_Galung,2,B-IO,6,3,1,0,2,4,2
20131114-M-CH_Tour_Finals-RR-Alejandro_Gonzalez-Jesse_Huta_Galung,2,S-XC,28,2,0,0,2,14,14
20131114-M-CH_Tour_Finals-RR-Alejandro_Gonzalez-Jesse_Huta_Galung,2,S-DTM,7,1,0,0,1,2,5
20131114-M-CH_Tour_Finals-RR-Alejandro_Gonzalez-Jesse_Huta_Galung,2,S-DTL,4,2,0,0,2,1,3
20131113-M-CH_Tour_Finals-RR-Guilherme_Clezar-Aleksandr_Nedovyesov,1,F-XC,37,10,5,1,4,24,13
20131113-M-CH_Tour_Finals-RR-Guilherme_Clezar-Aleksandr_Nedovyesov,1,F-DTM,30,1,0,0,1,14,16
20131113-M-CH_Tour_Finals-RR-Guilherme_Clezar-Aleksandr_Nedovyesov,1,F-DTL,4,1,0,1,0,2,2
20131113-M-CH_Tour_Finals-RR-Guilherme_Clezar-Aleksandr_Nedovyesov,1,F-IO,53,9,3,0,6,29,24
20131113-M-CH_Tour_Finals-RR-Guilherme_Clezar-Aleksandr_Nedovyesov,1,F-II,5,3,2,0,1,4,1
20131113-M-CH_Tour_Finals-RR-Guilherme_Clezar-Aleksandr_Nedovyesov,1,B-XC,33,1,0,0,1,14,19
20131113-M-CH_Tour_Finals-RR-Guilherme_Clezar-Aleksandr_Nedovyesov,1,B-DTM,39,4,0,0,4,16,23
20131113-M-CH_Tour_Finals-RR-Guilherme_Clezar-Aleksandr_Nedovyesov,1,B-DTL,11,6,0,2,4,7,4
20131113-M-CH_Tour_Finals-RR-Guilherme_Clezar-Aleksandr_Nedovyesov,1,B-IO,8,4,0,1,3,4,4
20131113-M-CH_Tour_Finals-RR-Guilherme_Clezar-Aleksandr_Nedovyesov,1,S-XC,5,1,0,0,1,2,3
20131113-M-CH_Tour_Finals-RR-Guilherme_Clezar-Aleksandr_Nedovyesov,1,S-DTM,13,2,0,0,2,6,7
20131113-M-CH_Tour_Finals-RR-Guilherme_Clezar-Aleksandr_Nedovyesov,1,S-DTL,6,0,0,0,0,1,5
20131113-M-CH_Tour_Finals-RR-Guilherme_Clezar-Aleksandr_Nedovyesov,2,F-XC,36,19,3,5,11,17,19
20131113-M-CH_Tour_Finals-RR-Guilherme_Clezar-Aleksandr_Nedovyesov,2,F-DTM,38,7,1,0,6,17,21
20131113-M-CH_Tour_Finals-RR-Guilherme_Clezar-Aleksandr_Nedovyesov,2,F-DTL,5,2,1,0,1,4,1
20131113-M-CH_Tour_Finals-RR-Guilherme_Clezar-Aleksandr_Nedovyesov,2,F-IO,18,8,3,0,5,8,10
20131113-M-CH_Tour_Finals-RR-Guilherme_Clezar-Aleksandr_Nedovyesov,2,F-II,2,2,1,0,1,1,1
20131113-M-CH_Tour_Finals-RR-Guilherme_Clezar-Aleksandr_Nedovyesov,2,B-XC,53,8,4,1,3,30,23
20131113-M-CH_Tour_Finals-RR-Guilherme_Clezar-Aleksandr_Nedovyesov,2,B-DTM,42,2,0,0,2,21,21
20131113-M-CH_Tour_Finals-RR-Guilherme_Clezar-Aleksandr_Nedovyesov,2,B-DTL,4,3,1,0,2,1,3
20131113-M-CH_Tour_Finals-RR-Guilherme_Clezar-Aleksandr_Nedovyesov,2,B-IO,4,2,1,0,1,3,1
20131113-M-CH_Tour_Finals-RR-Guilherme_Clezar-Aleksandr_Nedovyesov,2,S-XC,16,2,0,0,2,6,10
20131113-M-CH_Tour_Finals-RR-Guilherme_Clezar-Aleksandr_Nedovyesov,2,S-DTM,17,1,1,0,0,6,11
20131113-M-CH_Tour_Finals-RR-Guilherme_Clezar-Aleksandr_Nedovyesov,2,S-DTL,1,0,0,0,0,0,1
20131113-M-CH_Tour_Finals-RR-Guilherme_Clezar-Aleksandr_Nedovyesov,2,S-IO,6,0,0,0,0,3,3
20131114-M-CH_Tour_Finals-RR-Teymuraz_Gabashvili-Aleksandr_Nedovyesov,1,F-XC,45,9,5,1,3,22,23
20131114-M-CH_Tour_Finals-RR-Teymuraz_Gabashvili-Aleksandr_Nedovyesov,1,F-DTM,19,1,0,0,1,7,12
20131114-M-CH_Tour_Finals-RR-Teymuraz_Gabashvili-Aleksandr_Nedovyesov,1,F-DTL,10,6,0,2,4,3,7
20131114-M-CH_Tour_Finals-RR-Teymuraz_Gabashvili-Aleksandr_Nedovyesov,1,F-IO,28,8,1,2,5,19,9
20131114-M-CH_Tour_Finals-RR-Teymuraz_Gabashvili-Aleksandr_Nedovyesov,1,F-II,3,1,0,1,0,3,0
20131114-M-CH_Tour_Finals-RR-Teymuraz_Gabashvili-Aleksandr_Nedovyesov,1,B-XC,34,6,0,2,4,19,15
20131114-M-CH_Tour_Finals-RR-Teymuraz_Gabashvili-Aleksandr_Nedovyesov,1,B-DTM,28,2,0,0,2,14,14
20131114-M-CH_Tour_Finals-RR-Teymuraz_Gabashvili-Aleksandr_Nedovyesov,1,B-DTL,6,4,1,0,3,1,5
20131114-M-CH_Tour_Finals-RR-Teymuraz_Gabashvili-Aleksandr_Nedovyesov,1,B-IO,8,4,3,1,0,6,2
20131114-M-CH_Tour_Finals-RR-Teymuraz_Gabashvili-Aleksandr_Nedovyesov,1,S-XC,5,1,1,0,0,4,1
20131114-M-CH_Tour_Finals-RR-Teymuraz_Gabashvili-Aleksandr_Nedovyesov,1,S-DTM,5,1,0,0,1,1,4
20131114-M-CH_Tour_Finals-RR-Teymuraz_Gabashvili-Aleksandr_Nedovyesov,1,S-DTL,1,1,1,0,0,1,0
20131114-M-CH_Tour_Finals-RR-Teymuraz_Gabashvili-Aleksandr_Nedovyesov,2,F-XC,32,13,5,1,6,17,15
20131114-M-CH_Tour_Finals-RR-Teymuraz_Gabashvili-Aleksandr_Nedovyesov,2,F-DTM,28,5,0,1,4,14,14
20131114-M-CH_Tour_Finals-RR-Teymuraz_Gabashvili-Aleksandr_Nedovyesov,2,F-DTL,7,3,0,1,2,4,3
20131114-M-CH_Tour_Finals-RR-Teymuraz_Gabashvili-Aleksandr_Nedovyesov,2,F-IO,25,7,0,1,6,6,19
20131114-M-CH_Tour_Finals-RR-Teymuraz_Gabashvili-Aleksandr_Nedovyesov,2,F-II,3,2,0,0,2,1,2
20131114-M-CH_Tour_Finals-RR-Teymuraz_Gabashvili-Aleksandr_Nedovyesov,2,B-XC,23,4,0,0,4,11,12
20131114-M-CH_Tour_Finals-RR-Teymuraz_Gabashvili-Aleksandr_Nedovyesov,2,B-DTM,22,1,0,0,1,12,10
20131114-M-CH_Tour_Finals-RR-Teymuraz_Gabashvili-Aleksandr_Nedovyesov,2,B-DTL,3,1,0,0,1,1,2
20131114-M-CH_Tour_Finals-RR-Teymuraz_Gabashvili-Aleksandr_Nedovyesov,2,B-IO,1,1,0,0,1,0,1
20131114-M-CH_Tour_Finals-RR-Teymuraz_Gabashvili-Aleksandr_Nedovyesov,2,S-XC,10,2,0,1,1,4,6
20131114-M-CH_Tour_Finals-RR-Teymuraz_Gabashvili-Aleksandr_Nedovyesov,2,S-DTM,9,1,0,0,1,2,7
20140520-M-Dusseldorf-R32-Nikolay_Davydenko-Dudi_Sela,1,F-XC,40,15,5,4,6,25,15
20140520-M-Dusseldorf-R32-Nikolay_Davydenko-Dudi_Sela,1,F-DTM,14,3,0,0,3,2,12
20140520-M-Dusseldorf-R32-Nikolay_Davydenko-Dudi_Sela,1,F-DTL,10,6,2,1,3,7,3
20140520-M-Dusseldorf-R32-Nikolay_Davydenko-Dudi_Sela,1,F-IO,18,5,1,1,3,8,10
20140520-M-Dusseldorf-R32-Nikolay_Davydenko-Dudi_Sela,1,F-II,2,0,0,0,0,2,0
20140520-M-Dusseldorf-R32-Nikolay_Davydenko-Dudi_Sela,1,B-XC,20,5,2,1,2,14,6
20140520-M-Dusseldorf-R32-Nikolay_Davydenko-Dudi_Sela,1,B-DTM,22,2,0,0,2,10,12
20140520-M-Dusseldorf-R32-Nikolay_Davydenko-Dudi_Sela,1,B-DTL,2,1,0,0,1,1,1
20140520-M-Dusseldorf-R32-Nikolay_Davydenko-Dudi_Sela,1,B-IO,4,2,1,0,1,1,3
20140520-M-Dusseldorf-R32-Nikolay_Davydenko-Dudi_Sela,1,S-XC,1,0,0,0,0,1,0
20140520-M-Dusseldorf-R32-Nikolay_Davydenko-Dudi_Sela,1,S-DTM,2,1,0,0,1,1,1
20140520-M-Dusseldorf-R32-Nikolay_Davydenko-Dudi_Sela,2,F-XC,32,8,3,1,4,15,17
20140520-M-Dusseldorf-R32-Nikolay_Davydenko-Dudi_Sela,2,F-DTM,21,6,0,1,5,7,14
20140520-M-Dusseldorf-R32-Nikolay_Davydenko-Dudi_Sela,2,F-IO,8,4,1,1,2,5,3
20140520-M-Dusseldorf-R32-Nikolay_Davydenko-Dudi_Sela,2,B-XC,18,6,0,1,5,6,12
20140520-M-Dusseldorf-R32-Nikolay_Davydenko-Dudi_Sela,2,B-DTM,29,3,0,0,3,17,12
20140520-M-Dusseldorf-R32-Nikolay_Davydenko-Dudi_Sela,2,B-DTL,3,2,0,0,2,0,3
20140520-M-Dusseldorf-R32-Nikolay_Davydenko-Dudi_Sela,2,S-XC,6,0,0,0,0,3,3
20140520-M-Dusseldorf-R32-Nikolay_Davydenko-Dudi_Sela,2,S-DTM,9,1,0,0,1,1,8
20140520-M-Dusseldorf-R32-Nikolay_Davydenko-Dudi_Sela,2,S-DTL,1,0,0,0,0,0,1
20130303-M-Delray_Beach-F-Ernests_Gulbis-Edouard_Roger_Vasselin,1,F-XC,34,10,5,1,4,25,9
20130303-M-Delray_Beach-F-Ernests_Gulbis-Edouard_Roger_Vasselin,1,F-DTM,39,5,0,0,5,14,25
20130303-M-Delray_Beach-F-Ernests_Gulbis-Edouard_Roger_Vasselin,1,F-DTL,11,5,3,0,2,9,2
20130303-M-Delray_Beach-F-Ernests_Gulbis-Edouard_Roger_Vasselin,1,F-IO,11,3,1,1,1,10,1
20130303-M-Delray_Beach-F-Ernests_Gulbis-Edouard_Roger_Vasselin,1,B-XC,29,4,1,2,1,19,10
20130303-M-Delray_Beach-F-Ernests_Gulbis-Edouard_Roger_Vasselin,1,B-DTM,34,3,0,0,3,18,16
20130303-M-Delray_Beach-F-Ernests_Gulbis-Edouard_Roger_Vasselin,1,B-DTL,4,4,1,1,2,2,2
20130303-M-Delray_Beach-F-Ernests_Gulbis-Edouard_Roger_Vasselin,1,B-IO,10,5,3,1,1,7,3
20130303-M-Delray_Beach-F-Ernests_Gulbis-Edouard_Roger_Vasselin,1,S-XC,5,0,0,0,0,2,3
20130303-M-Delray_Beach-F-Ernests_Gulbis-Edouard_Roger_Vasselin,1,S-DTM,5,0,0,0,0,1,4
20130303-M-Delray_Beach-F-Ernests_Gulbis-Edouard_Roger_Vasselin,2,F-XC,37,5,1,1,3,14,23
20130303-M-Delray_Beach-F-Ernests_Gulbis-Edouard_Roger_Vasselin,2,F-DTM,33,2,0,0,2,13,20
20130303-M-Delray_Beach-F-Ernests_Gulbis-Edouard_Roger_Vasselin,2,F-DTL,5,3,1,0,2,3,2
20130303-M-Delray_Beach-F-Ernests_Gulbis-Edouard_Roger_Vasselin,2,F-IO,17,5,2,2,1,10,7
20130303-M-Delray_Beach-F-Ernests_Gulbis-Edouard_Roger_Vasselin,2,F-II,1,0,0,0,0,1,0
20130303-M-Delray_Beach-F-Ernests_Gulbis-Edouard_Roger_Vasselin,2,B-XC,26,7,0,3,4,11,15
20130303-M-Delray_Beach-F-Ernests_Gulbis-Edouard_Roger_Vasselin,2,B-DTM,23,2,1,0,1,8,15
20130303-M-Delray_Beach-F-Ernests_Gulbis-Edouard_Roger_Vasselin,2,B-DTL,6,4,1,1,2,3,3
20130303-M-Delray_Beach-F-Ernests_Gulbis-Edouard_Roger_Vasselin,2,B-IO,8,2,0,0,2,2,6
20130303-M-Delray_Beach-F-Ernests_Gulbis-Edouard_Roger_Vasselin,2,S-XC,12,1,0,0,1,5,7
20130303-M-Delray_Beach-F-Ernests_Gulbis-Edouard_Roger_Vasselin,2,S-DTM,12,0,0,0,0,5,7
20130303-M-Delray_Beach-F-Ernests_Gulbis-Edouard_Roger_Vasselin,2,S-DTL,3,1,0,0,1,0,3
20130303-M-Delray_Beach-F-Ernests_Gulbis-Edouard_Roger_Vasselin,2,S-IO,2,0,0,0,0,1,1
20140104-M-Doha-F-Rafael_Nadal-Gael_Monfils,1,F-XC,83,18,4,7,7,55,28
20140104-M-Doha-F-Rafael_Nadal-Gael_Monfils,1,F-DTM,25,4,0,1,3,16,9
20140104-M-Doha-F-Rafael_Nadal-Gael_Monfils,1,F-DTL,20,4,1,2,1,15,5
20140104-M-Doha-F-Rafael_Nadal-Gael_Monfils,1,F-IO,31,12,6,4,2,20,11
20140104-M-Doha-F-Rafael_Nadal-Gael_Monfils,1,F-II,1,1,0,1,0,1,0
20140104-M-Doha-F-Rafael_Nadal-Gael_Monfils,1,B-XC,44,5,1,2,2,33,11
20140104-M-Doha-F-Rafael_Nadal-Gael_Monfils,1,B-DTM,21,1,0,0,1,14,7
20140104-M-Doha-F-Rafael_Nadal-Gael_Monfils,1,B-DTL,11,5,0,3,2,7,4
20140104-M-Doha-F-Rafael_Nadal-Gael_Monfils,1,B-IO,4,1,0,1,0,4,0
20140104-M-Doha-F-Rafael_Nadal-Gael_Monfils,1,S-XC,3,0,0,0,0,1,2
20140104-M-Doha-F-Rafael_Nadal-Gael_Monfils,1,S-DTM,10,0,0,0,0,7,3
20140104-M-Doha-F-Rafael_Nadal-Gael_Monfils,1,S-DTL,1,0,0,0,0,0,1
20140104-M-Doha-F-Rafael_Nadal-Gael_Monfils,1,S-IO,2,1,0,1,0,2,0
20140104-M-Doha-F-Rafael_Nadal-Gael_Monfils,2,F-XC,75,18,5,0,13,22,53
20140104-M-Doha-F-Rafael_Nadal-Gael_Monfils,2,F-DTM,43,3,1,0,2,11,32
20140104-M-Doha-F-Rafael_Nadal-Gael_Monfils,2,F-DTL,10,2,1,1,0,6,4
20140104-M-Doha-F-Rafael_Nadal-Gael_Monfils,2,F-IO,27,10,3,2,5,15,12
20140104-M-Doha-F-Rafael_Nadal-Gael_Monfils,2,F-II,3,1,1,0,0,2,1
20140104-M-Doha-F-Rafael_Nadal-Gael_Monfils,2,B-XC,37,9,5,1,3,13,24
20140104-M-Doha-F-Rafael_Nadal-Gael_Monfils,2,B-DTM,34,6,0,0,6,11,23
20140104-M-Doha-F-Rafael_Nadal-Gael_Monfils,2,B-DTL,11,0,0,0,0,5,6
20140104-M-Doha-F-Rafael_Nadal-Gael_Monfils,2,B-IO,2,0,0,0,0,1,1
20140104-M-Doha-F-Rafael_Nadal-Gael_Monfils,2,S-DTM,3,0,0,0,0,0,3
20140104-M-Doha-F-Rafael_Nadal-Gael_Monfils,2,S-DTL,3,0,0,0,0,0,3
20140104-M-Doha-F-Rafael_Nadal-Gael_Monfils,2,S-IO,1,0,0,0,0,1,0
20140103-M-Doha-SF-Peter_Gojowczyk-Rafael_Nadal,1,F-XC,102,16,1,7,8,39,63
20140103-M-Doha-SF-Peter_Gojowczyk-Rafael_Nadal,1,F-DTM,30,2,0,0,2,10,20
20140103-M-Doha-SF-Peter_Gojowczyk-Rafael_Nadal,1,F-DTL,11,6,4,0,2,7,4
20140103-M-Doha-SF-Peter_Gojowczyk-Rafael_Nadal,1,F-IO,30,9,3,2,4,16,14
20140103-M-Doha-SF-Peter_Gojowczyk-Rafael_Nadal,1,F-II,3,1,0,1,0,1,2
20140103-M-Doha-SF-Peter_Gojowczyk-Rafael_Nadal,1,B-XC,29,8,1,1,6,13,16
20140103-M-Doha-SF-Peter_Gojowczyk-Rafael_Nadal,1,B-DTM,28,1,0,0,1,6,22
20140103-M-Doha-SF-Peter_Gojowczyk-Rafael_Nadal,1,B-DTL,28,7,2,0,5,12,16
20140103-M-Doha-SF-Peter_Gojowczyk-Rafael_Nadal,1,B-IO,6,0,0,0,0,6,0
20140103-M-Doha-SF-Peter_Gojowczyk-Rafael_Nadal,1,S-DTM,1,0,0,0,0,1,0
20140103-M-Doha-SF-Peter_Gojowczyk-Rafael_Nadal,1,S-DTL,1,0,0,0,0,0,1
20140103-M-Doha-SF-Peter_Gojowczyk-Rafael_Nadal,1,S-IO,1,0,0,0,0,0,1
20140103-M-Doha-SF-Peter_Gojowczyk-Rafael_Nadal,2,F-XC,47,6,1,2,3,25,22
20140103-M-Doha-SF-Peter_Gojowczyk-Rafael_Nadal,2,F-DTM,26,2,0,0,2,13,13
20140103-M-Doha-SF-Peter_Gojowczyk-Rafael_Nadal,2,F-DTL,23,10,3,1,6,11,12
20140103-M-Doha-SF-Peter_Gojowczyk-Rafael_Nadal,2,F-IO,22,11,7,1,3,16,6
20140103-M-Doha-SF-Peter_Gojowczyk-Rafael_Nadal,2,F-II,5,1,1,0,0,5,0
20140103-M-Doha-SF-Peter_Gojowczyk-Rafael_Nadal,2,B-XC,51,10,1,3,6,30,21
20140103-M-Doha-SF-Peter_Gojowczyk-Rafael_Nadal,2,B-DTM,24,1,0,0,1,19,5
20140103-M-Doha-SF-Peter_Gojowczyk-Rafael_Nadal,2,B-DTL,13,2,0,0,2,7,6
20140103-M-Doha-SF-Peter_Gojowczyk-Rafael_Nadal,2,S-XC,9,0,0,0,0,5,4
20140103-M-Doha-SF-Peter_Gojowczyk-Rafael_Nadal,2,S-DTM,24,1,0,0,1,12,12
20140103-M-Doha-SF-Peter_Gojowczyk-Rafael_Nadal,2,S-DTL,10,1,0,1,0,6,4
20140103-M-Doha-SF-Peter_Gojowczyk-Rafael_Nadal,2,S-IO,3,0,0,0,0,2,1
20140102-M-Doha-QF-Ernests_Gulbis-Rafael_Nadal,1,F-XC,36,7,2,1,4,20,16
20140102-M-Doha-QF-Ernests_Gulbis-Rafael_Nadal,1,F-DTM,29,4,0,0,4,16,13
20140102-M-Doha-QF-Ernests_Gulbis-Rafael_Nadal,1,F-DTL,12,5,2,1,2,9,3
20140102-M-Doha-QF-Ernests_Gulbis-Rafael_Nadal,1,F-IO,18,11,7,2,2,12,6
20140102-M-Doha-QF-Ernests_Gulbis-Rafael_Nadal,1,B-XC,35,12,6,0,6,22,13
20140102-M-Doha-QF-Ernests_Gulbis-Rafael_Nadal,1,B-DTM,33,5,0,2,3,15,18
20140102-M-Doha-QF-Ernests_Gulbis-Rafael_Nadal,1,B-DTL,18,4,0,1,3,12,6
20140102-M-Doha-QF-Ernests_Gulbis-Rafael_Nadal,1,B-IO,14,5,1,1,3,8,6
20140102-M-Doha-QF-Ernests_Gulbis-Rafael_Nadal,1,S-DTM,4,0,0,0,0,2,2
20140102-M-Doha-QF-Ernests_Gulbis-Rafael_Nadal,1,S-DTL,2,0,0,0,0,1,1
20140102-M-Doha-QF-Ernests_Gulbis-Rafael_Nadal,1,S-IO,2,0,0,0,0,2,0
20140102-M-Doha-QF-Ernests_Gulbis-Rafael_Nadal,2,F-XC,53,7,1,4,2,26,27
20140102-M-Doha-QF-Ernests_Gulbis-Rafael_Nadal,2,F-DTM,32,2,0,0,2,12,20
20140102-M-Doha-QF-Ernests_Gulbis-Rafael_Nadal,2,F-DTL,9,3,1,1,1,3,6
20140102-M-Doha-QF-Ernests_Gulbis-Rafael_Nadal,2,F-IO,32,6,2,2,2,20,12
20140102-M-Doha-QF-Ernests_Gulbis-Rafael_Nadal,2,F-II,6,0,0,0,0,1,5
20140102-M-Doha-QF-Ernests_Gulbis-Rafael_Nadal,2,B-XC,17,4,2,1,1,10,7
20140102-M-Doha-QF-Ernests_Gulbis-Rafael_Nadal,2,B-DTM,19,0,0,0,0,5,14
20140102-M-Doha-QF-Ernests_Gulbis-Rafael_Nadal,2,B-DTL,8,2,1,0,1,5,3
20140102-M-Doha-QF-Ernests_Gulbis-Rafael_Nadal,2,B-IO,5,0,0,0,0,1,4
20140102-M-Doha-QF-Ernests_Gulbis-Rafael_Nadal,2,S-XC,6,0,0,0,0,0,6
20140102-M-Doha-QF-Ernests_Gulbis-Rafael_Nadal,2,S-DTM,15,1,0,1,0,5,10
20140102-M-Doha-QF-Ernests_Gulbis-Rafael_Nadal,2,S-DTL,3,2,0,0,2,0,3
20140101-M-Doha-R16-Rafael_Nadal-Tobias_Kamke,1,F-XC,101,24,11,5,8,62,39
20140101-M-Doha-R16-Rafael_Nadal-Tobias_Kamke,1,F-DTM,36,4,0,1,3,16,20
20140101-M-Doha-R16-Rafael_Nadal-Tobias_Kamke,1,F-DTL,15,5,2,2,1,8,7
20140101-M-Doha-R16-Rafael_Nadal-Tobias_Kamke,1,F-IO,40,12,6,3,3,22,18
20140101-M-Doha-R16-Rafael_Nadal-Tobias_Kamke,1,F-II,9,2,1,0,1,7,2
20140101-M-Doha-R16-Rafael_Nadal-Tobias_Kamke,1,B-XC,38,5,1,0,4,24,14
20140101-M-Doha-R16-Rafael_Nadal-Tobias_Kamke,1,B-DTM,28,1,0,0,1,13,15
20140101-M-Doha-R16-Rafael_Nadal-Tobias_Kamke,1,B-DTL,15,3,0,1,2,8,7
20140101-M-Doha-R16-Rafael_Nadal-Tobias_Kamke,1,B-IO,2,1,0,0,1,1,1
20140101-M-Doha-R16-Rafael_Nadal-Tobias_Kamke,1,S-XC,5,0,0,0,0,3,2
20140101-M-Doha-R16-Rafael_Nadal-Tobias_Kamke,1,S-DTM,10,0,0,0,0,3,7
20140101-M-Doha-R16-Rafael_Nadal-Tobias_Kamke,1,S-DTL,3,0,0,0,0,1,2
20140101-M-Doha-R16-Rafael_Nadal-Tobias_Kamke,2,F-XC,73,12,2,4,6,35,38
20140101-M-Doha-R16-Rafael_Nadal-Tobias_Kamke,2,F-DTM,54,1,0,0,1,21,33
20140101-M-Doha-R16-Rafael_Nadal-Tobias_Kamke,2,F-DTL,13,5,2,1,2,6,7
20140101-M-Doha-R16-Rafael_Nadal-Tobias_Kamke,2,F-IO,31,16,4,6,6,18,13
20140101-M-Doha-R16-Rafael_Nadal-Tobias_Kamke,2,F-II,4,3,1,1,1,3,1
20140101-M-Doha-R16-Rafael_Nadal-Tobias_Kamke,2,B-XC,53,11,5,2,4,27,26
20140101-M-Doha-R16-Rafael_Nadal-Tobias_Kamke,2,B-DTM,36,0,0,0,0,22,14
20140101-M-Doha-R16-Rafael_Nadal-Tobias_Kamke,2,B-DTL,19,7,2,0,5,7,12
20140101-M-Doha-R16-Rafael_Nadal-Tobias_Kamke,2,B-IO,2,1,0,0,1,0,2
20140101-M-Doha-R16-Rafael_Nadal-Tobias_Kamke,2,S-XC,5,0,0,0,0,2,3
20140101-M-Doha-R16-Rafael_Nadal-Tobias_Kamke,2,S-DTM,6,1,0,0,1,1,5
20140101-M-Doha-R16-Rafael_Nadal-Tobias_Kamke,2,S-DTL,7,0,0,0,0,1,6
20131231-M-Doha-R32-Rafael_Nadal-Lukas_Rosol,1,F-XC,21,11,4,3,4,8,13
20131231-M-Doha-R32-Rafael_Nadal-Lukas_Rosol,1,F-DTM,26,2,0,0,2,15,11
20131231-M-Doha-R32-Rafael_Nadal-Lukas_Rosol,1,F-DTL,4,0,0,0,0,2,2
20131231-M-Doha-R32-Rafael_Nadal-Lukas_Rosol,1,F-IO,52,6,2,1,3,37,15
20131231-M-Doha-R32-Rafael_Nadal-Lukas_Rosol,1,F-II,5,5,1,1,3,2,3
20131231-M-Doha-R32-Rafael_Nadal-Lukas_Rosol,1,B-XC,2,1,0,0,1,0,2
20131231-M-Doha-R32-Rafael_Nadal-Lukas_Rosol,1,B-DTM,17,1,0,0,1,11,6
20131231-M-Doha-R32-Rafael_Nadal-Lukas_Rosol,1,B-DTL,1,0,0,0,0,1,0
20131231-M-Doha-R32-Rafael_Nadal-Lukas_Rosol,1,B-IO,23,6,0,3,3,12,11
20131231-M-Doha-R32-Rafael_Nadal-Lukas_Rosol,1,B-II,11,2,2,0,0,6,5
20131231-M-Doha-R32-Rafael_Nadal-Lukas_Rosol,1,S-XC,3,0,0,0,0,2,1
20131231-M-Doha-R32-Rafael_Nadal-Lukas_Rosol,1,S-DTM,17,1,0,1,0,9,8
20131231-M-Doha-R32-Rafael_Nadal-Lukas_Rosol,1,S-IO,3,0,0,0,0,3,0
20131231-M-Doha-R32-Rafael_Nadal-Lukas_Rosol,1,S-II,4,1,0,0,1,2,2
20131231-M-Doha-R32-Rafael_Nadal-Lukas_Rosol,2,F-XC,51,13,5,2,6,25,26
20131231-M-Doha-R32-Rafael_Nadal-Lukas_Rosol,2,F-DTM,30,7,1,0,6,11,19
20131231-M-Doha-R32-Rafael_Nadal-Lukas_Rosol,2,F-DTL,13,8,4,1,3,7,6
20131231-M-Doha-R32-Rafael_Nadal-Lukas_Rosol,2,F-IO,34,19,9,3,7,18,16
20131231-M-Doha-R32-Rafael_Nadal-Lukas_Rosol,2,F-II,10,5,1,0,4,3,7
20131231-M-Doha-R32-Rafael_Nadal-Lukas_Rosol,2,B-XC,27,13,2,2,9,11,16
20131231-M-Doha-R32-Rafael_Nadal-Lukas_Rosol,2,B-DTM,23,2,0,1,1,10,13
20131231-M-Doha-R32-Rafael_Nadal-Lukas_Rosol,2,B-DTL,7,1,0,0,1,2,5
20131231-M-Doha-R32-Rafael_Nadal-Lukas_Rosol,2,B-IO,1,0,0,0,0,0,1
20131231-M-Doha-R32-Rafael_Nadal-Lukas_Rosol,2,B-II,1,0,0,0,0,0,1
20131231-M-Doha-R32-Rafael_Nadal-Lukas_Rosol,2,S-DTM,2,1,0,0,1,0,2
20131231-M-Doha-R32-Rafael_Nadal-Lukas_Rosol,2,S-DTL,2,0,0,0,0,0,2
20140301-M-Dubai-F-Tomas_Berdych-Roger_Federer,1,F-XC,28,8,3,1,4,13,15
20140301-M-Dubai-F-Tomas_Berdych-Roger_Federer,1,F-DTM,52,9,2,0,7,25,27
20140301-M-Dubai-F-Tomas_Berdych-Roger_Federer,1,F-DTL,3,0,0,0,0,1,2
20140301-M-Dubai-F-Tomas_Berdych-Roger_Federer,1,F-IO,34,17,2,2,13,13,21
20140301-M-Dubai-F-Tomas_Berdych-Roger_Federer,1,F-II,2,2,1,1,0,2,0
20140301-M-Dubai-F-Tomas_Berdych-Roger_Federer,1,B-XC,25,3,1,0,2,9,16
20140301-M-Dubai-F-Tomas_Berdych-Roger_Federer,1,B-DTM,27,6,0,0,6,9,18
20140301-M-Dubai-F-Tomas_Berdych-Roger_Federer,1,B-DTL,7,5,1,2,2,4,3
20140301-M-Dubai-F-Tomas_Berdych-Roger_Federer,1,B-IO,4,2,0,1,1,2,2
20140301-M-Dubai-F-Tomas_Berdych-Roger_Federer,1,S-XC,3,1,0,0,1,1,2
20140301-M-Dubai-F-Tomas_Berdych-Roger_Federer,1,S-DTM,3,0,0,0,0,1,2
20140301-M-Dubai-F-Tomas_Berdych-Roger_Federer,1,S-DTL,2,0,0,0,0,1,1
20140301-M-Dubai-F-Tomas_Berdych-Roger_Federer,1,S-IO,1,0,0,0,0,0,1
20140301-M-Dubai-F-Tomas_Berdych-Roger_Federer,2,F-XC,42,14,3,2,9,21,21
20140301-M-Dubai-F-Tomas_Berdych-Roger_Federer,2,F-DTM,39,7,1,0,6,21,18
20140301-M-Dubai-F-Tomas_Berdych-Roger_Federer,2,F-DTL,6,4,3,1,0,5,1
20140301-M-Dubai-F-Tomas_Berdych-Roger_Federer,2,F-IO,20,10,3,1,6,9,11
20140301-M-Dubai-F-Tomas_Berdych-Roger_Federer,2,F-II,2,1,0,0,1,1,1
20140301-M-Dubai-F-Tomas_Berdych-Roger_Federer,2,B-XC,17,2,0,0,2,11,6
20140301-M-Dubai-F-Tomas_Berdych-Roger_Federer,2,B-DTM,29,1,0,0,1,19,10
20140301-M-Dubai-F-Tomas_Berdych-Roger_Federer,2,B-DTL,1,1,0,0,1,0,1
20140301-M-Dubai-F-Tomas_Berdych-Roger_Federer,2,B-IO,3,1,0,0,1,1,2
20140301-M-Dubai-F-Tomas_Berdych-Roger_Federer,2,S-XC,13,0,0,0,0,9,4
20140301-M-Dubai-F-Tomas_Berdych-Roger_Federer,2,S-DTM,2,0,0,0,0,0,2
20140228-M-Dubai-SF-Novak_Djokovic-Roger_Federer,1,F-XC,22,9,2,2,5,8,14
20140228-M-Dubai-SF-Novak_Djokovic-Roger_Federer,1,F-DTM,32,2,0,0,2,18,14
20140228-M-Dubai-SF-Novak_Djokovic-Roger_Federer,1,F-DTL,7,0,0,0,0,3,4
20140228-M-Dubai-SF-Novak_Djokovic-Roger_Federer,1,F-IO,32,5,3,0,2,15,17
20140228-M-Dubai-SF-Novak_Djokovic-Roger_Federer,1,F-II,1,1,0,1,0,1,0
20140228-M-Dubai-SF-Novak_Djokovic-Roger_Federer,1,B-XC,48,11,6,1,3,23,25
20140228-M-Dubai-SF-Novak_Djokovic-Roger_Federer,1,B-DTM,35,3,0,1,2,16,19
20140228-M-Dubai-SF-Novak_Djokovic-Roger_Federer,1,B-DTL,9,1,1,0,0,6,3
20140228-M-Dubai-SF-Novak_Djokovic-Roger_Federer,1,B-IO,10,8,1,1,6,2,8
20140228-M-Dubai-SF-Novak_Djokovic-Roger_Federer,1,S-XC,3,0,0,0,0,3,0
20140228-M-Dubai-SF-Novak_Djokovic-Roger_Federer,1,S-DTM,1,0,0,0,0,0,1
20140228-M-Dubai-SF-Novak_Djokovic-Roger_Federer,2,F-XC,22,9,4,2,3,14,8
20140228-M-Dubai-SF-Novak_Djokovic-Roger_Federer,2,F-DTM,28,3,0,0,3,11,17
20140228-M-Dubai-SF-Novak_Djokovic-Roger_Federer,2,F-DTL,4,2,1,0,1,2,2
20140228-M-Dubai-SF-Novak_Djokovic-Roger_Federer,2,F-IO,24,5,1,2,2,13,11
20140228-M-Dubai-SF-Novak_Djokovic-Roger_Federer,2,F-II,2,0,0,0,0,0,2
20140228-M-Dubai-SF-Novak_Djokovic-Roger_Federer,2,B-XC,26,5,1,0,3,11,15
20140228-M-Dubai-SF-Novak_Djokovic-Roger_Federer,2,B-DTM,37,2,1,0,1,22,15
20140228-M-Dubai-SF-Novak_Djokovic-Roger_Federer,2,B-DTL,12,2,1,1,0,9,3
20140228-M-Dubai-SF-Novak_Djokovic-Roger_Federer,2,B-IO,4,0,0,0,0,1,3
20140228-M-Dubai-SF-Novak_Djokovic-Roger_Federer,2,S-XC,13,2,0,0,2,5,8
20140228-M-Dubai-SF-Novak_Djokovic-Roger_Federer,2,S-DTM,14,1,0,0,1,6,8
20140228-M-Dubai-SF-Novak_Djokovic-Roger_Federer,2,S-DTL,2,0,0,0,0,2,0
20140228-M-Dubai-SF-Novak_Djokovic-Roger_Federer,2,S-II,1,0,0,0,0,1,0
20140519-M-Dusseldorf-R32-Dustin_Brown-Yen_Hsun_Lu,1,F-XC,32,18,7,4,7,18,14
20140519-M-Dusseldorf-R32-Dustin_Brown-Yen_Hsun_Lu,1,F-DTM,16,8,1,1,6,7,9
20140519-M-Dusseldorf-R32-Dustin_Brown-Yen_Hsun_Lu,1,F-DTL,2,1,1,0,0,1,1
20140519-M-Dusseldorf-R32-Dustin_Brown-Yen_Hsun_Lu,1,F-IO,9,4,1,1,2,6,3
20140519-M-Dusseldorf-R32-Dustin_Brown-Yen_Hsun_Lu,1,F-II,1,1,0,0,1,0,1
20140519-M-Dusseldorf-R32-Dustin_Brown-Yen_Hsun_Lu,1,B-XC,15,4,1,0,3,5,10
20140519-M-Dusseldorf-R32-Dustin_Brown-Yen_Hsun_Lu,1,B-DTM,16,3,0,0,3,9,7
20140519-M-Dusseldorf-R32-Dustin_Brown-Yen_Hsun_Lu,1,B-DTL,8,5,2,1,2,6,2
20140519-M-Dusseldorf-R32-Dustin_Brown-Yen_Hsun_Lu,1,B-IO,2,1,0,0,1,0,2
20140519-M-Dusseldorf-R32-Dustin_Brown-Yen_Hsun_Lu,1,S-XC,7,0,0,0,0,4,3
20140519-M-Dusseldorf-R32-Dustin_Brown-Yen_Hsun_Lu,1,S-DTM,4,1,0,0,1,1,3
20140519-M-Dusseldorf-R32-Dustin_Brown-Yen_Hsun_Lu,1,S-DTL,2,2,1,0,1,1,1
20140519-M-Dusseldorf-R32-Dustin_Brown-Yen_Hsun_Lu,2,F-XC,24,9,2,0,7,8,16
20140519-M-Dusseldorf-R32-Dustin_Brown-Yen_Hsun_Lu,2,F-DTM,13,2,0,2,0,7,6
20140519-M-Dusseldorf-R32-Dustin_Brown-Yen_Hsun_Lu,2,F-DTL,9,1,1,0,0,4,5
20140519-M-Dusseldorf-R32-Dustin_Brown-Yen_Hsun_Lu,2,F-IO,17,7,4,0,3,10,7
20140519-M-Dusseldorf-R32-Dustin_Brown-Yen_Hsun_Lu,2,B-XC,19,2,0,1,1,9,10
20140519-M-Dusseldorf-R32-Dustin_Brown-Yen_Hsun_Lu,2,B-DTM,12,0,0,0,0,8,4
20140519-M-Dusseldorf-R32-Dustin_Brown-Yen_Hsun_Lu,2,B-DTL,3,1,0,1,0,3,0
20140519-M-Dusseldorf-R32-Dustin_Brown-Yen_Hsun_Lu,2,B-IO,4,4,0,1,3,1,3
20140519-M-Dusseldorf-R32-Dustin_Brown-Yen_Hsun_Lu,2,S-XC,4,1,0,0,1,1,3
20140519-M-Dusseldorf-R32-Dustin_Brown-Yen_Hsun_Lu,2,S-DTM,2,0,0,0,0,0,2
20140519-M-Dusseldorf-R32-Dustin_Brown-Yen_Hsun_Lu,2,S-DTL,3,2,0,1,1,1,2
20140519-M-Dusseldorf-R32-Dustin_Brown-Yen_Hsun_Lu,2,S-IO,1,0,0,0,0,0,1
20130524-M-Dusseldorf-SF-Jarkko_Nieminen-Igor_Sijsling,1,F-XC,64,7,2,3,2,36,28
20130524-M-Dusseldorf-SF-Jarkko_Nieminen-Igor_Sijsling,1,F-DTM,26,3,0,0,3,13,13
20130524-M-Dusseldorf-SF-Jarkko_Nieminen-Igor_Sijsling,1,F-DTL,16,7,3,1,3,9,7
20130524-M-Dusseldorf-SF-Jarkko_Nieminen-Igor_Sijsling,1,F-IO,21,8,1,2,5,13,8
20130524-M-Dusseldorf-SF-Jarkko_Nieminen-Igor_Sijsling,1,F-II,2,1,1,0,0,1,1
20130524-M-Dusseldorf-SF-Jarkko_Nieminen-Igor_Sijsling,1,B-XC,44,2,1,0,1,25,19
20130524-M-Dusseldorf-SF-Jarkko_Nieminen-Igor_Sijsling,1,B-DTM,49,1,0,0,1,28,21
20130524-M-Dusseldorf-SF-Jarkko_Nieminen-Igor_Sijsling,1,B-DTL,6,2,1,0,1,4,2
20130524-M-Dusseldorf-SF-Jarkko_Nieminen-Igor_Sijsling,1,B-IO,21,4,0,1,3,8,13
20130524-M-Dusseldorf-SF-Jarkko_Nieminen-Igor_Sijsling,1,B-II,1,1,0,0,1,0,1
20130524-M-Dusseldorf-SF-Jarkko_Nieminen-Igor_Sijsling,1,S-XC,7,0,0,0,0,3,4
20130524-M-Dusseldorf-SF-Jarkko_Nieminen-Igor_Sijsling,1,S-DTM,20,1,0,0,1,14,6
20130524-M-Dusseldorf-SF-Jarkko_Nieminen-Igor_Sijsling,1,S-DTL,10,0,0,0,0,4,6
20130524-M-Dusseldorf-SF-Jarkko_Nieminen-Igor_Sijsling,1,S-IO,6,0,0,0,0,2,4
20130524-M-Dusseldorf-SF-Jarkko_Nieminen-Igor_Sijsling,2,F-XC,81,15,3,3,9,33,48
20130524-M-Dusseldorf-SF-Jarkko_Nieminen-Igor_Sijsling,2,F-DTM,27,5,1,0,4,13,14
20130524-M-Dusseldorf-SF-Jarkko_Nieminen-Igor_Sijsling,2,F-DTL,20,13,4,2,7,10,10
20130524-M-Dusseldorf-SF-Jarkko_Nieminen-Igor_Sijsling,2,F-IO,30,15,7,5,3,18,12
20130524-M-Dusseldorf-SF-Jarkko_Nieminen-Igor_Sijsling,2,F-II,4,1,0,0,1,3,1
20130524-M-Dusseldorf-SF-Jarkko_Nieminen-Igor_Sijsling,2,B-XC,52,15,3,6,6,24,28
20130524-M-Dusseldorf-SF-Jarkko_Nieminen-Igor_Sijsling,2,B-DTM,28,3,0,0,3,14,14
20130524-M-Dusseldorf-SF-Jarkko_Nieminen-Igor_Sijsling,2,B-DTL,6,4,3,0,1,3,3
20130524-M-Dusseldorf-SF-Jarkko_Nieminen-Igor_Sijsling,2,B-IO,13,2,0,1,1,4,9
20130524-M-Dusseldorf-SF-Jarkko_Nieminen-Igor_Sijsling,2,S-XC,9,1,0,0,1,3,6
20130524-M-Dusseldorf-SF-Jarkko_Nieminen-Igor_Sijsling,2,S-DTM,35,3,1,1,1,21,14
20130524-M-Dusseldorf-SF-Jarkko_Nieminen-Igor_Sijsling,2,S-DTL,6,1,0,0,1,3,3
20130524-M-Dusseldorf-SF-Jarkko_Nieminen-Igor_Sijsling,2,S-IO,3,0,0,0,0,1,2
20130827-M-US_Open-R128-Roger_Federer-Grega_Zemlja,1,F-XC,14,6,3,1,2,12,2
20130827-M-US_Open-R128-Roger_Federer-Grega_Zemlja,1,F-DTM,18,4,0,0,4,8,10
20130827-M-US_Open-R128-Roger_Federer-Grega_Zemlja,1,F-DTL,2,1,1,0,0,2,0
20130827-M-US_Open-R128-Roger_Federer-Grega_Zemlja,1,F-IO,8,5,2,1,2,6,2
20130827-M-US_Open-R128-Roger_Federer-Grega_Zemlja,1,F-II,3,2,0,0,2,0,3
20130827-M-US_Open-R128-Roger_Federer-Grega_Zemlja,1,B-XC,7,2,0,1,1,3,4
20130827-M-US_Open-R128-Roger_Federer-Grega_Zemlja,1,B-DTM,12,2,0,0,2,7,5
20130827-M-US_Open-R128-Roger_Federer-Grega_Zemlja,1,B-DTL,3,2,0,1,1,2,1
20130827-M-US_Open-R128-Roger_Federer-Grega_Zemlja,1,B-IO,1,1,0,1,0,1,0
20130827-M-US_Open-R128-Roger_Federer-Grega_Zemlja,1,S-XC,7,1,0,0,1,4,3
20130827-M-US_Open-R128-Roger_Federer-Grega_Zemlja,1,S-DTM,4,0,0,0,0,2,2
20130827-M-US_Open-R128-Roger_Federer-Grega_Zemlja,1,S-DTL,1,0,0,0,0,1,0
20130827-M-US_Open-R128-Roger_Federer-Grega_Zemlja,2,F-XC,15,7,2,0,5,5,10
20130827-M-US_Open-R128-Roger_Federer-Grega_Zemlja,2,F-DTM,12,5,1,0,4,1,11
20130827-M-US_Open-R128-Roger_Federer-Grega_Zemlja,2,F-DTL,3,1,0,0,1,0,3
20130827-M-US_Open-R128-Roger_Federer-Grega_Zemlja,2,F-IO,13,5,2,0,3,6,7
20130827-M-US_Open-R128-Roger_Federer-Grega_Zemlja,2,F-II,3,2,1,0,1,1,2
20130827-M-US_Open-R128-Roger_Federer-Grega_Zemlja,2,B-XC,8,3,1,0,2,5,3
20130827-M-US_Open-R128-Roger_Federer-Grega_Zemlja,2,B-DTM,19,6,1,0,5,7,12
20130827-M-US_Open-R128-Roger_Federer-Grega_Zemlja,2,B-DTL,1,1,0,1,0,1,0
20130827-M-US_Open-R128-Roger_Federer-Grega_Zemlja,2,S-XC,3,0,0,0,0,1,2
20130827-M-US_Open-R128-Roger_Federer-Grega_Zemlja,2,S-DTM,3,1,0,0,1,0,3
20130827-M-US_Open-R128-Roger_Federer-Grega_Zemlja,2,S-DTL,2,0,0,0,0,0,2
20130904-M-US_Open-QF-Richard_Gasquet-David_Ferrer,1,F-XC,49,14,3,1,10,21,28
20130904-M-US_Open-QF-Richard_Gasquet-David_Ferrer,1,F-DTM,69,9,0,1,8,24,45
20130904-M-US_Open-QF-Richard_Gasquet-David_Ferrer,1,F-DTL,11,4,0,1,3,4,7
20130904-M-US_Open-QF-Richard_Gasquet-David_Ferrer,1,F-IO,19,0,0,0,0,10,9
20130904-M-US_Open-QF-Richard_Gasquet-David_Ferrer,1,B-XC,135,11,0,2,9,64,71
20130904-M-US_Open-QF-Richard_Gasquet-David_Ferrer,1,B-DTM,38,2,0,0,2,18,20
20130904-M-US_Open-QF-Richard_Gasquet-David_Ferrer,1,B-DTL,25,21,12,1,8,16,9
20130904-M-US_Open-QF-Richard_Gasquet-David_Ferrer,1,B-IO,7,5,3,0,2,4,3
20130904-M-US_Open-QF-Richard_Gasquet-David_Ferrer,1,S-XC,20,0,0,0,0,11,9
20130904-M-US_Open-QF-Richard_Gasquet-David_Ferrer,1,S-DTM,11,0,0,0,0,4,7
20130904-M-US_Open-QF-Richard_Gasquet-David_Ferrer,1,S-DTL,2,1,0,0,1,0,2
20130904-M-US_Open-QF-Richard_Gasquet-David_Ferrer,2,F-XC,54,9,3,1,5,32,22
20130904-M-US_Open-QF-Richard_Gasquet-David_Ferrer,2,F-DTM,37,3,0,0,3,18,19
20130904-M-US_Open-QF-Richard_Gasquet-David_Ferrer,2,F-DTL,14,7,4,1,2,9,5
20130904-M-US_Open-QF-Richard_Gasquet-David_Ferrer,2,F-IO,58,7,1,2,4,32,26
20130904-M-US_Open-QF-Richard_Gasquet-David_Ferrer,2,F-II,23,3,1,1,1,11,12
20130904-M-US_Open-QF-Richard_Gasquet-David_Ferrer,2,B-XC,103,14,2,3,9,54,49
20130904-M-US_Open-QF-Richard_Gasquet-David_Ferrer,2,B-DTM,71,12,0,0,12,25,46
20130904-M-US_Open-QF-Richard_Gasquet-David_Ferrer,2,B-DTL,17,12,6,2,4,11,6
20130904-M-US_Open-QF-Richard_Gasquet-David_Ferrer,2,B-IO,1,0,0,0,0,1,0
20130904-M-US_Open-QF-Richard_Gasquet-David_Ferrer,2,S-XC,1,0,0,0,0,1,0
20130904-M-US_Open-QF-Richard_Gasquet-David_Ferrer,2,S-DTM,3,0,0,0,0,1,2
20130904-M-US_Open-QF-Richard_Gasquet-David_Ferrer,2,S-DTL,2,0,0,0,0,1,1
20130616-M-Halle-F-Mikhail_Youzhny-Roger_Federer,1,F-XC,29,5,3,0,2,11,18
20130616-M-Halle-F-Mikhail_Youzhny-Roger_Federer,1,F-DTM,32,1,0,0,1,12,20
20130616-M-Halle-F-Mikhail_Youzhny-Roger_Federer,1,F-DTL,7,3,0,2,1,3,4
20130616-M-Halle-F-Mikhail_Youzhny-Roger_Federer,1,F-IO,32,9,2,2,5,19,13
20130616-M-Halle-F-Mikhail_Youzhny-Roger_Federer,1,F-II,2,2,0,0,2,0,2
20130616-M-Halle-F-Mikhail_Youzhny-Roger_Federer,1,B-XC,34,6,2,1,3,22,12
20130616-M-Halle-F-Mikhail_Youzhny-Roger_Federer,1,B-DTM,16,3,0,3,0,9,7
20130616-M-Halle-F-Mikhail_Youzhny-Roger_Federer,1,B-DTL,8,3,0,1,2,3,5
20130616-M-Halle-F-Mikhail_Youzhny-Roger_Federer,1,B-IO,4,2,0,0,2,0,4
20130616-M-Halle-F-Mikhail_Youzhny-Roger_Federer,1,S-XC,20,0,0,0,0,8,12
20130616-M-Halle-F-Mikhail_Youzhny-Roger_Federer,1,S-DTM,12,3,0,0,3,3,9
20130616-M-Halle-F-Mikhail_Youzhny-Roger_Federer,1,S-DTL,5,2,0,1,1,2,3
20130616-M-Halle-F-Mikhail_Youzhny-Roger_Federer,1,S-IO,3,0,0,0,0,3,0
20130616-M-Halle-F-Mikhail_Youzhny-Roger_Federer,2,F-XC,34,11,3,4,4,24,10
20130616-M-Halle-F-Mikhail_Youzhny-Roger_Federer,2,F-DTM,38,6,0,1,5,23,15
20130616-M-Halle-F-Mikhail_Youzhny-Roger_Federer,2,F-DTL,7,1,1,0,0,7,0
20130616-M-Halle-F-Mikhail_Youzhny-Roger_Federer,2,F-IO,31,15,5,6,4,19,12
20130616-M-Halle-F-Mikhail_Youzhny-Roger_Federer,2,F-II,6,2,1,1,0,6,0
20130616-M-Halle-F-Mikhail_Youzhny-Roger_Federer,2,B-XC,21,5,1,1,3,6,15
20130616-M-Halle-F-Mikhail_Youzhny-Roger_Federer,2,B-DTM,27,3,0,0,3,12,15
20130616-M-Halle-F-Mikhail_Youzhny-Roger_Federer,2,B-DTL,8,5,1,0,4,4,4
20130616-M-Halle-F-Mikhail_Youzhny-Roger_Federer,2,B-IO,4,0,0,0,0,3,1
20130616-M-Halle-F-Mikhail_Youzhny-Roger_Federer,2,S-XC,20,0,0,0,0,11,9
20130616-M-Halle-F-Mikhail_Youzhny-Roger_Federer,2,S-DTM,9,4,0,1,3,4,5
20130616-M-Halle-F-Mikhail_Youzhny-Roger_Federer,2,S-DTL,3,1,1,0,0,2,1
20140613-M-Halle-QF-Kei_Nishikori-Steve_Johnson,1,F-XC,25,3,0,2,1,20,5
20140613-M-Halle-QF-Kei_Nishikori-Steve_Johnson,1,F-DTM,15,3,1,1,1,11,4
20140613-M-Halle-QF-Kei_Nishikori-Steve_Johnson,1,F-DTL,6,1,0,1,0,6,0
20140613-M-Halle-QF-Kei_Nishikori-Steve_Johnson,1,F-IO,22,6,3,0,3,15,7
20140613-M-Halle-QF-Kei_Nishikori-Steve_Johnson,1,F-II,3,0,0,0,0,3,0
20140613-M-Halle-QF-Kei_Nishikori-Steve_Johnson,1,B-XC,45,9,1,4,4,34,11
20140613-M-Halle-QF-Kei_Nishikori-Steve_Johnson,1,B-DTM,13,1,0,0,1,8,5
20140613-M-Halle-QF-Kei_Nishikori-Steve_Johnson,1,B-DTL,6,4,4,0,0,6,0
20140613-M-Halle-QF-Kei_Nishikori-Steve_Johnson,1,B-IO,1,0,0,0,0,1,0
20140613-M-Halle-QF-Kei_Nishikori-Steve_Johnson,1,S-XC,7,3,0,1,2,5,2
20140613-M-Halle-QF-Kei_Nishikori-Steve_Johnson,1,S-DTM,4,0,0,0,0,2,2
20140613-M-Halle-QF-Kei_Nishikori-Steve_Johnson,1,S-DTL,1,1,0,1,0,1,0
20140613-M-Halle-QF-Kei_Nishikori-Steve_Johnson,2,F-XC,31,14,5,2,7,11,20
20140613-M-Halle-QF-Kei_Nishikori-Steve_Johnson,2,F-DTM,20,5,0,1,4,3,17
20140613-M-Halle-QF-Kei_Nishikori-Steve_Johnson,2,F-DTL,5,4,0,0,4,1,4
20140613-M-Halle-QF-Kei_Nishikori-Steve_Johnson,2,F-IO,7,4,4,0,0,4,3
20140613-M-Halle-QF-Kei_Nishikori-Steve_Johnson,2,F-II,3,2,0,0,2,0,3
20140613-M-Halle-QF-Kei_Nishikori-Steve_Johnson,2,B-XC,2,0,0,0,0,0,2
20140613-M-Halle-QF-Kei_Nishikori-Steve_Johnson,2,B-DTM,2,0,0,0,0,0,2
20140613-M-Halle-QF-Kei_Nishikori-Steve_Johnson,2,B-DTL,3,3,1,0,2,1,2
20140613-M-Halle-QF-Kei_Nishikori-Steve_Johnson,2,S-XC,40,4,0,0,4,9,31
20140613-M-Halle-QF-Kei_Nishikori-Steve_Johnson,2,S-DTM,24,4,0,0,4,4,20
20140613-M-Halle-QF-Kei_Nishikori-Steve_Johnson,2,S-DTL,5,1,1,0,0,3,2
20140613-M-Halle-QF-Kei_Nishikori-Steve_Johnson,2,S-IO,3,0,0,0,0,2,1
20130720-M-Hamburg-SF-Federico_Delbonis-Roger_Federer,1,F-XC,73,8,2,3,3,41,32
20130720-M-Hamburg-SF-Federico_Delbonis-Roger_Federer,1,F-DTM,37,1,1,0,0,24,13
20130720-M-Hamburg-SF-Federico_Delbonis-Roger_Federer,1,F-DTL,3,3,0,0,3,0,3
20130720-M-Hamburg-SF-Federico_Delbonis-Roger_Federer,1,F-IO,29,15,5,5,5,19,10
20130720-M-Hamburg-SF-Federico_Delbonis-Roger_Federer,1,B-XC,30,8,6,2,0,26,4
20130720-M-Hamburg-SF-Federico_Delbonis-Roger_Federer,1,B-DTM,39,7,0,0,7,22,17
20130720-M-Hamburg-SF-Federico_Delbonis-Roger_Federer,1,B-DTL,16,2,1,0,1,7,9
20130720-M-Hamburg-SF-Federico_Delbonis-Roger_Federer,1,B-IO,10,1,0,1,0,5,5
20130720-M-Hamburg-SF-Federico_Delbonis-Roger_Federer,1,S-XC,5,1,0,0,1,4,1
20130720-M-Hamburg-SF-Federico_Delbonis-Roger_Federer,1,S-DTM,9,0,0,0,0,2,7
20130720-M-Hamburg-SF-Federico_Delbonis-Roger_Federer,1,S-DTL,6,1,0,0,1,2,4
20130720-M-Hamburg-SF-Federico_Delbonis-Roger_Federer,1,S-IO,1,0,0,0,0,1,0
20130720-M-Hamburg-SF-Federico_Delbonis-Roger_Federer,1,S-II,1,0,0,0,0,0,1
20130720-M-Hamburg-SF-Federico_Delbonis-Roger_Federer,2,F-XC,48,6,2,0,4,20,28
20130720-M-Hamburg-SF-Federico_Delbonis-Roger_Federer,2,F-DTM,59,8,0,3,5,25,34
20130720-M-Hamburg-SF-Federico_Delbonis-Roger_Federer,2,F-DTL,5,3,1,0,2,1,4
20130720-M-Hamburg-SF-Federico_Delbonis-Roger_Federer,2,F-IO,24,10,4,2,4,15,9
20130720-M-Hamburg-SF-Federico_Delbonis-Roger_Federer,2,F-II,4,2,2,0,0,4,0
20130720-M-Hamburg-SF-Federico_Delbonis-Roger_Federer,2,B-XC,29,7,5,1,1,18,11
20130720-M-Hamburg-SF-Federico_Delbonis-Roger_Federer,2,B-DTM,49,6,1,0,5,18,31
20130720-M-Hamburg-SF-Federico_Delbonis-Roger_Federer,2,B-DTL,9,0,0,0,0,6,3
20130720-M-Hamburg-SF-Federico_Delbonis-Roger_Federer,2,B-IO,5,0,0,0,0,4,1
20130720-M-Hamburg-SF-Federico_Delbonis-Roger_Federer,2,S-XC,10,2,1,1,0,5,5
20130720-M-Hamburg-SF-Federico_Delbonis-Roger_Federer,2,S-DTM,12,1,0,0,1,5,7
20130720-M-Hamburg-SF-Federico_Delbonis-Roger_Federer,2,S-DTL,6,1,0,0,1,1,5
20140311-M-Indian_Wells_Masters-R32-Julien_Benneteau-Dominic_Thiem,1,F-XC,44,10,2,2,6,21,23
20140311-M-Indian_Wells_Masters-R32-Julien_Benneteau-Dominic_Thiem,1,F-DTM,20,0,0,0,0,6,14
20140311-M-Indian_Wells_Masters-R32-Julien_Benneteau-Dominic_Thiem,1,F-DTL,6,3,2,1,0,4,2
20140311-M-Indian_Wells_Masters-R32-Julien_Benneteau-Dominic_Thiem,1,F-IO,35,4,2,1,1,21,14
20140311-M-Indian_Wells_Masters-R32-Julien_Benneteau-Dominic_Thiem,1,F-II,3,3,1,1,1,2,1
20140311-M-Indian_Wells_Masters-R32-Julien_Benneteau-Dominic_Thiem,1,B-XC,36,7,1,2,4,20,16
20140311-M-Indian_Wells_Masters-R32-Julien_Benneteau-Dominic_Thiem,1,B-DTM,30,5,0,0,5,10,20
20140311-M-Indian_Wells_Masters-R32-Julien_Benneteau-Dominic_Thiem,1,B-DTL,9,4,4,0,0,6,3
20140311-M-Indian_Wells_Masters-R32-Julien_Benneteau-Dominic_Thiem,1,B-IO,5,2,1,0,1,3,2
20140311-M-Indian_Wells_Masters-R32-Julien_Benneteau-Dominic_Thiem,1,S-DTM,3,0,0,0,0,1,2
20140311-M-Indian_Wells_Masters-R32-Julien_Benneteau-Dominic_Thiem,2,F-XC,30,8,3,1,4,13,17
20140311-M-Indian_Wells_Masters-R32-Julien_Benneteau-Dominic_Thiem,2,F-DTM,27,3,0,0,3,14,13
20140311-M-Indian_Wells_Masters-R32-Julien_Benneteau-Dominic_Thiem,2,F-DTL,7,4,2,0,2,4,3
20140311-M-Indian_Wells_Masters-R32-Julien_Benneteau-Dominic_Thiem,2,F-IO,29,5,1,1,3,16,13
20140311-M-Indian_Wells_Masters-R32-Julien_Benneteau-Dominic_Thiem,2,F-II,4,4,1,1,2,2,2
20140311-M-Indian_Wells_Masters-R32-Julien_Benneteau-Dominic_Thiem,2,B-XC,37,3,0,2,1,19,18
20140311-M-Indian_Wells_Masters-R32-Julien_Benneteau-Dominic_Thiem,2,B-DTM,25,2,0,0,2,14,11
20140311-M-Indian_Wells_Masters-R32-Julien_Benneteau-Dominic_Thiem,2,B-DTL,12,10,3,1,6,5,7
20140311-M-Indian_Wells_Masters-R32-Julien_Benneteau-Dominic_Thiem,2,B-IO,3,1,0,0,1,1,2
20140311-M-Indian_Wells_Masters-R32-Julien_Benneteau-Dominic_Thiem,2,S-XC,6,0,0,0,0,2,4
20140311-M-Indian_Wells_Masters-R32-Julien_Benneteau-Dominic_Thiem,2,S-DTM,7,1,0,1,0,2,5
20140311-M-Indian_Wells_Masters-R32-Julien_Benneteau-Dominic_Thiem,2,S-DTL,2,1,0,1,0,1,1
20130314-M-Indian_Wells-R16-Tommy_Haas-Juan_Martin_Del_Potro,1,F-XC,53,15,0,4,11,17,36
20130314-M-Indian_Wells-R16-Tommy_Haas-Juan_Martin_Del_Potro,1,F-DTM,22,2,0,0,2,7,15
20130314-M-Indian_Wells-R16-Tommy_Haas-Juan_Martin_Del_Potro,1,F-DTL,19,5,1,0,4,5,14
20130314-M-Indian_Wells-R16-Tommy_Haas-Juan_Martin_Del_Potro,1,F-IO,25,4,2,0,2,11,14
20130314-M-Indian_Wells-R16-Tommy_Haas-Juan_Martin_Del_Potro,1,F-II,3,1,1,0,0,1,2
20130314-M-Indian_Wells-R16-Tommy_Haas-Juan_Martin_Del_Potro,1,B-XC,22,2,0,1,1,5,17
20130314-M-Indian_Wells-R16-Tommy_Haas-Juan_Martin_Del_Potro,1,B-DTM,19,0,0,0,0,9,10
20130314-M-Indian_Wells-R16-Tommy_Haas-Juan_Martin_Del_Potro,1,B-DTL,7,4,0,0,4,2,5
20130314-M-Indian_Wells-R16-Tommy_Haas-Juan_Martin_Del_Potro,1,B-IO,8,5,1,1,3,3,5
20130314-M-Indian_Wells-R16-Tommy_Haas-Juan_Martin_Del_Potro,1,S-XC,11,0,0,0,0,5,6
20130314-M-Indian_Wells-R16-Tommy_Haas-Juan_Martin_Del_Potro,1,S-DTM,9,1,0,0,1,5,4
20130314-M-Indian_Wells-R16-Tommy_Haas-Juan_Martin_Del_Potro,1,S-IO,1,0,0,0,0,0,1
20130314-M-Indian_Wells-R16-Tommy_Haas-Juan_Martin_Del_Potro,2,F-XC,51,6,2,1,3,37,14
20130314-M-Indian_Wells-R16-Tommy_Haas-Juan_Martin_Del_Potro,2,F-DTM,30,3,0,0,3,18,12
20130314-M-Indian_Wells-R16-Tommy_Haas-Juan_Martin_Del_Potro,2,F-DTL,6,1,0,1,0,4,2
20130314-M-Indian_Wells-R16-Tommy_Haas-Juan_Martin_Del_Potro,2,F-IO,31,5,1,0,4,15,16
20130314-M-Indian_Wells-R16-Tommy_Haas-Juan_Martin_Del_Potro,2,F-II,1,1,1,0,0,1,0
20130314-M-Indian_Wells-R16-Tommy_Haas-Juan_Martin_Del_Potro,2,B-XC,23,2,1,1,0,16,7
20130314-M-Indian_Wells-R16-Tommy_Haas-Juan_Martin_Del_Potro,2,B-DTM,31,1,0,0,1,19,12
20130314-M-Indian_Wells-R16-Tommy_Haas-Juan_Martin_Del_Potro,2,S-XC,9,1,0,0,1,4,5
20130314-M-Indian_Wells-R16-Tommy_Haas-Juan_Martin_Del_Potro,2,S-DTM,4,0,0,0,0,3,1
20140312-M-Indian_Wells_Masters-R16-Tommy_Haas-Roger_Federer,1,F-XC,30,6,1,2,3,19,11
20140312-M-Indian_Wells_Masters-R16-Tommy_Haas-Roger_Federer,1,F-DTM,22,5,1,0,4,11,11
20140312-M-Indian_Wells_Masters-R16-Tommy_Haas-Roger_Federer,1,F-DTL,9,2,1,1,0,6,3
20140312-M-Indian_Wells_Masters-R16-Tommy_Haas-Roger_Federer,1,F-IO,26,8,1,3,4,11,15
20140312-M-Indian_Wells_Masters-R16-Tommy_Haas-Roger_Federer,1,F-II,2,1,0,0,1,1,1
20140312-M-Indian_Wells_Masters-R16-Tommy_Haas-Roger_Federer,1,B-XC,26,4,0,2,2,15,11
20140312-M-Indian_Wells_Masters-R16-Tommy_Haas-Roger_Federer,1,B-DTM,27,2,0,0,2,13,14
20140312-M-Indian_Wells_Masters-R16-Tommy_Haas-Roger_Federer,1,B-DTL,8,5,1,0,4,2,6
20140312-M-Indian_Wells_Masters-R16-Tommy_Haas-Roger_Federer,1,B-IO,5,1,0,0,1,2,3
20140312-M-Indian_Wells_Masters-R16-Tommy_Haas-Roger_Federer,1,S-XC,12,0,0,0,0,10,2
20140312-M-Indian_Wells_Masters-R16-Tommy_Haas-Roger_Federer,1,S-DTM,5,1,0,0,1,1,4
20140312-M-Indian_Wells_Masters-R16-Tommy_Haas-Roger_Federer,1,S-DTL,1,1,0,0,1,0,1
20140312-M-Indian_Wells_Masters-R16-Tommy_Haas-Roger_Federer,2,F-XC,38,13,7,0,6,20,18
20140312-M-Indian_Wells_Masters-R16-Tommy_Haas-Roger_Federer,2,F-DTM,33,4,1,0,3,14,19
20140312-M-Indian_Wells_Masters-R16-Tommy_Haas-Roger_Federer,2,F-DTL,7,4,0,1,3,2,5
20140312-M-Indian_Wells_Masters-R16-Tommy_Haas-Roger_Federer,2,F-IO,30,8,2,3,3,16,14
20140312-M-Indian_Wells_Masters-R16-Tommy_Haas-Roger_Federer,2,F-II,6,4,2,1,1,5,1
20140312-M-Indian_Wells_Masters-R16-Tommy_Haas-Roger_Federer,2,B-XC,22,1,0,1,0,8,14
20140312-M-Indian_Wells_Masters-R16-Tommy_Haas-Roger_Federer,2,B-DTM,17,1,0,0,1,9,8
20140312-M-Indian_Wells_Masters-R16-Tommy_Haas-Roger_Federer,2,B-DTL,3,1,1,0,0,1,2
20140312-M-Indian_Wells_Masters-R16-Tommy_Haas-Roger_Federer,2,B-IO,5,2,0,1,1,3,2
20140312-M-Indian_Wells_Masters-R16-Tommy_Haas-Roger_Federer,2,S-XC,5,1,0,1,0,4,1
20140312-M-Indian_Wells_Masters-R16-Tommy_Haas-Roger_Federer,2,S-DTM,3,0,0,0,0,0,3
20140312-M-Indian_Wells_Masters-R16-Tommy_Haas-Roger_Federer,2,S-DTL,1,0,0,0,0,1,0
20140316-M-Indian_Wells_Masters-F-Roger_Federer-Novak_Djokovic,1,F-XC,52,21,8,3,10,30,22
20140316-M-Indian_Wells_Masters-F-Roger_Federer-Novak_Djokovic,1,F-DTM,33,5,1,1,3,13,20
20140316-M-Indian_Wells_Masters-F-Roger_Federer-Novak_Djokovic,1,F-DTL,12,2,0,0,2,5,7
20140316-M-Indian_Wells_Masters-F-Roger_Federer-Novak_Djokovic,1,F-IO,31,11,5,3,3,21,10
20140316-M-Indian_Wells_Masters-F-Roger_Federer-Novak_Djokovic,1,F-II,4,2,0,1,1,2,2
20140316-M-Indian_Wells_Masters-F-Roger_Federer-Novak_Djokovic,1,B-XC,31,5,0,1,4,17,14
20140316-M-Indian_Wells_Masters-F-Roger_Federer-Novak_Djokovic,1,B-DTM,53,5,0,0,5,20,33
20140316-M-Indian_Wells_Masters-F-Roger_Federer-Novak_Djokovic,1,B-DTL,8,3,1,0,2,3,5
20140316-M-Indian_Wells_Masters-F-Roger_Federer-Novak_Djokovic,1,B-IO,6,4,3,1,0,5,1
20140316-M-Indian_Wells_Masters-F-Roger_Federer-Novak_Djokovic,1,S-XC,20,2,0,0,2,11,9
20140316-M-Indian_Wells_Masters-F-Roger_Federer-Novak_Djokovic,1,S-DTM,7,1,0,1,0,4,3
20140316-M-Indian_Wells_Masters-F-Roger_Federer-Novak_Djokovic,1,S-IO,1,1,1,0,0,1,0
20140316-M-Indian_Wells_Masters-F-Roger_Federer-Novak_Djokovic,2,F-XC,51,19,6,5,8,29,22
20140316-M-Indian_Wells_Masters-F-Roger_Federer-Novak_Djokovic,2,F-DTM,26,3,1,0,2,12,14
20140316-M-Indian_Wells_Masters-F-Roger_Federer-Novak_Djokovic,2,F-DTL,8,2,1,0,1,4,4
20140316-M-Indian_Wells_Masters-F-Roger_Federer-Novak_Djokovic,2,F-IO,32,11,3,4,4,20,12
20140316-M-Indian_Wells_Masters-F-Roger_Federer-Novak_Djokovic,2,F-II,1,0,0,0,0,1,0
20140316-M-Indian_Wells_Masters-F-Roger_Federer-Novak_Djokovic,2,B-XC,77,8,1,1,6,34,43
20140316-M-Indian_Wells_Masters-F-Roger_Federer-Novak_Djokovic,2,B-DTM,34,5,0,2,3,17,17
20140316-M-Indian_Wells_Masters-F-Roger_Federer-Novak_Djokovic,2,B-DTL,10,4,1,1,2,6,4
20140316-M-Indian_Wells_Masters-F-Roger_Federer-Novak_Djokovic,2,B-IO,12,4,0,1,3,8,4
20140316-M-Indian_Wells_Masters-F-Roger_Federer-Novak_Djokovic,2,S-XC,4,2,0,1,1,1,3
20140316-M-Indian_Wells_Masters-F-Roger_Federer-Novak_Djokovic,2,S-DTM,2,0,0,0,0,1,1
20140316-M-Indian_Wells_Masters-F-Roger_Federer-Novak_Djokovic,2,S-DTL,1,0,0,0,0,0,1
20140316-M-Indian_Wells_Masters-F-Roger_Federer-Novak_Djokovic,2,S-IO,1,0,0,0,0,0,1
20140311-M-Indian_Wells_Masters-R32-Mikhail_Kukushkin-Feliciano_Lopez,1,F-XC,32,8,1,0,7,16,16
20140311-M-Indian_Wells_Masters-R32-Mikhail_Kukushkin-Feliciano_Lopez,1,F-DTM,18,0,0,0,0,13,5
20140311-M-Indian_Wells_Masters-R32-Mikhail_Kukushkin-Feliciano_Lopez,1,F-DTL,12,5,3,0,2,8,4
20140311-M-Indian_Wells_Masters-R32-Mikhail_Kukushkin-Feliciano_Lopez,1,F-IO,29,9,3,3,3,19,10
20140311-M-Indian_Wells_Masters-R32-Mikhail_Kukushkin-Feliciano_Lopez,1,F-II,2,0,0,0,0,0,2
20140311-M-Indian_Wells_Masters-R32-Mikhail_Kukushkin-Feliciano_Lopez,1,B-XC,28,6,0,3,3,19,9
20140311-M-Indian_Wells_Masters-R32-Mikhail_Kukushkin-Feliciano_Lopez,1,B-DTM,37,4,0,0,4,25,12
20140311-M-Indian_Wells_Masters-R32-Mikhail_Kukushkin-Feliciano_Lopez,1,B-DTL,5,5,3,0,2,3,2
20140311-M-Indian_Wells_Masters-R32-Mikhail_Kukushkin-Feliciano_Lopez,1,B-IO,4,2,1,1,0,3,1
20140311-M-Indian_Wells_Masters-R32-Mikhail_Kukushkin-Feliciano_Lopez,1,S-XC,4,1,0,1,0,3,1
20140311-M-Indian_Wells_Masters-R32-Mikhail_Kukushkin-Feliciano_Lopez,1,S-DTM,3,0,0,0,0,1,2
20140311-M-Indian_Wells_Masters-R32-Mikhail_Kukushkin-Feliciano_Lopez,1,S-IO,1,0,0,0,0,0,1
20140311-M-Indian_Wells_Masters-R32-Mikhail_Kukushkin-Feliciano_Lopez,2,F-XC,48,8,1,3,4,16,32
20140311-M-Indian_Wells_Masters-R32-Mikhail_Kukushkin-Feliciano_Lopez,2,F-DTM,34,3,0,0,3,9,25
20140311-M-Indian_Wells_Masters-R32-Mikhail_Kukushkin-Feliciano_Lopez,2,F-DTL,5,1,0,0,1,1,4
20140311-M-Indian_Wells_Masters-R32-Mikhail_Kukushkin-Feliciano_Lopez,2,F-IO,16,5,0,3,2,7,9
20140311-M-Indian_Wells_Masters-R32-Mikhail_Kukushkin-Feliciano_Lopez,2,B-XC,5,2,1,0,1,3,2
20140311-M-Indian_Wells_Masters-R32-Mikhail_Kukushkin-Feliciano_Lopez,2,B-DTM,3,1,0,0,1,0,3
20140311-M-Indian_Wells_Masters-R32-Mikhail_Kukushkin-Feliciano_Lopez,2,B-DTL,1,1,1,0,0,1,0
20140311-M-Indian_Wells_Masters-R32-Mikhail_Kukushkin-Feliciano_Lopez,2,B-IO,1,0,0,0,0,0,1
20140311-M-Indian_Wells_Masters-R32-Mikhail_Kukushkin-Feliciano_Lopez,2,S-XC,10,1,0,0,1,4,6
20140311-M-Indian_Wells_Masters-R32-Mikhail_Kukushkin-Feliciano_Lopez,2,S-DTM,18,0,0,0,0,6,12
20140311-M-Indian_Wells_Masters-R32-Mikhail_Kukushkin-Feliciano_Lopez,2,S-DTL,1,0,0,0,0,0,1
20140311-M-Indian_Wells_Masters-R32-Mikhail_Kukushkin-Feliciano_Lopez,2,S-IO,8,0,0,0,0,3,5
20140315-M-Indian_Wells_Masters-SF-John_Isner-Novak_Djokovic,1,F-XC,25,12,6,3,3,16,9
20140315-M-Indian_Wells_Masters-SF-John_Isner-Novak_Djokovic,1,F-DTM,46,7,0,0,7,14,32
20140315-M-Indian_Wells_Masters-SF-John_Isner-Novak_Djokovic,1,F-DTL,15,7,0,2,5,8,7
20140315-M-Indian_Wells_Masters-SF-John_Isner-Novak_Djokovic,1,F-IO,57,15,1,2,12,19,38
20140315-M-Indian_Wells_Masters-SF-John_Isner-Novak_Djokovic,1,F-II,4,4,4,0,0,4,0
20140315-M-Indian_Wells_Masters-SF-John_Isner-Novak_Djokovic,1,B-XC,27,4,0,0,4,9,18
20140315-M-Indian_Wells_Masters-SF-John_Isner-Novak_Djokovic,1,B-DTM,59,8,0,1,7,23,36
20140315-M-Indian_Wells_Masters-SF-John_Isner-Novak_Djokovic,1,B-DTL,10,8,4,0,4,5,5
20140315-M-Indian_Wells_Masters-SF-John_Isner-Novak_Djokovic,1,B-IO,1,0,0,0,0,1,0
20140315-M-Indian_Wells_Masters-SF-John_Isner-Novak_Djokovic,1,S-XC,12,0,0,0,0,6,6
20140315-M-Indian_Wells_Masters-SF-John_Isner-Novak_Djokovic,1,S-DTM,11,2,0,0,2,3,8
20140315-M-Indian_Wells_Masters-SF-John_Isner-Novak_Djokovic,2,F-XC,33,9,0,2,7,16,17
20140315-M-Indian_Wells_Masters-SF-John_Isner-Novak_Djokovic,2,F-DTM,21,0,0,0,0,13,8
20140315-M-Indian_Wells_Masters-SF-John_Isner-Novak_Djokovic,2,F-DTL,2,0,0,0,0,1,1
20140315-M-Indian_Wells_Masters-SF-John_Isner-Novak_Djokovic,2,F-IO,45,11,7,3,1,32,13
20140315-M-Indian_Wells_Masters-SF-John_Isner-Novak_Djokovic,2,F-II,3,2,1,0,1,2,1
20140315-M-Indian_Wells_Masters-SF-John_Isner-Novak_Djokovic,2,B-XC,71,5,1,1,3,42,29
20140315-M-Indian_Wells_Masters-SF-John_Isner-Novak_Djokovic,2,B-DTM,42,9,1,2,6,19,23
20140315-M-Indian_Wells_Masters-SF-John_Isner-Novak_Djokovic,2,B-DTL,7,4,2,0,2,4,3
20140315-M-Indian_Wells_Masters-SF-John_Isner-Novak_Djokovic,2,B-IO,10,5,3,1,1,6,4
20140315-M-Indian_Wells_Masters-SF-John_Isner-Novak_Djokovic,2,S-XC,5,0,0,0,0,3,2
20140315-M-Indian_Wells_Masters-SF-John_Isner-Novak_Djokovic,2,S-DTM,3,0,0,0,0,2,1
20140315-M-Indian_Wells_Masters-SF-John_Isner-Novak_Djokovic,2,S-DTL,2,0,0,0,0,1,1
20140315-M-Indian_Wells_Masters-SF-John_Isner-Novak_Djokovic,2,S-IO,1,1,0,0,1,0,1
20140310-M-Indian_Wells_Masters-R32-Jiri_Vesely-Andy_Murray,1,F-XC,89,12,1,4,7,49,40
20140310-M-Indian_Wells_Masters-R32-Jiri_Vesely-Andy_Murray,1,F-DTM,62,6,1,0,5,42,20
20140310-M-Indian_Wells_Masters-R32-Jiri_Vesely-Andy_Murray,1,F-DTL,6,3,1,1,1,4,2
20140310-M-Indian_Wells_Masters-R32-Jiri_Vesely-Andy_Murray,1,F-IO,29,10,3,1,6,18,11
20140310-M-Indian_Wells_Masters-R32-Jiri_Vesely-Andy_Murray,1,F-II,1,1,1,0,0,1,0
20140310-M-Indian_Wells_Masters-R32-Jiri_Vesely-Andy_Murray,1,B-XC,57,9,1,2,6,32,25
20140310-M-Indian_Wells_Masters-R32-Jiri_Vesely-Andy_Murray,1,B-DTM,65,6,0,0,6,34,31
20140310-M-Indian_Wells_Masters-R32-Jiri_Vesely-Andy_Murray,1,B-DTL,14,6,3,1,2,4,10
20140310-M-Indian_Wells_Masters-R32-Jiri_Vesely-Andy_Murray,1,B-IO,17,3,1,1,1,10,7
20140310-M-Indian_Wells_Masters-R32-Jiri_Vesely-Andy_Murray,1,S-XC,1,0,0,0,0,0,1
20140310-M-Indian_Wells_Masters-R32-Jiri_Vesely-Andy_Murray,1,S-DTM,11,0,0,0,0,6,5
20140310-M-Indian_Wells_Masters-R32-Jiri_Vesely-Andy_Murray,1,S-DTL,2,1,0,1,0,1,1
20140310-M-Indian_Wells_Masters-R32-Jiri_Vesely-Andy_Murray,1,S-IO,1,1,0,1,0,1,0
20140310-M-Indian_Wells_Masters-R32-Jiri_Vesely-Andy_Murray,1,S-II,1,0,0,0,0,0,1
20140310-M-Indian_Wells_Masters-R32-Jiri_Vesely-Andy_Murray,2,F-XC,90,15,6,2,7,40,50
20140310-M-Indian_Wells_Masters-R32-Jiri_Vesely-Andy_Murray,2,F-DTM,55,3,0,1,2,23,32
20140310-M-Indian_Wells_Masters-R32-Jiri_Vesely-Andy_Murray,2,F-DTL,11,5,0,1,4,2,9
20140310-M-Indian_Wells_Masters-R32-Jiri_Vesely-Andy_Murray,2,F-IO,39,10,3,2,5,18,21
20140310-M-Indian_Wells_Masters-R32-Jiri_Vesely-Andy_Murray,2,F-II,6,3,1,1,1,4,2
20140310-M-Indian_Wells_Masters-R32-Jiri_Vesely-Andy_Murray,2,B-XC,41,5,0,0,5,16,25
20140310-M-Indian_Wells_Masters-R32-Jiri_Vesely-Andy_Murray,2,B-DTM,45,2,0,1,1,18,27
20140310-M-Indian_Wells_Masters-R32-Jiri_Vesely-Andy_Murray,2,B-DTL,10,2,0,0,2,5,5
20140310-M-Indian_Wells_Masters-R32-Jiri_Vesely-Andy_Murray,2,B-IO,9,5,4,0,1,4,5
20140310-M-Indian_Wells_Masters-R32-Jiri_Vesely-Andy_Murray,2,S-XC,7,2,0,0,2,2,5
20140310-M-Indian_Wells_Masters-R32-Jiri_Vesely-Andy_Murray,2,S-DTM,22,2,0,0,2,10,12
20140310-M-Indian_Wells_Masters-R32-Jiri_Vesely-Andy_Murray,2,S-DTL,5,0,0,0,0,1,4
20140310-M-Indian_Wells_Masters-R32-Jiri_Vesely-Andy_Murray,2,S-IO,5,1,0,1,0,3,2
20140310-M-Indian_Wells_Masters-R32-Alexandr_Dolgopolov-Rafael_Nadal,1,F-XC,76,9,3,4,2,43,33
20140310-M-Indian_Wells_Masters-R32-Alexandr_Dolgopolov-Rafael_Nadal,1,F-DTM,20,1,0,0,1,11,9
20140310-M-Indian_Wells_Masters-R32-Alexandr_Dolgopolov-Rafael_Nadal,1,F-DTL,13,6,2,2,2,9,4
20140310-M-Indian_Wells_Masters-R32-Alexandr_Dolgopolov-Rafael_Nadal,1,F-IO,26,16,6,3,7,18,8
20140310-M-Indian_Wells_Masters-R32-Alexandr_Dolgopolov-Rafael_Nadal,1,F-II,9,2,1,1,0,6,3
20140310-M-Indian_Wells_Masters-R32-Alexandr_Dolgopolov-Rafael_Nadal,1,B-XC,43,19,3,1,15,18,25
20140310-M-Indian_Wells_Masters-R32-Alexandr_Dolgopolov-Rafael_Nadal,1,B-DTM,54,6,0,1,5,27,27
20140310-M-Indian_Wells_Masters-R32-Alexandr_Dolgopolov-Rafael_Nadal,1,B-DTL,23,6,1,0,5,9,14
20140310-M-Indian_Wells_Masters-R32-Alexandr_Dolgopolov-Rafael_Nadal,1,B-IO,7,1,0,0,1,5,2
20140310-M-Indian_Wells_Masters-R32-Alexandr_Dolgopolov-Rafael_Nadal,1,B-II,1,1,0,0,1,0,1
20140310-M-Indian_Wells_Masters-R32-Alexandr_Dolgopolov-Rafael_Nadal,1,S-XC,1,1,1,0,0,1,0
20140310-M-Indian_Wells_Masters-R32-Alexandr_Dolgopolov-Rafael_Nadal,1,S-DTL,1,0,0,0,0,1,0
20140310-M-Indian_Wells_Masters-R32-Alexandr_Dolgopolov-Rafael_Nadal,2,F-XC,73,7,2,3,2,43,30
20140310-M-Indian_Wells_Masters-R32-Alexandr_Dolgopolov-Rafael_Nadal,2,F-DTM,36,4,0,0,4,12,24
20140310-M-Indian_Wells_Masters-R32-Alexandr_Dolgopolov-Rafael_Nadal,2,F-DTL,10,1,1,0,0,4,6
20140310-M-Indian_Wells_Masters-R32-Alexandr_Dolgopolov-Rafael_Nadal,2,F-IO,40,15,6,4,5,22,18
20140310-M-Indian_Wells_Masters-R32-Alexandr_Dolgopolov-Rafael_Nadal,2,F-II,9,1,1,0,0,5,4
20140310-M-Indian_Wells_Masters-R32-Alexandr_Dolgopolov-Rafael_Nadal,2,B-XC,39,10,1,3,6,13,26
20140310-M-Indian_Wells_Masters-R32-Alexandr_Dolgopolov-Rafael_Nadal,2,B-DTM,24,2,0,0,2,11,13
20140310-M-Indian_Wells_Masters-R32-Alexandr_Dolgopolov-Rafael_Nadal,2,B-DTL,23,5,2,1,2,10,13
20140310-M-Indian_Wells_Masters-R32-Alexandr_Dolgopolov-Rafael_Nadal,2,B-IO,1,1,0,0,1,0,1
20140310-M-Indian_Wells_Masters-R32-Alexandr_Dolgopolov-Rafael_Nadal,2,S-XC,4,0,0,0,0,1,3
20140310-M-Indian_Wells_Masters-R32-Alexandr_Dolgopolov-Rafael_Nadal,2,S-DTM,6,0,0,0,0,3,3
20140310-M-Indian_Wells_Masters-R32-Alexandr_Dolgopolov-Rafael_Nadal,2,S-DTL,3,1,0,0,1,0,3
20140310-M-Indian_Wells_Masters-R32-Alexandr_Dolgopolov-Rafael_Nadal,2,S-IO,1,0,0,0,0,0,1
20140308-M-Indian_Wells_Masters-R64-Radek_Stepanek-Rafael_Nadal,1,F-XC,50,8,1,2,5,25,25
20140308-M-Indian_Wells_Masters-R64-Radek_Stepanek-Rafael_Nadal,1,F-DTM,39,5,0,0,5,15,24
20140308-M-Indian_Wells_Masters-R64-Radek_Stepanek-Rafael_Nadal,1,F-DTL,8,4,2,0,2,4,4
20140308-M-Indian_Wells_Masters-R64-Radek_Stepanek-Rafael_Nadal,1,F-IO,28,15,6,6,3,16,12
20140308-M-Indian_Wells_Masters-R64-Radek_Stepanek-Rafael_Nadal,1,F-II,1,1,1,0,0,1,0
20140308-M-Indian_Wells_Masters-R64-Radek_Stepanek-Rafael_Nadal,1,B-XC,11,3,0,1,2,3,8
20140308-M-Indian_Wells_Masters-R64-Radek_Stepanek-Rafael_Nadal,1,B-DTM,26,2,0,1,1,10,16
20140308-M-Indian_Wells_Masters-R64-Radek_Stepanek-Rafael_Nadal,1,B-DTL,13,7,2,0,5,4,9
20140308-M-Indian_Wells_Masters-R64-Radek_Stepanek-Rafael_Nadal,1,B-IO,9,3,0,0,3,1,8
20140308-M-Indian_Wells_Masters-R64-Radek_Stepanek-Rafael_Nadal,1,S-DTM,3,0,0,0,0,0,3
20140308-M-Indian_Wells_Masters-R64-Radek_Stepanek-Rafael_Nadal,1,S-DTL,8,1,0,0,1,2,6
20140308-M-Indian_Wells_Masters-R64-Radek_Stepanek-Rafael_Nadal,2,F-XC,44,11,4,4,3,30,14
20140308-M-Indian_Wells_Masters-R64-Radek_Stepanek-Rafael_Nadal,2,F-DTM,28,3,1,2,0,23,5
20140308-M-Indian_Wells_Masters-R64-Radek_Stepanek-Rafael_Nadal,2,F-DTL,7,4,3,1,0,6,1
20140308-M-Indian_Wells_Masters-R64-Radek_Stepanek-Rafael_Nadal,2,F-IO,43,13,2,6,5,28,15
20140308-M-Indian_Wells_Masters-R64-Radek_Stepanek-Rafael_Nadal,2,F-II,8,3,0,2,1,5,3
20140308-M-Indian_Wells_Masters-R64-Radek_Stepanek-Rafael_Nadal,2,B-XC,24,4,2,2,0,13,11
20140308-M-Indian_Wells_Masters-R64-Radek_Stepanek-Rafael_Nadal,2,B-DTM,28,2,0,1,1,13,15
20140308-M-Indian_Wells_Masters-R64-Radek_Stepanek-Rafael_Nadal,2,B-DTL,7,3,1,1,1,5,2
20140308-M-Indian_Wells_Masters-R64-Radek_Stepanek-Rafael_Nadal,2,S-XC,4,0,0,0,0,3,1
20140308-M-Indian_Wells_Masters-R64-Radek_Stepanek-Rafael_Nadal,2,S-DTM,7,0,0,0,0,1,6
20140308-M-Indian_Wells_Masters-R64-Radek_Stepanek-Rafael_Nadal,2,S-DTL,2,0,0,0,0,2,0
20140308-M-Indian_Wells_Masters-R64-Stanislas_Wawrinka-Ivo_Karlovic,1,F-XC,16,6,3,1,2,11,5
20140308-M-Indian_Wells_Masters-R64-Stanislas_Wawrinka-Ivo_Karlovic,1,F-DTM,5,0,0,0,0,4,1
20140308-M-Indian_Wells_Masters-R64-Stanislas_Wawrinka-Ivo_Karlovic,1,F-DTL,1,0,0,0,0,1,0
20140308-M-Indian_Wells_Masters-R64-Stanislas_Wawrinka-Ivo_Karlovic,1,F-IO,5,5,3,0,2,3,2
20140308-M-Indian_Wells_Masters-R64-Stanislas_Wawrinka-Ivo_Karlovic,1,F-II,1,1,1,0,0,1,0
20140308-M-Indian_Wells_Masters-R64-Stanislas_Wawrinka-Ivo_Karlovic,1,B-XC,7,2,1,1,0,5,2
20140308-M-Indian_Wells_Masters-R64-Stanislas_Wawrinka-Ivo_Karlovic,1,B-DTM,1,1,0,0,1,0,1
20140308-M-Indian_Wells_Masters-R64-Stanislas_Wawrinka-Ivo_Karlovic,1,B-DTL,1,1,1,0,0,1,0
20140308-M-Indian_Wells_Masters-R64-Stanislas_Wawrinka-Ivo_Karlovic,1,B-IO,1,1,0,0,1,0,1
20140308-M-Indian_Wells_Masters-R64-Stanislas_Wawrinka-Ivo_Karlovic,1,S-XC,3,1,1,0,0,3,0
20140308-M-Indian_Wells_Masters-R64-Stanislas_Wawrinka-Ivo_Karlovic,1,S-DTM,1,0,0,0,0,0,1
20140308-M-Indian_Wells_Masters-R64-Stanislas_Wawrinka-Ivo_Karlovic,2,F-XC,3,1,0,0,1,1,2
20140308-M-Indian_Wells_Masters-R64-Stanislas_Wawrinka-Ivo_Karlovic,2,F-DTM,8,3,0,1,2,2,6
20140308-M-Indian_Wells_Masters-R64-Stanislas_Wawrinka-Ivo_Karlovic,2,F-DTL,1,1,0,0,1,0,1
20140308-M-Indian_Wells_Masters-R64-Stanislas_Wawrinka-Ivo_Karlovic,2,F-IO,1,0,0,0,0,0,1
20140308-M-Indian_Wells_Masters-R64-Stanislas_Wawrinka-Ivo_Karlovic,2,S-XC,3,0,0,0,0,0,3
20140308-M-Indian_Wells_Masters-R64-Stanislas_Wawrinka-Ivo_Karlovic,2,S-DTM,4,0,0,0,0,1,3
20140308-M-Indian_Wells_Masters-R64-Stanislas_Wawrinka-Ivo_Karlovic,2,S-DTL,2,1,0,0,1,1,1
20140308-M-Indian_Wells_Masters-R64-Stanislas_Wawrinka-Ivo_Karlovic,2,S-IO,1,1,0,1,0,1,0
20130312-M-Indian_Wells-R32-Ernests_Gulbis-Andreas_Seppi,1,F-XC,37,8,1,2,5,15,22
20130312-M-Indian_Wells-R32-Ernests_Gulbis-Andreas_Seppi,1,F-DTM,33,4,0,0,4,13,20
20130312-M-Indian_Wells-R32-Ernests_Gulbis-Andreas_Seppi,1,F-DTL,4,2,0,0,2,1,3
20130312-M-Indian_Wells-R32-Ernests_Gulbis-Andreas_Seppi,1,F-IO,17,5,1,2,2,8,9
20130312-M-Indian_Wells-R32-Ernests_Gulbis-Andreas_Seppi,1,B-XC,73,15,2,2,11,32,41
20130312-M-Indian_Wells-R32-Ernests_Gulbis-Andreas_Seppi,1,B-DTM,38,4,0,0,4,12,26
20130312-M-Indian_Wells-R32-Ernests_Gulbis-Andreas_Seppi,1,B-DTL,5,4,0,0,4,0,5
20130312-M-Indian_Wells-R32-Ernests_Gulbis-Andreas_Seppi,1,B-IO,7,5,1,1,3,2,5
20130312-M-Indian_Wells-R32-Ernests_Gulbis-Andreas_Seppi,1,S-XC,17,1,0,0,1,5,12
20130312-M-Indian_Wells-R32-Ernests_Gulbis-Andreas_Seppi,1,S-DTM,2,0,0,0,0,1,1
20130312-M-Indian_Wells-R32-Ernests_Gulbis-Andreas_Seppi,1,S-DTL,1,0,0,0,0,0,1
20130312-M-Indian_Wells-R32-Ernests_Gulbis-Andreas_Seppi,2,F-XC,60,17,4,4,9,41,19
20130312-M-Indian_Wells-R32-Ernests_Gulbis-Andreas_Seppi,2,F-DTM,38,6,0,0,6,19,19
20130312-M-Indian_Wells-R32-Ernests_Gulbis-Andreas_Seppi,2,F-DTL,10,2,0,0,2,6,4
20130312-M-Indian_Wells-R32-Ernests_Gulbis-Andreas_Seppi,2,F-IO,37,11,2,3,6,23,14
20130312-M-Indian_Wells-R32-Ernests_Gulbis-Andreas_Seppi,2,F-II,2,0,0,0,0,2,0
20130312-M-Indian_Wells-R32-Ernests_Gulbis-Andreas_Seppi,2,B-XC,44,4,1,1,2,27,17
20130312-M-Indian_Wells-R32-Ernests_Gulbis-Andreas_Seppi,2,B-DTM,54,10,0,0,10,28,26
20130312-M-Indian_Wells-R32-Ernests_Gulbis-Andreas_Seppi,2,B-DTL,4,2,1,0,1,1,3
20130312-M-Indian_Wells-R32-Ernests_Gulbis-Andreas_Seppi,2,B-IO,2,2,0,0,2,0,2
20130312-M-Indian_Wells-R32-Ernests_Gulbis-Andreas_Seppi,2,S-XC,4,0,0,0,0,3,1
20130312-M-Indian_Wells-R32-Ernests_Gulbis-Andreas_Seppi,2,S-DTM,3,0,0,0,0,2,1
20130312-M-Indian_Wells-R32-Ernests_Gulbis-Andreas_Seppi,2,S-DTL,3,0,0,0,0,0,3
20130907-M-US_Open-SF-Novak_Djokovic-Stanislas_Wawrinka,1,F-XC,87,13,2,3,8,42,45
20130907-M-US_Open-SF-Novak_Djokovic-Stanislas_Wawrinka,1,F-DTM,75,9,1,0,8,36,39
20130907-M-US_Open-SF-Novak_Djokovic-Stanislas_Wawrinka,1,F-DTL,18,0,0,0,0,12,6
20130907-M-US_Open-SF-Novak_Djokovic-Stanislas_Wawrinka,1,F-IO,61,11,3,2,6,26,35
20130907-M-US_Open-SF-Novak_Djokovic-Stanislas_Wawrinka,1,F-II,5,1,0,1,0,4,1
20130907-M-US_Open-SF-Novak_Djokovic-Stanislas_Wawrinka,1,B-XC,122,14,3,2,9,60,62
20130907-M-US_Open-SF-Novak_Djokovic-Stanislas_Wawrinka,1,B-DTM,77,7,0,2,5,30,47
20130907-M-US_Open-SF-Novak_Djokovic-Stanislas_Wawrinka,1,B-DTL,9,3,0,0,3,4,5
20130907-M-US_Open-SF-Novak_Djokovic-Stanislas_Wawrinka,1,B-IO,11,0,0,0,0,8,3
20130907-M-US_Open-SF-Novak_Djokovic-Stanislas_Wawrinka,1,S-XC,7,1,0,0,1,3,4
20130907-M-US_Open-SF-Novak_Djokovic-Stanislas_Wawrinka,1,S-DTM,8,0,0,0,0,1,7
20130907-M-US_Open-SF-Novak_Djokovic-Stanislas_Wawrinka,2,F-XC,88,22,8,3,11,48,40
20130907-M-US_Open-SF-Novak_Djokovic-Stanislas_Wawrinka,2,F-DTM,84,10,1,0,9,37,47
20130907-M-US_Open-SF-Novak_Djokovic-Stanislas_Wawrinka,2,F-DTL,22,10,3,1,6,10,12
20130907-M-US_Open-SF-Novak_Djokovic-Stanislas_Wawrinka,2,F-IO,36,10,3,3,4,23,13
20130907-M-US_Open-SF-Novak_Djokovic-Stanislas_Wawrinka,2,F-II,6,2,0,1,1,3,3
20130907-M-US_Open-SF-Novak_Djokovic-Stanislas_Wawrinka,2,B-XC,95,15,3,3,9,54,41
20130907-M-US_Open-SF-Novak_Djokovic-Stanislas_Wawrinka,2,B-DTM,63,6,0,0,6,34,29
20130907-M-US_Open-SF-Novak_Djokovic-Stanislas_Wawrinka,2,B-DTL,23,14,5,0,9,10,13
20130907-M-US_Open-SF-Novak_Djokovic-Stanislas_Wawrinka,2,B-IO,8,2,0,1,1,4,4
20130907-M-US_Open-SF-Novak_Djokovic-Stanislas_Wawrinka,2,S-XC,51,3,0,0,3,22,29
20130907-M-US_Open-SF-Novak_Djokovic-Stanislas_Wawrinka,2,S-DTM,21,1,0,0,1,5,16
20130907-M-US_Open-SF-Novak_Djokovic-Stanislas_Wawrinka,2,S-DTL,1,1,0,0,1,0,1
20130929-M-Kuala_Lumpur-F-Julien_Benneteau-Joao_Sousa,1,F-XC,80,12,1,5,6,35,45
20130929-M-Kuala_Lumpur-F-Julien_Benneteau-Joao_Sousa,1,F-DTM,32,4,0,0,4,11,21
20130929-M-Kuala_Lumpur-F-Julien_Benneteau-Joao_Sousa,1,F-DTL,17,7,0,3,4,9,8
20130929-M-Kuala_Lumpur-F-Julien_Benneteau-Joao_Sousa,1,F-IO,35,12,3,6,3,22,13
20130929-M-Kuala_Lumpur-F-Julien_Benneteau-Joao_Sousa,1,F-II,3,1,0,1,0,2,1
20130929-M-Kuala_Lumpur-F-Julien_Benneteau-Joao_Sousa,1,B-XC,48,8,0,3,5,18,30
20130929-M-Kuala_Lumpur-F-Julien_Benneteau-Joao_Sousa,1,B-DTM,27,1,0,0,1,11,16
20130929-M-Kuala_Lumpur-F-Julien_Benneteau-Joao_Sousa,1,B-DTL,13,6,2,2,2,6,7
20130929-M-Kuala_Lumpur-F-Julien_Benneteau-Joao_Sousa,1,B-IO,7,2,1,0,1,4,3
20130929-M-Kuala_Lumpur-F-Julien_Benneteau-Joao_Sousa,1,S-DTM,3,0,0,0,0,0,3
20130929-M-Kuala_Lumpur-F-Julien_Benneteau-Joao_Sousa,1,S-DTL,2,1,0,1,0,1,1
20130929-M-Kuala_Lumpur-F-Julien_Benneteau-Joao_Sousa,2,F-XC,84,16,2,8,6,46,38
20130929-M-Kuala_Lumpur-F-Julien_Benneteau-Joao_Sousa,2,F-DTM,53,4,0,1,3,27,26
20130929-M-Kuala_Lumpur-F-Julien_Benneteau-Joao_Sousa,2,F-DTL,25,12,3,3,6,15,10
20130929-M-Kuala_Lumpur-F-Julien_Benneteau-Joao_Sousa,2,F-IO,45,9,5,3,1,32,13
20130929-M-Kuala_Lumpur-F-Julien_Benneteau-Joao_Sousa,2,F-II,12,4,1,3,0,9,3
20130929-M-Kuala_Lumpur-F-Julien_Benneteau-Joao_Sousa,2,B-XC,29,6,1,0,5,17,12
20130929-M-Kuala_Lumpur-F-Julien_Benneteau-Joao_Sousa,2,B-DTM,25,5,0,1,4,11,14
20130929-M-Kuala_Lumpur-F-Julien_Benneteau-Joao_Sousa,2,B-DTL,5,2,1,0,1,4,1
20130929-M-Kuala_Lumpur-F-Julien_Benneteau-Joao_Sousa,2,B-IO,2,0,0,0,0,1,1
20130929-M-Kuala_Lumpur-F-Julien_Benneteau-Joao_Sousa,2,S-XC,7,1,0,1,0,5,2
20130929-M-Kuala_Lumpur-F-Julien_Benneteau-Joao_Sousa,2,S-DTM,10,0,0,0,0,3,7
20130929-M-Kuala_Lumpur-F-Julien_Benneteau-Joao_Sousa,2,S-DTL,2,0,0,0,0,0,2
20130724-M-Lexington_CH-R16-James_Ward-Mitchell_Krueger,1,F-XC,5,2,1,0,1,3,2
20130724-M-Lexington_CH-R16-James_Ward-Mitchell_Krueger,1,F-DTM,15,3,0,1,2,11,4
20130724-M-Lexington_CH-R16-James_Ward-Mitchell_Krueger,1,F-IO,37,14,3,4,7,27,10
20130724-M-Lexington_CH-R16-James_Ward-Mitchell_Krueger,1,F-II,5,2,1,0,1,2,3
20130724-M-Lexington_CH-R16-James_Ward-Mitchell_Krueger,1,B-XC,1,1,1,0,0,1,0
20130724-M-Lexington_CH-R16-James_Ward-Mitchell_Krueger,1,B-DTM,11,1,0,0,1,8,3
20130724-M-Lexington_CH-R16-James_Ward-Mitchell_Krueger,1,B-IO,18,7,2,2,3,11,7
20130724-M-Lexington_CH-R16-James_Ward-Mitchell_Krueger,1,B-II,3,2,1,1,0,2,1
20130724-M-Lexington_CH-R16-James_Ward-Mitchell_Krueger,1,S-XC,3,0,0,0,0,3,0
20130724-M-Lexington_CH-R16-James_Ward-Mitchell_Krueger,1,S-IO,1,1,0,1,0,1,0
20130724-M-Lexington_CH-R16-James_Ward-Mitchell_Krueger,2,F-XC,7,3,1,1,1,5,2
20130724-M-Lexington_CH-R16-James_Ward-Mitchell_Krueger,2,F-DTM,23,2,0,0,2,2,21
20130724-M-Lexington_CH-R16-James_Ward-Mitchell_Krueger,2,F-DTL,2,1,0,1,0,2,0
20130724-M-Lexington_CH-R16-James_Ward-Mitchell_Krueger,2,F-IO,21,7,0,0,7,3,18
20130724-M-Lexington_CH-R16-James_Ward-Mitchell_Krueger,2,F-II,9,4,0,0,4,0,9
20130724-M-Lexington_CH-R16-James_Ward-Mitchell_Krueger,2,B-XC,4,2,1,0,1,2,2
20130724-M-Lexington_CH-R16-James_Ward-Mitchell_Krueger,2,B-DTM,15,0,0,0,0,2,13
20130724-M-Lexington_CH-R16-James_Ward-Mitchell_Krueger,2,B-IO,6,3,0,1,2,2,4
20130724-M-Lexington_CH-R16-James_Ward-Mitchell_Krueger,2,B-II,1,0,0,0,0,1,0
20130724-M-Lexington_CH-R16-James_Ward-Mitchell_Krueger,2,S-XC,1,0,0,0,0,0,1
20130724-M-Lexington_CH-R16-James_Ward-Mitchell_Krueger,2,S-DTM,3,0,0,0,0,2,1
20130724-M-Lexington_CH-R16-James_Ward-Mitchell_Krueger,2,S-II,3,0,0,0,0,1,2
20140507-M-Madrid_Masters-R32-Paul_Henri_Mathieu-Marin_Cilic,1,F-XC,29,11,3,3,5,17,12
20140507-M-Madrid_Masters-R32-Paul_Henri_Mathieu-Marin_Cilic,1,F-DTM,11,2,0,0,2,4,7
20140507-M-Madrid_Masters-R32-Paul_Henri_Mathieu-Marin_Cilic,1,F-DTL,5,2,0,0,2,3,2
20140507-M-Madrid_Masters-R32-Paul_Henri_Mathieu-Marin_Cilic,1,F-IO,14,2,1,0,1,8,6
20140507-M-Madrid_Masters-R32-Paul_Henri_Mathieu-Marin_Cilic,1,F-II,2,1,1,0,0,2,0
20140507-M-Madrid_Masters-R32-Paul_Henri_Mathieu-Marin_Cilic,1,B-XC,43,9,2,2,5,26,17
20140507-M-Madrid_Masters-R32-Paul_Henri_Mathieu-Marin_Cilic,1,B-DTM,16,3,0,1,2,8,8
20140507-M-Madrid_Masters-R32-Paul_Henri_Mathieu-Marin_Cilic,1,B-DTL,7,6,3,0,3,4,3
20140507-M-Madrid_Masters-R32-Paul_Henri_Mathieu-Marin_Cilic,1,B-IO,2,1,0,0,1,0,2
20140507-M-Madrid_Masters-R32-Paul_Henri_Mathieu-Marin_Cilic,1,S-XC,2,0,0,0,0,2,0
20140507-M-Madrid_Masters-R32-Paul_Henri_Mathieu-Marin_Cilic,1,S-DTM,2,0,0,0,0,2,0
20140507-M-Madrid_Masters-R32-Paul_Henri_Mathieu-Marin_Cilic,2,F-XC,27,10,5,1,4,17,10
20140507-M-Madrid_Masters-R32-Paul_Henri_Mathieu-Marin_Cilic,2,F-DTM,14,3,0,0,3,5,9
20140507-M-Madrid_Masters-R32-Paul_Henri_Mathieu-Marin_Cilic,2,F-DTL,8,5,1,2,2,4,4
20140507-M-Madrid_Masters-R32-Paul_Henri_Mathieu-Marin_Cilic,2,F-IO,23,8,4,0,4,9,14
20140507-M-Madrid_Masters-R32-Paul_Henri_Mathieu-Marin_Cilic,2,F-II,3,1,1,0,0,1,2
20140507-M-Madrid_Masters-R32-Paul_Henri_Mathieu-Marin_Cilic,2,B-XC,31,7,0,1,6,13,18
20140507-M-Madrid_Masters-R32-Paul_Henri_Mathieu-Marin_Cilic,2,B-DTM,23,3,0,0,3,9,14
20140507-M-Madrid_Masters-R32-Paul_Henri_Mathieu-Marin_Cilic,2,B-DTL,4,3,3,0,0,4,0
20140507-M-Madrid_Masters-R32-Paul_Henri_Mathieu-Marin_Cilic,2,S-XC,3,0,0,0,0,0,3
20140507-M-Madrid_Masters-R32-Paul_Henri_Mathieu-Marin_Cilic,2,S-DTM,2,0,0,0,0,0,2
20130508-M-Madrid_Masters-R16-Roger_Federer-Kei_Nishikori,1,F-XC,30,9,3,1,5,21,9
20130508-M-Madrid_Masters-R16-Roger_Federer-Kei_Nishikori,1,F-DTM,27,2,0,0,2,11,16
20130508-M-Madrid_Masters-R16-Roger_Federer-Kei_Nishikori,1,F-DTL,3,2,1,0,1,1,2
20130508-M-Madrid_Masters-R16-Roger_Federer-Kei_Nishikori,1,F-IO,22,3,2,0,1,12,10
20130508-M-Madrid_Masters-R16-Roger_Federer-Kei_Nishikori,1,F-II,3,2,1,0,1,1,2
20130508-M-Madrid_Masters-R16-Roger_Federer-Kei_Nishikori,1,B-XC,23,2,0,0,2,11,12
20130508-M-Madrid_Masters-R16-Roger_Federer-Kei_Nishikori,1,B-DTM,22,3,0,0,3,6,16
20130508-M-Madrid_Masters-R16-Roger_Federer-Kei_Nishikori,1,B-DTL,5,3,3,0,0,4,1
20130508-M-Madrid_Masters-R16-Roger_Federer-Kei_Nishikori,1,B-IO,4,2,0,0,2,2,2
20130508-M-Madrid_Masters-R16-Roger_Federer-Kei_Nishikori,1,S-XC,14,1,0,0,1,8,6
20130508-M-Madrid_Masters-R16-Roger_Federer-Kei_Nishikori,1,S-DTM,4,1,0,0,1,1,3
20130508-M-Madrid_Masters-R16-Roger_Federer-Kei_Nishikori,2,F-XC,29,12,3,1,8,12,17
20130508-M-Madrid_Masters-R16-Roger_Federer-Kei_Nishikori,2,F-DTM,30,1,0,0,1,12,18
20130508-M-Madrid_Masters-R16-Roger_Federer-Kei_Nishikori,2,F-DTL,4,1,0,0,1,1,3
20130508-M-Madrid_Masters-R16-Roger_Federer-Kei_Nishikori,2,F-IO,28,8,4,1,3,21,7
20130508-M-Madrid_Masters-R16-Roger_Federer-Kei_Nishikori,2,F-II,6,3,0,2,1,3,3
20130508-M-Madrid_Masters-R16-Roger_Federer-Kei_Nishikori,2,B-XC,46,6,1,1,4,23,23
20130508-M-Madrid_Masters-R16-Roger_Federer-Kei_Nishikori,2,B-DTM,16,1,0,0,1,5,11
20130508-M-Madrid_Masters-R16-Roger_Federer-Kei_Nishikori,2,B-DTL,13,6,1,4,1,9,4
20130508-M-Madrid_Masters-R16-Roger_Federer-Kei_Nishikori,2,B-IO,2,0,0,0,0,0,2
20130508-M-Madrid_Masters-R16-Roger_Federer-Kei_Nishikori,2,S-XC,3,1,0,0,1,1,2
20130508-M-Madrid_Masters-R16-Roger_Federer-Kei_Nishikori,2,S-DTM,2,0,0,0,0,0,2
20130508-M-Madrid_Masters-R16-Roger_Federer-Kei_Nishikori,2,S-DTL,1,0,0,0,0,0,1
20140506-M-Madrid_Masters-R64-Nicolas_Almagro-Andrey_Golubev,1,F-XC,60,28,9,8,11,36,24
20140506-M-Madrid_Masters-R64-Nicolas_Almagro-Andrey_Golubev,1,F-DTM,16,4,0,0,4,8,8
20140506-M-Madrid_Masters-R64-Nicolas_Almagro-Andrey_Golubev,1,F-DTL,10,4,1,2,1,6,4
20140506-M-Madrid_Masters-R64-Nicolas_Almagro-Andrey_Golubev,1,F-IO,26,12,4,3,5,15,11
20140506-M-Madrid_Masters-R64-Nicolas_Almagro-Andrey_Golubev,1,F-II,3,1,0,1,0,2,1
20140506-M-Madrid_Masters-R64-Nicolas_Almagro-Andrey_Golubev,1,B-XC,37,5,1,0,4,15,22
20140506-M-Madrid_Masters-R64-Nicolas_Almagro-Andrey_Golubev,1,B-DTM,26,3,0,0,3,11,15
20140506-M-Madrid_Masters-R64-Nicolas_Almagro-Andrey_Golubev,1,B-DTL,10,5,0,2,3,4,6
20140506-M-Madrid_Masters-R64-Nicolas_Almagro-Andrey_Golubev,1,B-IO,2,0,0,0,0,1,1
20140506-M-Madrid_Masters-R64-Nicolas_Almagro-Andrey_Golubev,1,S-XC,6,0,0,0,0,2,4
20140506-M-Madrid_Masters-R64-Nicolas_Almagro-Andrey_Golubev,1,S-DTM,9,2,1,0,1,3,6
20140506-M-Madrid_Masters-R64-Nicolas_Almagro-Andrey_Golubev,1,S-DTL,2,1,1,0,0,1,1
20140506-M-Madrid_Masters-R64-Nicolas_Almagro-Andrey_Golubev,2,F-XC,59,24,6,3,15,25,34
20140506-M-Madrid_Masters-R64-Nicolas_Almagro-Andrey_Golubev,2,F-DTM,22,2,0,0,2,12,10
20140506-M-Madrid_Masters-R64-Nicolas_Almagro-Andrey_Golubev,2,F-DTL,12,9,1,2,6,5,7
20140506-M-Madrid_Masters-R64-Nicolas_Almagro-Andrey_Golubev,2,F-IO,34,11,6,2,3,24,10
20140506-M-Madrid_Masters-R64-Nicolas_Almagro-Andrey_Golubev,2,F-II,5,2,1,0,1,4,1
20140506-M-Madrid_Masters-R64-Nicolas_Almagro-Andrey_Golubev,2,B-XC,29,3,1,1,1,18,11
20140506-M-Madrid_Masters-R64-Nicolas_Almagro-Andrey_Golubev,2,B-DTM,18,4,0,0,4,6,12
20140506-M-Madrid_Masters-R64-Nicolas_Almagro-Andrey_Golubev,2,B-DTL,3,3,1,1,1,2,1
20140506-M-Madrid_Masters-R64-Nicolas_Almagro-Andrey_Golubev,2,S-XC,8,0,0,0,0,4,4
20140506-M-Madrid_Masters-R64-Nicolas_Almagro-Andrey_Golubev,2,S-DTM,7,1,0,0,1,2,5
20140506-M-Madrid_Masters-R64-Nicolas_Almagro-Andrey_Golubev,2,S-DTL,2,0,0,0,0,0,2
20140509-M-Madrid_Masters-QF-Tomas_Berdych-Rafael_Nadal,1,F-XC,52,8,3,3,2,33,19
20140509-M-Madrid_Masters-QF-Tomas_Berdych-Rafael_Nadal,1,F-DTM,17,1,0,0,1,5,12
20140509-M-Madrid_Masters-QF-Tomas_Berdych-Rafael_Nadal,1,F-DTL,4,2,0,0,2,1,3
20140509-M-Madrid_Masters-QF-Tomas_Berdych-Rafael_Nadal,1,F-IO,16,8,4,1,3,10,6
20140509-M-Madrid_Masters-QF-Tomas_Berdych-Rafael_Nadal,1,F-II,3,1,0,1,0,2,1
20140509-M-Madrid_Masters-QF-Tomas_Berdych-Rafael_Nadal,1,B-XC,24,4,1,1,2,7,17
20140509-M-Madrid_Masters-QF-Tomas_Berdych-Rafael_Nadal,1,B-DTM,18,1,0,1,0,10,8
20140509-M-Madrid_Masters-QF-Tomas_Berdych-Rafael_Nadal,1,B-DTL,11,3,0,1,2,4,7
20140509-M-Madrid_Masters-QF-Tomas_Berdych-Rafael_Nadal,1,B-IO,2,0,0,0,0,0,2
20140509-M-Madrid_Masters-QF-Tomas_Berdych-Rafael_Nadal,1,S-DTM,2,0,0,0,0,0,2
20140509-M-Madrid_Masters-QF-Tomas_Berdych-Rafael_Nadal,1,S-DTL,3,0,0,0,0,0,3
20140509-M-Madrid_Masters-QF-Tomas_Berdych-Rafael_Nadal,2,F-XC,44,8,3,3,2,30,14
20140509-M-Madrid_Masters-QF-Tomas_Berdych-Rafael_Nadal,2,F-DTM,21,2,0,2,0,11,10
20140509-M-Madrid_Masters-QF-Tomas_Berdych-Rafael_Nadal,2,F-DTL,8,4,4,0,0,5,3
20140509-M-Madrid_Masters-QF-Tomas_Berdych-Rafael_Nadal,2,F-IO,24,12,8,2,2,17,7
20140509-M-Madrid_Masters-QF-Tomas_Berdych-Rafael_Nadal,2,F-II,10,3,0,2,1,8,2
20140509-M-Madrid_Masters-QF-Tomas_Berdych-Rafael_Nadal,2,B-XC,24,9,2,2,5,10,14
20140509-M-Madrid_Masters-QF-Tomas_Berdych-Rafael_Nadal,2,B-DTM,11,0,0,0,0,4,7
20140509-M-Madrid_Masters-QF-Tomas_Berdych-Rafael_Nadal,2,B-DTL,8,1,0,0,1,2,6
20140509-M-Madrid_Masters-QF-Tomas_Berdych-Rafael_Nadal,2,B-IO,1,1,0,1,0,1,0
20140509-M-Madrid_Masters-QF-Tomas_Berdych-Rafael_Nadal,2,S-XC,3,0,0,0,0,2,1
20140509-M-Madrid_Masters-QF-Tomas_Berdych-Rafael_Nadal,2,S-DTM,6,0,0,0,0,3,3
20140509-M-Madrid_Masters-QF-Tomas_Berdych-Rafael_Nadal,2,S-DTL,3,1,0,1,0,1,2
20140508-M-Madrid_Masters-R16-Jarkko_Nieminen-Rafael_Nadal,1,F-XC,12,3,1,2,0,7,5
20140508-M-Madrid_Masters-R16-Jarkko_Nieminen-Rafael_Nadal,1,F-DTM,17,2,0,0,2,5,12
20140508-M-Madrid_Masters-R16-Jarkko_Nieminen-Rafael_Nadal,1,F-DTL,15,4,3,0,1,8,7
20140508-M-Madrid_Masters-R16-Jarkko_Nieminen-Rafael_Nadal,1,F-IO,14,4,1,2,1,6,8
20140508-M-Madrid_Masters-R16-Jarkko_Nieminen-Rafael_Nadal,1,F-II,1,0,0,0,0,0,1
20140508-M-Madrid_Masters-R16-Jarkko_Nieminen-Rafael_Nadal,1,B-XC,42,6,1,2,3,17,25
20140508-M-Madrid_Masters-R16-Jarkko_Nieminen-Rafael_Nadal,1,B-DTM,35,6,0,2,4,8,27
20140508-M-Madrid_Masters-R16-Jarkko_Nieminen-Rafael_Nadal,1,B-DTL,11,5,1,1,3,3,8
20140508-M-Madrid_Masters-R16-Jarkko_Nieminen-Rafael_Nadal,1,B-IO,4,1,1,0,0,4,0
20140508-M-Madrid_Masters-R16-Jarkko_Nieminen-Rafael_Nadal,1,S-XC,2,0,0,0,0,1,1
20140508-M-Madrid_Masters-R16-Jarkko_Nieminen-Rafael_Nadal,1,S-DTM,3,1,0,0,1,0,3
20140508-M-Madrid_Masters-R16-Jarkko_Nieminen-Rafael_Nadal,2,F-XC,29,10,3,6,1,20,9
20140508-M-Madrid_Masters-R16-Jarkko_Nieminen-Rafael_Nadal,2,F-DTM,22,2,0,0,2,9,13
20140508-M-Madrid_Masters-R16-Jarkko_Nieminen-Rafael_Nadal,2,F-DTL,8,5,3,0,2,4,4
20140508-M-Madrid_Masters-R16-Jarkko_Nieminen-Rafael_Nadal,2,F-IO,40,8,2,4,2,32,8
20140508-M-Madrid_Masters-R16-Jarkko_Nieminen-Rafael_Nadal,2,F-II,9,4,2,2,0,7,2
20140508-M-Madrid_Masters-R16-Jarkko_Nieminen-Rafael_Nadal,2,B-XC,26,6,2,0,4,16,10
20140508-M-Madrid_Masters-R16-Jarkko_Nieminen-Rafael_Nadal,2,B-DTM,12,1,0,0,1,8,4
20140508-M-Madrid_Masters-R16-Jarkko_Nieminen-Rafael_Nadal,2,B-DTL,5,1,0,0,1,2,3
20140508-M-Madrid_Masters-R16-Jarkko_Nieminen-Rafael_Nadal,2,B-IO,2,1,1,0,0,2,0
20140508-M-Madrid_Masters-R16-Jarkko_Nieminen-Rafael_Nadal,2,S-XC,3,0,0,0,0,1,2
20140508-M-Madrid_Masters-R16-Jarkko_Nieminen-Rafael_Nadal,2,S-DTM,2,0,0,0,0,1,1
20140511-M-Madrid_Masters-F-Rafael_Nadal-Kei_Nishikori,1,F-XC,34,6,1,1,4,14,20
20140511-M-Madrid_Masters-F-Rafael_Nadal-Kei_Nishikori,1,F-DTM,22,1,0,1,0,7,15
20140511-M-Madrid_Masters-F-Rafael_Nadal-Kei_Nishikori,1,F-DTL,10,4,1,3,0,7,3
20140511-M-Madrid_Masters-F-Rafael_Nadal-Kei_Nishikori,1,F-IO,15,5,1,3,1,8,7
20140511-M-Madrid_Masters-F-Rafael_Nadal-Kei_Nishikori,1,F-II,8,3,1,2,0,4,4
20140511-M-Madrid_Masters-F-Rafael_Nadal-Kei_Nishikori,1,B-XC,14,1,0,1,0,9,5
20140511-M-Madrid_Masters-F-Rafael_Nadal-Kei_Nishikori,1,B-DTM,20,2,0,0,2,9,11
20140511-M-Madrid_Masters-F-Rafael_Nadal-Kei_Nishikori,1,B-DTL,15,4,1,0,3,6,9
20140511-M-Madrid_Masters-F-Rafael_Nadal-Kei_Nishikori,1,B-IO,4,3,1,1,1,2,2
20140511-M-Madrid_Masters-F-Rafael_Nadal-Kei_Nishikori,1,S-DTM,8,0,0,0,0,5,3
20140511-M-Madrid_Masters-F-Rafael_Nadal-Kei_Nishikori,1,S-DTL,2,0,0,0,0,0,2
20140511-M-Madrid_Masters-F-Rafael_Nadal-Kei_Nishikori,1,S-IO,1,0,0,0,0,1,0
20140511-M-Madrid_Masters-F-Rafael_Nadal-Kei_Nishikori,2,F-XC,38,4,0,0,4,19,19
20140511-M-Madrid_Masters-F-Rafael_Nadal-Kei_Nishikori,2,F-DTM,21,1,0,1,0,11,10
20140511-M-Madrid_Masters-F-Rafael_Nadal-Kei_Nishikori,2,F-DTL,7,3,0,1,2,2,5
20140511-M-Madrid_Masters-F-Rafael_Nadal-Kei_Nishikori,2,F-IO,29,16,6,4,6,20,9
20140511-M-Madrid_Masters-F-Rafael_Nadal-Kei_Nishikori,2,F-II,3,2,0,1,1,2,1
20140511-M-Madrid_Masters-F-Rafael_Nadal-Kei_Nishikori,2,B-XC,28,5,2,1,2,16,12
20140511-M-Madrid_Masters-F-Rafael_Nadal-Kei_Nishikori,2,B-DTM,7,0,0,0,0,6,1
20140511-M-Madrid_Masters-F-Rafael_Nadal-Kei_Nishikori,2,B-DTL,17,5,2,1,2,11,6
20140511-M-Madrid_Masters-F-Rafael_Nadal-Kei_Nishikori,2,B-IO,7,2,1,0,1,4,3
20140511-M-Madrid_Masters-F-Rafael_Nadal-Kei_Nishikori,2,S-DTL,4,1,0,0,1,1,3
20140507-M-Madrid_Masters-R32-Rafael_Nadal-Juan_Monaco,1,F-XC,60,11,4,2,5,43,17
20140507-M-Madrid_Masters-R32-Rafael_Nadal-Juan_Monaco,1,F-DTM,18,0,0,0,0,9,9
20140507-M-Madrid_Masters-R32-Rafael_Nadal-Juan_Monaco,1,F-DTL,13,8,4,1,3,6,7
20140507-M-Madrid_Masters-R32-Rafael_Nadal-Juan_Monaco,1,F-IO,16,7,2,4,1,11,5
20140507-M-Madrid_Masters-R32-Rafael_Nadal-Juan_Monaco,1,F-II,6,1,0,0,1,4,2
20140507-M-Madrid_Masters-R32-Rafael_Nadal-Juan_Monaco,1,B-XC,23,2,1,0,1,17,6
20140507-M-Madrid_Masters-R32-Rafael_Nadal-Juan_Monaco,1,B-DTM,21,1,0,0,1,11,10
20140507-M-Madrid_Masters-R32-Rafael_Nadal-Juan_Monaco,1,B-DTL,10,2,0,0,2,7,3
20140507-M-Madrid_Masters-R32-Rafael_Nadal-Juan_Monaco,1,B-IO,4,0,0,0,0,3,1
20140507-M-Madrid_Masters-R32-Rafael_Nadal-Juan_Monaco,1,S-IO,1,0,0,0,0,1,0
20140507-M-Madrid_Masters-R32-Rafael_Nadal-Juan_Monaco,2,F-XC,45,5,1,0,4,19,26
20140507-M-Madrid_Masters-R32-Rafael_Nadal-Juan_Monaco,2,F-DTM,23,1,0,0,1,6,17
20140507-M-Madrid_Masters-R32-Rafael_Nadal-Juan_Monaco,2,F-DTL,1,1,1,0,0,1,0
20140507-M-Madrid_Masters-R32-Rafael_Nadal-Juan_Monaco,2,F-IO,7,1,1,0,0,2,5
20140507-M-Madrid_Masters-R32-Rafael_Nadal-Juan_Monaco,2,F-II,2,1,0,0,1,0,2
20140507-M-Madrid_Masters-R32-Rafael_Nadal-Juan_Monaco,2,B-XC,38,7,1,2,4,14,24
20140507-M-Madrid_Masters-R32-Rafael_Nadal-Juan_Monaco,2,B-DTM,31,2,0,0,2,11,20
20140507-M-Madrid_Masters-R32-Rafael_Nadal-Juan_Monaco,2,B-DTL,7,4,1,0,3,1,6
20140507-M-Madrid_Masters-R32-Rafael_Nadal-Juan_Monaco,2,B-IO,4,0,0,0,0,0,4
20140507-M-Madrid_Masters-R32-Rafael_Nadal-Juan_Monaco,2,S-XC,3,1,0,0,1,1,2
20140507-M-Madrid_Masters-R32-Rafael_Nadal-Juan_Monaco,2,S-DTM,2,1,0,0,1,0,2
20140507-M-Madrid_Masters-R32-Rafael_Nadal-Juan_Monaco,2,S-DTL,2,0,0,0,0,0,2
20140510-M-Madrid_Masters-SF-Roberto_Bautista_Agut-Rafael_Nadal,1,F-XC,49,8,1,4,3,26,23
20140510-M-Madrid_Masters-SF-Roberto_Bautista_Agut-Rafael_Nadal,1,F-DTM,19,2,0,1,1,6,13
20140510-M-Madrid_Masters-SF-Roberto_Bautista_Agut-Rafael_Nadal,1,F-DTL,11,4,2,1,1,8,3
20140510-M-Madrid_Masters-SF-Roberto_Bautista_Agut-Rafael_Nadal,1,F-IO,29,10,6,2,2,18,11
20140510-M-Madrid_Masters-SF-Roberto_Bautista_Agut-Rafael_Nadal,1,F-II,10,2,1,1,0,7,3
20140510-M-Madrid_Masters-SF-Roberto_Bautista_Agut-Rafael_Nadal,1,B-XC,37,8,0,3,5,15,22
20140510-M-Madrid_Masters-SF-Roberto_Bautista_Agut-Rafael_Nadal,1,B-DTM,21,2,0,0,2,6,15
20140510-M-Madrid_Masters-SF-Roberto_Bautista_Agut-Rafael_Nadal,1,B-DTL,13,4,0,0,4,4,9
20140510-M-Madrid_Masters-SF-Roberto_Bautista_Agut-Rafael_Nadal,1,B-IO,2,1,0,0,1,0,2
20140510-M-Madrid_Masters-SF-Roberto_Bautista_Agut-Rafael_Nadal,1,S-XC,2,0,0,0,0,1,1
20140510-M-Madrid_Masters-SF-Roberto_Bautista_Agut-Rafael_Nadal,1,S-DTM,3,0,0,0,0,3,0
20140510-M-Madrid_Masters-SF-Roberto_Bautista_Agut-Rafael_Nadal,2,F-XC,73,13,6,4,3,45,28
20140510-M-Madrid_Masters-SF-Roberto_Bautista_Agut-Rafael_Nadal,2,F-DTM,12,0,0,0,0,3,9
20140510-M-Madrid_Masters-SF-Roberto_Bautista_Agut-Rafael_Nadal,2,F-DTL,16,8,6,1,1,9,7
20140510-M-Madrid_Masters-SF-Roberto_Bautista_Agut-Rafael_Nadal,2,F-IO,21,11,1,6,4,12,9
20140510-M-Madrid_Masters-SF-Roberto_Bautista_Agut-Rafael_Nadal,2,F-II,6,0,0,0,0,3,3
20140510-M-Madrid_Masters-SF-Roberto_Bautista_Agut-Rafael_Nadal,2,B-XC,16,5,2,1,2,11,5
20140510-M-Madrid_Masters-SF-Roberto_Bautista_Agut-Rafael_Nadal,2,B-DTM,24,2,0,0,2,12,12
20140510-M-Madrid_Masters-SF-Roberto_Bautista_Agut-Rafael_Nadal,2,B-DTL,14,5,2,0,3,5,9
20140510-M-Madrid_Masters-SF-Roberto_Bautista_Agut-Rafael_Nadal,2,S-XC,1,0,0,0,0,1,0
20140510-M-Madrid_Masters-SF-Roberto_Bautista_Agut-Rafael_Nadal,2,S-DTM,7,0,0,0,0,4,3
20140510-M-Madrid_Masters-SF-Roberto_Bautista_Agut-Rafael_Nadal,2,S-DTL,1,0,0,0,0,0,1
20130512-M-Madrid_Masters-F-Stanislas_Wawrinka-Rafael_Nadal,1,F-XC,31,3,0,0,3,14,17
20130512-M-Madrid_Masters-F-Stanislas_Wawrinka-Rafael_Nadal,1,F-DTM,19,2,0,0,2,10,9
20130512-M-Madrid_Masters-F-Stanislas_Wawrinka-Rafael_Nadal,1,F-IO,16,7,5,0,2,9,7
20130512-M-Madrid_Masters-F-Stanislas_Wawrinka-Rafael_Nadal,1,F-II,4,2,2,0,0,4,0
20130512-M-Madrid_Masters-F-Stanislas_Wawrinka-Rafael_Nadal,1,B-XC,20,6,1,1,4,5,15
20130512-M-Madrid_Masters-F-Stanislas_Wawrinka-Rafael_Nadal,1,B-DTM,22,2,0,0,2,8,14
20130512-M-Madrid_Masters-F-Stanislas_Wawrinka-Rafael_Nadal,1,B-DTL,11,2,0,0,2,2,9
20130512-M-Madrid_Masters-F-Stanislas_Wawrinka-Rafael_Nadal,1,B-IO,3,0,0,0,0,1,2
20130512-M-Madrid_Masters-F-Stanislas_Wawrinka-Rafael_Nadal,1,S-XC,2,0,0,0,0,0,2
20130512-M-Madrid_Masters-F-Stanislas_Wawrinka-Rafael_Nadal,1,S-DTM,3,0,0,0,0,0,3
20130512-M-Madrid_Masters-F-Stanislas_Wawrinka-Rafael_Nadal,1,S-DTL,4,0,0,0,0,0,4
20130512-M-Madrid_Masters-F-Stanislas_Wawrinka-Rafael_Nadal,2,F-XC,43,9,3,3,3,32,11
20130512-M-Madrid_Masters-F-Stanislas_Wawrinka-Rafael_Nadal,2,F-DTM,15,1,0,0,1,10,5
20130512-M-Madrid_Masters-F-Stanislas_Wawrinka-Rafael_Nadal,2,F-DTL,3,3,1,1,1,2,1
20130512-M-Madrid_Masters-F-Stanislas_Wawrinka-Rafael_Nadal,2,F-IO,14,8,4,1,3,8,6
20130512-M-Madrid_Masters-F-Stanislas_Wawrinka-Rafael_Nadal,2,F-II,6,3,1,1,1,5,1
20130512-M-Madrid_Masters-F-Stanislas_Wawrinka-Rafael_Nadal,2,B-XC,20,7,2,2,3,11,9
20130512-M-Madrid_Masters-F-Stanislas_Wawrinka-Rafael_Nadal,2,B-DTM,13,0,0,0,0,4,9
20130512-M-Madrid_Masters-F-Stanislas_Wawrinka-Rafael_Nadal,2,B-DTL,10,0,0,0,0,8,2
20130512-M-Madrid_Masters-F-Stanislas_Wawrinka-Rafael_Nadal,2,B-IO,4,0,0,0,0,2,2
20130512-M-Madrid_Masters-F-Stanislas_Wawrinka-Rafael_Nadal,2,S-DTM,1,0,0,0,0,1,0
20130512-M-Madrid_Masters-F-Stanislas_Wawrinka-Rafael_Nadal,2,S-DTL,4,1,0,1,0,3,1
20130512-M-Madrid_Masters-F-Stanislas_Wawrinka-Rafael_Nadal,2,S-IO,1,1,0,0,1,0,1
20130507-M-Madrid_Masters-R32-Jo_Wilfried_Tsonga-Robin_Haase,1,F-XC,54,22,10,5,7,29,25
20130507-M-Madrid_Masters-R32-Jo_Wilfried_Tsonga-Robin_Haase,1,F-DTM,21,5,0,2,3,10,11
20130507-M-Madrid_Masters-R32-Jo_Wilfried_Tsonga-Robin_Haase,1,F-DTL,9,4,1,1,2,6,3
20130507-M-Madrid_Masters-R32-Jo_Wilfried_Tsonga-Robin_Haase,1,F-IO,36,11,9,1,1,24,12
20130507-M-Madrid_Masters-R32-Jo_Wilfried_Tsonga-Robin_Haase,1,F-II,9,6,2,4,0,6,3
20130507-M-Madrid_Masters-R32-Jo_Wilfried_Tsonga-Robin_Haase,1,B-XC,48,14,4,1,9,21,27
20130507-M-Madrid_Masters-R32-Jo_Wilfried_Tsonga-Robin_Haase,1,B-DTM,25,2,0,0,2,11,14
20130507-M-Madrid_Masters-R32-Jo_Wilfried_Tsonga-Robin_Haase,1,B-DTL,7,5,1,1,3,4,3
20130507-M-Madrid_Masters-R32-Jo_Wilfried_Tsonga-Robin_Haase,1,B-IO,5,2,1,0,1,1,4
20130507-M-Madrid_Masters-R32-Jo_Wilfried_Tsonga-Robin_Haase,1,S-XC,7,0,0,0,0,4,3
20130507-M-Madrid_Masters-R32-Jo_Wilfried_Tsonga-Robin_Haase,1,S-DTM,6,1,0,0,1,2,4
20130507-M-Madrid_Masters-R32-Jo_Wilfried_Tsonga-Robin_Haase,1,S-DTL,1,0,0,0,0,0,1
20130507-M-Madrid_Masters-R32-Jo_Wilfried_Tsonga-Robin_Haase,2,F-XC,31,10,3,4,3,17,14
20130507-M-Madrid_Masters-R32-Jo_Wilfried_Tsonga-Robin_Haase,2,F-DTM,46,2,0,0,2,28,18
20130507-M-Madrid_Masters-R32-Jo_Wilfried_Tsonga-Robin_Haase,2,F-DTL,3,0,0,0,0,3,0
20130507-M-Madrid_Masters-R32-Jo_Wilfried_Tsonga-Robin_Haase,2,F-IO,67,7,4,1,2,38,29
20130507-M-Madrid_Masters-R32-Jo_Wilfried_Tsonga-Robin_Haase,2,F-II,3,2,1,0,1,2,1
20130507-M-Madrid_Masters-R32-Jo_Wilfried_Tsonga-Robin_Haase,2,B-XC,16,1,0,0,1,7,9
20130507-M-Madrid_Masters-R32-Jo_Wilfried_Tsonga-Robin_Haase,2,B-DTM,23,1,0,0,1,11,12
20130507-M-Madrid_Masters-R32-Jo_Wilfried_Tsonga-Robin_Haase,2,B-DTL,13,5,1,2,2,8,5
20130507-M-Madrid_Masters-R32-Jo_Wilfried_Tsonga-Robin_Haase,2,B-IO,3,0,0,0,0,2,1
20130507-M-Madrid_Masters-R32-Jo_Wilfried_Tsonga-Robin_Haase,2,S-XC,5,2,0,0,2,0,5
20130507-M-Madrid_Masters-R32-Jo_Wilfried_Tsonga-Robin_Haase,2,S-DTM,4,0,0,0,0,0,4
20130507-M-Madrid_Masters-R32-Jo_Wilfried_Tsonga-Robin_Haase,2,S-DTL,1,0,0,0,0,1,0
20140124-M-Maui_CH-QF-Takanyi_Garanganga-Tsung_Hua_Yang,1,F-XC,59,18,4,2,12,28,31
20140124-M-Maui_CH-QF-Takanyi_Garanganga-Tsung_Hua_Yang,1,F-DTM,83,10,1,1,8,43,40
20140124-M-Maui_CH-QF-Takanyi_Garanganga-Tsung_Hua_Yang,1,F-DTL,13,6,3,1,2,10,3
20140124-M-Maui_CH-QF-Takanyi_Garanganga-Tsung_Hua_Yang,1,F-IO,48,13,4,2,7,27,21
20140124-M-Maui_CH-QF-Takanyi_Garanganga-Tsung_Hua_Yang,1,B-XC,44,4,0,1,3,23,21
20140124-M-Maui_CH-QF-Takanyi_Garanganga-Tsung_Hua_Yang,1,B-DTM,46,2,0,0,2,20,26
20140124-M-Maui_CH-QF-Takanyi_Garanganga-Tsung_Hua_Yang,1,S-XC,1,0,0,0,0,0,1
20140124-M-Maui_CH-QF-Takanyi_Garanganga-Tsung_Hua_Yang,1,S-DTM,8,0,0,0,0,5,3
20140124-M-Maui_CH-QF-Takanyi_Garanganga-Tsung_Hua_Yang,2,F-XC,60,14,3,3,8,30,30
20140124-M-Maui_CH-QF-Takanyi_Garanganga-Tsung_Hua_Yang,2,F-DTM,58,6,0,0,6,27,31
20140124-M-Maui_CH-QF-Takanyi_Garanganga-Tsung_Hua_Yang,2,F-DTL,5,4,0,2,2,3,2
20140124-M-Maui_CH-QF-Takanyi_Garanganga-Tsung_Hua_Yang,2,F-IO,25,4,2,1,1,16,9
20140124-M-Maui_CH-QF-Takanyi_Garanganga-Tsung_Hua_Yang,2,F-II,3,2,1,0,1,2,1
20140124-M-Maui_CH-QF-Takanyi_Garanganga-Tsung_Hua_Yang,2,B-XC,45,4,0,0,4,21,24
20140124-M-Maui_CH-QF-Takanyi_Garanganga-Tsung_Hua_Yang,2,B-DTM,63,4,0,0,4,27,36
20140124-M-Maui_CH-QF-Takanyi_Garanganga-Tsung_Hua_Yang,2,B-DTL,7,5,1,1,3,4,3
20140124-M-Maui_CH-QF-Takanyi_Garanganga-Tsung_Hua_Yang,2,B-IO,9,2,1,1,0,4,5
20140124-M-Maui_CH-QF-Takanyi_Garanganga-Tsung_Hua_Yang,2,S-XC,11,1,0,0,1,2,9
20140124-M-Maui_CH-QF-Takanyi_Garanganga-Tsung_Hua_Yang,2,S-DTM,6,0,0,0,0,0,6
20140124-M-Maui_CH-QF-Takanyi_Garanganga-Tsung_Hua_Yang,2,S-IO,1,0,0,0,0,0,1
20130419-M-Monte_Carlo_Masters-QF-Richard_Gasquet-Fabio_Fognini,1,F-XC,26,6,1,2,3,10,16
20130419-M-Monte_Carlo_Masters-QF-Richard_Gasquet-Fabio_Fognini,1,F-DTM,13,0,0,0,0,4,9
20130419-M-Monte_Carlo_Masters-QF-Richard_Gasquet-Fabio_Fognini,1,F-DTL,13,1,0,0,1,11,2
20130419-M-Monte_Carlo_Masters-QF-Richard_Gasquet-Fabio_Fognini,1,F-IO,19,5,1,3,1,11,8
20130419-M-Monte_Carlo_Masters-QF-Richard_Gasquet-Fabio_Fognini,1,B-XC,63,6,1,1,4,27,36
20130419-M-Monte_Carlo_Masters-QF-Richard_Gasquet-Fabio_Fognini,1,B-DTM,23,1,0,0,1,9,14
20130419-M-Monte_Carlo_Masters-QF-Richard_Gasquet-Fabio_Fognini,1,B-DTL,9,6,0,3,3,4,5
20130419-M-Monte_Carlo_Masters-QF-Richard_Gasquet-Fabio_Fognini,1,B-IO,8,4,2,1,1,6,2
20130419-M-Monte_Carlo_Masters-QF-Richard_Gasquet-Fabio_Fognini,1,B-II,1,1,0,1,0,1,0
20130419-M-Monte_Carlo_Masters-QF-Richard_Gasquet-Fabio_Fognini,1,S-XC,8,2,0,1,1,3,5
20130419-M-Monte_Carlo_Masters-QF-Richard_Gasquet-Fabio_Fognini,1,S-DTM,6,0,0,0,0,2,4
20130419-M-Monte_Carlo_Masters-QF-Richard_Gasquet-Fabio_Fognini,1,S-DTL,1,0,0,0,0,0,1
20130419-M-Monte_Carlo_Masters-QF-Richard_Gasquet-Fabio_Fognini,2,F-XC,34,10,5,3,2,19,15
20130419-M-Monte_Carlo_Masters-QF-Richard_Gasquet-Fabio_Fognini,2,F-DTM,11,1,0,0,1,6,5
20130419-M-Monte_Carlo_Masters-QF-Richard_Gasquet-Fabio_Fognini,2,F-DTL,14,3,2,1,0,11,3
20130419-M-Monte_Carlo_Masters-QF-Richard_Gasquet-Fabio_Fognini,2,F-IO,31,5,2,1,2,21,10
20130419-M-Monte_Carlo_Masters-QF-Richard_Gasquet-Fabio_Fognini,2,F-II,5,2,2,0,0,3,2
20130419-M-Monte_Carlo_Masters-QF-Richard_Gasquet-Fabio_Fognini,2,B-XC,33,9,1,1,7,14,19
20130419-M-Monte_Carlo_Masters-QF-Richard_Gasquet-Fabio_Fognini,2,B-DTM,35,3,0,0,3,18,17
20130419-M-Monte_Carlo_Masters-QF-Richard_Gasquet-Fabio_Fognini,2,B-DTL,19,11,3,1,7,9,10
20130419-M-Monte_Carlo_Masters-QF-Richard_Gasquet-Fabio_Fognini,2,B-IO,4,3,1,0,2,1,3
20130419-M-Monte_Carlo_Masters-QF-Richard_Gasquet-Fabio_Fognini,2,B-II,1,0,0,0,0,1,0
20130419-M-Monte_Carlo_Masters-QF-Richard_Gasquet-Fabio_Fognini,2,S-XC,3,0,0,0,0,1,2
20130419-M-Monte_Carlo_Masters-QF-Richard_Gasquet-Fabio_Fognini,2,S-DTM,1,0,0,0,0,1,0
20130419-M-Monte_Carlo_Masters-QF-Richard_Gasquet-Fabio_Fognini,2,S-DTL,1,1,1,0,0,1,0
20130417-M-Monte_Carlo_Masters-R32-Nicolas_Almagro-Jurgen_Melzer,1,F-XC,21,9,3,4,2,16,5
20130417-M-Monte_Carlo_Masters-R32-Nicolas_Almagro-Jurgen_Melzer,1,F-DTM,4,2,1,0,1,1,3
20130417-M-Monte_Carlo_Masters-R32-Nicolas_Almagro-Jurgen_Melzer,1,F-DTL,2,1,0,0,1,0,2
20130417-M-Monte_Carlo_Masters-R32-Nicolas_Almagro-Jurgen_Melzer,1,F-IO,12,6,3,2,1,7,5
20130417-M-Monte_Carlo_Masters-R32-Nicolas_Almagro-Jurgen_Melzer,1,B-XC,17,5,0,2,3,8,9
20130417-M-Monte_Carlo_Masters-R32-Nicolas_Almagro-Jurgen_Melzer,1,B-DTM,22,5,0,1,4,7,15
20130417-M-Monte_Carlo_Masters-R32-Nicolas_Almagro-Jurgen_Melzer,1,B-DTL,5,2,0,1,1,2,3
20130417-M-Monte_Carlo_Masters-R32-Nicolas_Almagro-Jurgen_Melzer,1,B-IO,2,1,0,0,1,1,1
20130417-M-Monte_Carlo_Masters-R32-Nicolas_Almagro-Jurgen_Melzer,1,S-XC,1,0,0,0,0,0,1
20130417-M-Monte_Carlo_Masters-R32-Nicolas_Almagro-Jurgen_Melzer,1,S-DTM,2,0,0,0,0,0,2
20130417-M-Monte_Carlo_Masters-R32-Nicolas_Almagro-Jurgen_Melzer,1,S-DTL,1,0,0,0,0,0,1
20130417-M-Monte_Carlo_Masters-R32-Nicolas_Almagro-Jurgen_Melzer,2,F-XC,26,5,3,1,1,19,7
20130417-M-Monte_Carlo_Masters-R32-Nicolas_Almagro-Jurgen_Melzer,2,F-DTM,11,1,0,0,1,6,5
20130417-M-Monte_Carlo_Masters-R32-Nicolas_Almagro-Jurgen_Melzer,2,F-DTL,1,1,0,0,1,0,1
20130417-M-Monte_Carlo_Masters-R32-Nicolas_Almagro-Jurgen_Melzer,2,F-IO,6,4,1,2,1,3,3
20130417-M-Monte_Carlo_Masters-R32-Nicolas_Almagro-Jurgen_Melzer,2,B-XC,5,1,1,0,0,4,1
20130417-M-Monte_Carlo_Masters-R32-Nicolas_Almagro-Jurgen_Melzer,2,B-DTM,9,2,0,1,1,3,6
20130417-M-Monte_Carlo_Masters-R32-Nicolas_Almagro-Jurgen_Melzer,2,B-DTL,1,0,0,0,0,1,0
20130417-M-Monte_Carlo_Masters-R32-Nicolas_Almagro-Jurgen_Melzer,2,B-II,1,1,1,0,0,1,0
20130417-M-Monte_Carlo_Masters-R32-Nicolas_Almagro-Jurgen_Melzer,2,S-XC,1,1,0,0,1,0,1
20130417-M-Monte_Carlo_Masters-R32-Nicolas_Almagro-Jurgen_Melzer,2,S-DTM,3,0,0,0,0,1,2
20130417-M-Monte_Carlo_Masters-R32-Nicolas_Almagro-Jurgen_Melzer,2,S-DTL,4,0,0,0,0,1,3
20140418-M-Monte_Carlo_Masters-QF-David_Ferrer-Rafael_Nadal,1,F-XC,140,11,1,2,8,66,74
20140418-M-Monte_Carlo_Masters-QF-David_Ferrer-Rafael_Nadal,1,F-DTM,31,2,0,1,1,13,18
20140418-M-Monte_Carlo_Masters-QF-David_Ferrer-Rafael_Nadal,1,F-DTL,10,6,1,2,3,6,4
20140418-M-Monte_Carlo_Masters-QF-David_Ferrer-Rafael_Nadal,1,F-IO,24,13,7,2,4,14,10
20140418-M-Monte_Carlo_Masters-QF-David_Ferrer-Rafael_Nadal,1,F-II,13,3,3,0,0,10,3
20140418-M-Monte_Carlo_Masters-QF-David_Ferrer-Rafael_Nadal,1,B-XC,32,7,2,3,2,15,17
20140418-M-Monte_Carlo_Masters-QF-David_Ferrer-Rafael_Nadal,1,B-DTM,32,2,0,0,2,12,20
20140418-M-Monte_Carlo_Masters-QF-David_Ferrer-Rafael_Nadal,1,B-DTL,52,7,0,1,6,23,29
20140418-M-Monte_Carlo_Masters-QF-David_Ferrer-Rafael_Nadal,1,B-IO,10,0,0,0,0,7,3
20140418-M-Monte_Carlo_Masters-QF-David_Ferrer-Rafael_Nadal,1,S-DTM,1,0,0,0,0,0,1
20140418-M-Monte_Carlo_Masters-QF-David_Ferrer-Rafael_Nadal,1,S-DTL,1,0,0,0,0,0,1
20140418-M-Monte_Carlo_Masters-QF-David_Ferrer-Rafael_Nadal,2,F-XC,46,5,0,3,2,24,22
20140418-M-Monte_Carlo_Masters-QF-David_Ferrer-Rafael_Nadal,2,F-DTM,18,3,0,0,3,8,10
20140418-M-Monte_Carlo_Masters-QF-David_Ferrer-Rafael_Nadal,2,F-DTL,14,7,2,2,3,8,6
20140418-M-Monte_Carlo_Masters-QF-David_Ferrer-Rafael_Nadal,2,F-IO,40,10,5,2,3,26,14
20140418-M-Monte_Carlo_Masters-QF-David_Ferrer-Rafael_Nadal,2,F-II,27,9,4,2,3,17,10
20140418-M-Monte_Carlo_Masters-QF-David_Ferrer-Rafael_Nadal,2,B-XC,68,13,2,4,7,30,38
20140418-M-Monte_Carlo_Masters-QF-David_Ferrer-Rafael_Nadal,2,B-DTM,43,4,0,0,4,21,22
20140418-M-Monte_Carlo_Masters-QF-David_Ferrer-Rafael_Nadal,2,B-DTL,67,16,2,3,11,34,33
20140418-M-Monte_Carlo_Masters-QF-David_Ferrer-Rafael_Nadal,2,B-IO,9,1,0,0,1,6,3
20140418-M-Monte_Carlo_Masters-QF-David_Ferrer-Rafael_Nadal,2,B-II,1,0,0,0,0,0,1
20140418-M-Monte_Carlo_Masters-QF-David_Ferrer-Rafael_Nadal,2,S-XC,4,0,0,0,0,1,3
20140418-M-Monte_Carlo_Masters-QF-David_Ferrer-Rafael_Nadal,2,S-DTM,5,0,0,0,0,1,4
20140418-M-Monte_Carlo_Masters-QF-David_Ferrer-Rafael_Nadal,2,S-DTL,2,0,0,0,0,1,1
20140416-M-Monte_Carlo_Masters-R32-Rafael_Nadal-Teymuraz_Gabashvili,1,F-XC,39,7,2,2,3,29,10
20140416-M-Monte_Carlo_Masters-R32-Rafael_Nadal-Teymuraz_Gabashvili,1,F-DTM,17,0,0,0,0,11,6
20140416-M-Monte_Carlo_Masters-R32-Rafael_Nadal-Teymuraz_Gabashvili,1,F-DTL,7,4,2,1,1,5,2
20140416-M-Monte_Carlo_Masters-R32-Rafael_Nadal-Teymuraz_Gabashvili,1,F-IO,18,10,7,2,1,13,5
20140416-M-Monte_Carlo_Masters-R32-Rafael_Nadal-Teymuraz_Gabashvili,1,F-II,4,0,0,0,0,3,1
20140416-M-Monte_Carlo_Masters-R32-Rafael_Nadal-Teymuraz_Gabashvili,1,B-XC,27,6,3,1,2,15,12
20140416-M-Monte_Carlo_Masters-R32-Rafael_Nadal-Teymuraz_Gabashvili,1,B-DTM,28,4,0,2,2,14,14
20140416-M-Monte_Carlo_Masters-R32-Rafael_Nadal-Teymuraz_Gabashvili,1,B-DTL,6,2,2,0,0,3,3
20140416-M-Monte_Carlo_Masters-R32-Rafael_Nadal-Teymuraz_Gabashvili,1,B-IO,2,0,0,0,0,1,1
20140416-M-Monte_Carlo_Masters-R32-Rafael_Nadal-Teymuraz_Gabashvili,1,B-II,2,1,1,0,0,2,0
20140416-M-Monte_Carlo_Masters-R32-Rafael_Nadal-Teymuraz_Gabashvili,1,S-DTM,4,0,0,0,0,1,3
20140416-M-Monte_Carlo_Masters-R32-Rafael_Nadal-Teymuraz_Gabashvili,1,S-DTL,3,1,0,0,1,1,2
20140416-M-Monte_Carlo_Masters-R32-Rafael_Nadal-Teymuraz_Gabashvili,2,F-XC,45,9,2,2,5,25,20
20140416-M-Monte_Carlo_Masters-R32-Rafael_Nadal-Teymuraz_Gabashvili,2,F-DTM,15,2,0,0,2,2,13
20140416-M-Monte_Carlo_Masters-R32-Rafael_Nadal-Teymuraz_Gabashvili,2,F-DTL,6,2,1,0,1,3,3
20140416-M-Monte_Carlo_Masters-R32-Rafael_Nadal-Teymuraz_Gabashvili,2,F-IO,23,10,5,1,4,10,13
20140416-M-Monte_Carlo_Masters-R32-Rafael_Nadal-Teymuraz_Gabashvili,2,F-II,3,1,1,0,0,2,1
20140416-M-Monte_Carlo_Masters-R32-Rafael_Nadal-Teymuraz_Gabashvili,2,B-XC,21,3,0,1,2,7,14
20140416-M-Monte_Carlo_Masters-R32-Rafael_Nadal-Teymuraz_Gabashvili,2,B-DTM,22,0,0,0,0,6,16
20140416-M-Monte_Carlo_Masters-R32-Rafael_Nadal-Teymuraz_Gabashvili,2,B-DTL,10,2,0,0,2,4,6
20140416-M-Monte_Carlo_Masters-R32-Rafael_Nadal-Teymuraz_Gabashvili,2,B-IO,8,0,0,0,0,2,6
20140416-M-Monte_Carlo_Masters-R32-Rafael_Nadal-Teymuraz_Gabashvili,2,S-XC,1,0,0,0,0,0,1
20140416-M-Monte_Carlo_Masters-R32-Rafael_Nadal-Teymuraz_Gabashvili,2,S-DTM,2,0,0,0,0,0,2
20140210-M-Memphis-R32-Nick_Kyrgios-Tim_Smyczek,1,F-XC,75,20,5,4,11,32,43
20140210-M-Memphis-R32-Nick_Kyrgios-Tim_Smyczek,1,F-DTM,45,7,0,0,7,22,23
20140210-M-Memphis-R32-Nick_Kyrgios-Tim_Smyczek,1,F-DTL,20,7,3,1,3,9,11
20140210-M-Memphis-R32-Nick_Kyrgios-Tim_Smyczek,1,F-IO,44,15,4,2,9,17,27
20140210-M-Memphis-R32-Nick_Kyrgios-Tim_Smyczek,1,F-II,6,5,0,1,4,2,4
20140210-M-Memphis-R32-Nick_Kyrgios-Tim_Smyczek,1,B-XC,47,10,0,1,9,18,29
20140210-M-Memphis-R32-Nick_Kyrgios-Tim_Smyczek,1,B-DTM,39,6,0,1,5,20,19
20140210-M-Memphis-R32-Nick_Kyrgios-Tim_Smyczek,1,B-DTL,9,4,1,1,2,4,5
20140210-M-Memphis-R32-Nick_Kyrgios-Tim_Smyczek,1,B-IO,13,1,0,0,1,4,9
20140210-M-Memphis-R32-Nick_Kyrgios-Tim_Smyczek,1,B-II,1,0,0,0,0,1,0
20140210-M-Memphis-R32-Nick_Kyrgios-Tim_Smyczek,1,S-XC,1,1,1,0,0,1,0
20140210-M-Memphis-R32-Nick_Kyrgios-Tim_Smyczek,1,S-DTM,1,0,0,0,0,0,1
20140210-M-Memphis-R32-Nick_Kyrgios-Tim_Smyczek,1,S-II,1,0,0,0,0,0,1
20140210-M-Memphis-R32-Nick_Kyrgios-Tim_Smyczek,2,F-XC,64,19,7,0,12,37,27
20140210-M-Memphis-R32-Nick_Kyrgios-Tim_Smyczek,2,F-DTM,60,11,0,0,11,25,35
20140210-M-Memphis-R32-Nick_Kyrgios-Tim_Smyczek,2,F-DTL,10,4,2,0,2,6,4
20140210-M-Memphis-R32-Nick_Kyrgios-Tim_Smyczek,2,F-IO,29,8,4,1,3,13,16
20140210-M-Memphis-R32-Nick_Kyrgios-Tim_Smyczek,2,F-II,3,0,0,0,0,3,0
20140210-M-Memphis-R32-Nick_Kyrgios-Tim_Smyczek,2,B-XC,40,2,0,1,1,25,15
20140210-M-Memphis-R32-Nick_Kyrgios-Tim_Smyczek,2,B-DTM,39,5,0,1,4,21,18
20140210-M-Memphis-R32-Nick_Kyrgios-Tim_Smyczek,2,B-DTL,11,6,2,0,4,5,6
20140210-M-Memphis-R32-Nick_Kyrgios-Tim_Smyczek,2,B-IO,6,2,0,0,2,3,3
20140210-M-Memphis-R32-Nick_Kyrgios-Tim_Smyczek,2,S-XC,6,0,0,0,0,6,0
20140210-M-Memphis-R32-Nick_Kyrgios-Tim_Smyczek,2,S-DTM,15,2,0,0,2,8,7
20140210-M-Memphis-R32-Nick_Kyrgios-Tim_Smyczek,2,S-DTL,4,1,0,0,1,0,4
20140210-M-Memphis-R32-Nick_Kyrgios-Tim_Smyczek,2,S-IO,3,0,0,0,0,2,1
20130325-M-Miami_Masters-R32-Grigor_Dimitrov-Andy_Murray,1,F-XC,46,14,5,3,6,26,20
20130325-M-Miami_Masters-R32-Grigor_Dimitrov-Andy_Murray,1,F-DTM,37,2,0,0,2,17,20
20130325-M-Miami_Masters-R32-Grigor_Dimitrov-Andy_Murray,1,F-DTL,6,2,1,1,0,5,1
20130325-M-Miami_Masters-R32-Grigor_Dimitrov-Andy_Murray,1,F-IO,42,14,7,1,6,20,22
20130325-M-Miami_Masters-R32-Grigor_Dimitrov-Andy_Murray,1,F-II,9,3,0,2,1,6,3
20130325-M-Miami_Masters-R32-Grigor_Dimitrov-Andy_Murray,1,B-XC,33,4,2,0,2,16,17
20130325-M-Miami_Masters-R32-Grigor_Dimitrov-Andy_Murray,1,B-DTM,41,7,0,0,7,17,24
20130325-M-Miami_Masters-R32-Grigor_Dimitrov-Andy_Murray,1,B-DTL,7,4,0,1,3,2,5
20130325-M-Miami_Masters-R32-Grigor_Dimitrov-Andy_Murray,1,S-XC,16,2,0,0,2,8,8
20130325-M-Miami_Masters-R32-Grigor_Dimitrov-Andy_Murray,1,S-DTM,13,3,1,0,2,4,9
20130325-M-Miami_Masters-R32-Grigor_Dimitrov-Andy_Murray,1,S-DTL,3,0,0,0,0,2,1
20130325-M-Miami_Masters-R32-Grigor_Dimitrov-Andy_Murray,1,S-IO,2,1,0,0,1,0,2
20130325-M-Miami_Masters-R32-Grigor_Dimitrov-Andy_Murray,2,F-XC,37,14,4,2,8,19,18
20130325-M-Miami_Masters-R32-Grigor_Dimitrov-Andy_Murray,2,F-DTM,50,1,0,0,1,22,28
20130325-M-Miami_Masters-R32-Grigor_Dimitrov-Andy_Murray,2,F-DTL,9,1,0,0,1,7,2
20130325-M-Miami_Masters-R32-Grigor_Dimitrov-Andy_Murray,2,F-IO,38,8,1,3,4,20,18
20130325-M-Miami_Masters-R32-Grigor_Dimitrov-Andy_Murray,2,B-XC,44,3,0,1,2,21,23
20130325-M-Miami_Masters-R32-Grigor_Dimitrov-Andy_Murray,2,B-DTM,30,1,0,0,1,19,11
20130325-M-Miami_Masters-R32-Grigor_Dimitrov-Andy_Murray,2,B-DTL,3,0,0,0,0,1,2
20130325-M-Miami_Masters-R32-Grigor_Dimitrov-Andy_Murray,2,B-IO,4,2,1,0,1,2,2
20130325-M-Miami_Masters-R32-Grigor_Dimitrov-Andy_Murray,2,S-XC,12,1,0,0,1,6,6
20130325-M-Miami_Masters-R32-Grigor_Dimitrov-Andy_Murray,2,S-DTM,8,0,0,0,0,3,5
20130325-M-Miami_Masters-R32-Grigor_Dimitrov-Andy_Murray,2,S-DTL,1,1,0,1,0,1,0
20130325-M-Miami_Masters-R32-Grigor_Dimitrov-Andy_Murray,2,S-IO,1,0,0,0,0,0,1
20140324-M-Miami_Masters-R32-Dusan_Lajovic-Alexandr_Dolgopolov,1,F-XC,62,15,7,3,5,34,28
20140324-M-Miami_Masters-R32-Dusan_Lajovic-Alexandr_Dolgopolov,1,F-DTM,18,2,0,0,2,5,13
20140324-M-Miami_Masters-R32-Dusan_Lajovic-Alexandr_Dolgopolov,1,F-DTL,5,3,2,0,1,2,3
20140324-M-Miami_Masters-R32-Dusan_Lajovic-Alexandr_Dolgopolov,1,F-IO,32,4,1,1,2,19,13
20140324-M-Miami_Masters-R32-Dusan_Lajovic-Alexandr_Dolgopolov,1,F-II,3,1,0,1,0,3,0
20140324-M-Miami_Masters-R32-Dusan_Lajovic-Alexandr_Dolgopolov,1,B-XC,41,9,0,2,7,17,24
20140324-M-Miami_Masters-R32-Dusan_Lajovic-Alexandr_Dolgopolov,1,B-DTM,34,5,1,1,3,13,21
20140324-M-Miami_Masters-R32-Dusan_Lajovic-Alexandr_Dolgopolov,1,B-DTL,12,6,3,0,3,5,7
20140324-M-Miami_Masters-R32-Dusan_Lajovic-Alexandr_Dolgopolov,1,B-IO,9,3,1,0,2,2,7
20140324-M-Miami_Masters-R32-Dusan_Lajovic-Alexandr_Dolgopolov,1,S-XC,23,3,0,0,3,9,14
20140324-M-Miami_Masters-R32-Dusan_Lajovic-Alexandr_Dolgopolov,1,S-DTM,15,5,0,0,5,2,13
20140324-M-Miami_Masters-R32-Dusan_Lajovic-Alexandr_Dolgopolov,1,S-DTL,2,1,0,0,1,0,2
20140324-M-Miami_Masters-R32-Dusan_Lajovic-Alexandr_Dolgopolov,1,S-IO,1,0,0,0,0,0,1
20140324-M-Miami_Masters-R32-Dusan_Lajovic-Alexandr_Dolgopolov,2,F-XC,35,9,2,2,5,20,15
20140324-M-Miami_Masters-R32-Dusan_Lajovic-Alexandr_Dolgopolov,2,F-DTM,41,1,0,0,1,24,17
20140324-M-Miami_Masters-R32-Dusan_Lajovic-Alexandr_Dolgopolov,2,F-DTL,24,9,2,1,6,13,11
20140324-M-Miami_Masters-R32-Dusan_Lajovic-Alexandr_Dolgopolov,2,F-IO,40,13,4,3,6,26,14
20140324-M-Miami_Masters-R32-Dusan_Lajovic-Alexandr_Dolgopolov,2,F-II,2,0,0,0,0,2,0
20140324-M-Miami_Masters-R32-Dusan_Lajovic-Alexandr_Dolgopolov,2,B-XC,46,7,0,0,7,21,25
20140324-M-Miami_Masters-R32-Dusan_Lajovic-Alexandr_Dolgopolov,2,B-DTM,35,4,0,0,4,16,19
20140324-M-Miami_Masters-R32-Dusan_Lajovic-Alexandr_Dolgopolov,2,B-DTL,6,4,1,1,2,4,2
20140324-M-Miami_Masters-R32-Dusan_Lajovic-Alexandr_Dolgopolov,2,S-XC,1,0,0,0,0,1,0
20140324-M-Miami_Masters-R32-Dusan_Lajovic-Alexandr_Dolgopolov,2,S-DTM,4,0,0,0,0,2,2
20140324-M-Miami_Masters-R32-Dusan_Lajovic-Alexandr_Dolgopolov,2,S-DTL,2,0,0,0,0,1,1
20140324-M-Miami_Masters-R32-Dusan_Lajovic-Alexandr_Dolgopolov,2,S-IO,1,0,0,0,0,1,0
20140322-M-Miami_Masters-R64-Donald_Young-John_Isner,1,F-XC,34,7,2,2,3,22,12
20140322-M-Miami_Masters-R64-Donald_Young-John_Isner,1,F-DTM,20,2,0,0,2,10,10
20140322-M-Miami_Masters-R64-Donald_Young-John_Isner,1,F-DTL,8,2,2,0,0,5,3
20140322-M-Miami_Masters-R64-Donald_Young-John_Isner,1,F-IO,25,8,7,0,1,19,6
20140322-M-Miami_Masters-R64-Donald_Young-John_Isner,1,F-II,5,3,2,0,1,4,1
20140322-M-Miami_Masters-R64-Donald_Young-John_Isner,1,B-XC,11,3,2,0,1,4,7
20140322-M-Miami_Masters-R64-Donald_Young-John_Isner,1,B-DTM,29,3,0,1,2,10,19
20140322-M-Miami_Masters-R64-Donald_Young-John_Isner,1,B-DTL,7,3,0,0,3,2,5
20140322-M-Miami_Masters-R64-Donald_Young-John_Isner,1,B-IO,2,0,0,0,0,0,2
20140322-M-Miami_Masters-R64-Donald_Young-John_Isner,1,S-DTM,5,2,0,0,2,1,4
20140322-M-Miami_Masters-R64-Donald_Young-John_Isner,1,S-DTL,1,0,0,0,0,1,0
20140322-M-Miami_Masters-R64-Donald_Young-John_Isner,2,F-XC,34,8,4,0,4,15,19
20140322-M-Miami_Masters-R64-Donald_Young-John_Isner,2,F-DTM,21,3,0,0,3,13,8
20140322-M-Miami_Masters-R64-Donald_Young-John_Isner,2,F-DTL,7,5,0,2,3,3,4
20140322-M-Miami_Masters-R64-Donald_Young-John_Isner,2,F-IO,32,24,8,5,11,16,16
20140322-M-Miami_Masters-R64-Donald_Young-John_Isner,2,F-II,1,0,0,0,0,0,1
20140322-M-Miami_Masters-R64-Donald_Young-John_Isner,2,B-XC,4,1,0,0,1,2,2
20140322-M-Miami_Masters-R64-Donald_Young-John_Isner,2,B-DTM,23,2,0,0,2,7,16
20140322-M-Miami_Masters-R64-Donald_Young-John_Isner,2,B-DTL,5,2,1,1,0,3,2
20140322-M-Miami_Masters-R64-Donald_Young-John_Isner,2,B-IO,4,2,1,0,1,3,1
20140322-M-Miami_Masters-R64-Donald_Young-John_Isner,2,S-XC,1,1,0,0,1,0,1
20140322-M-Miami_Masters-R64-Donald_Young-John_Isner,2,S-DTM,8,2,0,0,2,4,4
20140322-M-Miami_Masters-R64-Donald_Young-John_Isner,2,S-DTL,5,2,0,1,1,1,4
20140322-M-Miami_Masters-R64-Donald_Young-John_Isner,2,S-IO,2,0,0,0,0,2,0
20140319-M-Miami_Masters-R128-Lukasz_Kubot-Matthew_Ebden,1,F-XC,47,18,7,3,8,26,21
20140319-M-Miami_Masters-R128-Lukasz_Kubot-Matthew_Ebden,1,F-DTM,18,4,0,0,4,7,11
20140319-M-Miami_Masters-R128-Lukasz_Kubot-Matthew_Ebden,1,F-DTL,1,0,0,0,0,1,0
20140319-M-Miami_Masters-R128-Lukasz_Kubot-Matthew_Ebden,1,F-IO,20,2,0,1,1,13,7
20140319-M-Miami_Masters-R128-Lukasz_Kubot-Matthew_Ebden,1,B-XC,24,7,0,2,5,12,12
20140319-M-Miami_Masters-R128-Lukasz_Kubot-Matthew_Ebden,1,B-DTM,14,1,0,0,1,4,10
20140319-M-Miami_Masters-R128-Lukasz_Kubot-Matthew_Ebden,1,B-DTL,1,1,0,0,1,0,1
20140319-M-Miami_Masters-R128-Lukasz_Kubot-Matthew_Ebden,1,B-IO,1,0,0,0,0,0,1
20140319-M-Miami_Masters-R128-Lukasz_Kubot-Matthew_Ebden,1,S-XC,15,1,0,0,1,5,10
20140319-M-Miami_Masters-R128-Lukasz_Kubot-Matthew_Ebden,1,S-DTM,6,1,1,0,0,1,5
20140319-M-Miami_Masters-R128-Lukasz_Kubot-Matthew_Ebden,1,S-DTL,1,0,0,0,0,1,0
20140319-M-Miami_Masters-R128-Lukasz_Kubot-Matthew_Ebden,2,F-XC,36,9,3,2,4,17,19
20140319-M-Miami_Masters-R128-Lukasz_Kubot-Matthew_Ebden,2,F-DTM,29,3,0,1,2,20,9
20140319-M-Miami_Masters-R128-Lukasz_Kubot-Matthew_Ebden,2,F-DTL,12,9,3,0,6,5,7
20140319-M-Miami_Masters-R128-Lukasz_Kubot-Matthew_Ebden,2,F-IO,28,6,3,1,2,18,10
20140319-M-Miami_Masters-R128-Lukasz_Kubot-Matthew_Ebden,2,F-II,2,1,1,0,0,2,0
20140319-M-Miami_Masters-R128-Lukasz_Kubot-Matthew_Ebden,2,B-XC,8,3,1,0,2,2,6
20140319-M-Miami_Masters-R128-Lukasz_Kubot-Matthew_Ebden,2,B-DTM,11,2,0,0,2,4,7
20140319-M-Miami_Masters-R128-Lukasz_Kubot-Matthew_Ebden,2,B-DTL,2,2,1,0,1,1,1
20140319-M-Miami_Masters-R128-Lukasz_Kubot-Matthew_Ebden,2,S-XC,9,2,0,1,1,5,4
20140319-M-Miami_Masters-R128-Lukasz_Kubot-Matthew_Ebden,2,S-DTM,10,3,1,0,2,5,5
20140319-M-Miami_Masters-R128-Lukasz_Kubot-Matthew_Ebden,2,S-DTL,6,3,1,0,2,2,4
20140319-M-Miami_Masters-R128-Lukasz_Kubot-Matthew_Ebden,2,S-IO,2,0,0,0,0,2,0
20140326-M-Miami_Masters-QF-Roger_Federer-Kei_Nishikori,1,F-XC,46,18,4,5,9,25,21
20140326-M-Miami_Masters-QF-Roger_Federer-Kei_Nishikori,1,F-DTM,28,3,0,0,3,12,16
20140326-M-Miami_Masters-QF-Roger_Federer-Kei_Nishikori,1,F-DTL,11,4,0,3,1,6,5
20140326-M-Miami_Masters-QF-Roger_Federer-Kei_Nishikori,1,F-IO,35,12,6,0,6,16,19
20140326-M-Miami_Masters-QF-Roger_Federer-Kei_Nishikori,1,F-II,6,1,1,0,0,4,2
20140326-M-Miami_Masters-QF-Roger_Federer-Kei_Nishikori,1,B-XC,44,7,1,1,5,18,26
20140326-M-Miami_Masters-QF-Roger_Federer-Kei_Nishikori,1,B-DTM,56,13,0,0,13,20,36
20140326-M-Miami_Masters-QF-Roger_Federer-Kei_Nishikori,1,B-DTL,9,5,2,1,2,5,4
20140326-M-Miami_Masters-QF-Roger_Federer-Kei_Nishikori,1,B-IO,2,1,1,0,0,2,0
20140326-M-Miami_Masters-QF-Roger_Federer-Kei_Nishikori,1,S-XC,15,1,0,0,1,8,7
20140326-M-Miami_Masters-QF-Roger_Federer-Kei_Nishikori,1,S-DTM,7,1,0,0,1,3,4
20140326-M-Miami_Masters-QF-Roger_Federer-Kei_Nishikori,1,S-DTL,1,0,0,0,0,0,1
20140326-M-Miami_Masters-QF-Roger_Federer-Kei_Nishikori,2,F-XC,45,12,2,4,6,24,21
20140326-M-Miami_Masters-QF-Roger_Federer-Kei_Nishikori,2,F-DTM,35,3,0,0,3,16,19
20140326-M-Miami_Masters-QF-Roger_Federer-Kei_Nishikori,2,F-DTL,8,2,2,0,0,4,4
20140326-M-Miami_Masters-QF-Roger_Federer-Kei_Nishikori,2,F-IO,45,12,5,2,5,26,19
20140326-M-Miami_Masters-QF-Roger_Federer-Kei_Nishikori,2,F-II,4,3,1,0,2,1,3
20140326-M-Miami_Masters-QF-Roger_Federer-Kei_Nishikori,2,B-XC,80,16,3,2,11,43,37
20140326-M-Miami_Masters-QF-Roger_Federer-Kei_Nishikori,2,B-DTM,23,1,0,0,1,12,11
20140326-M-Miami_Masters-QF-Roger_Federer-Kei_Nishikori,2,B-DTL,6,2,1,0,1,4,2
20140326-M-Miami_Masters-QF-Roger_Federer-Kei_Nishikori,2,B-IO,6,4,1,0,3,1,5
20140326-M-Miami_Masters-QF-Roger_Federer-Kei_Nishikori,2,S-XC,12,0,0,0,0,5,7
20140326-M-Miami_Masters-QF-Roger_Federer-Kei_Nishikori,2,S-DTM,4,0,0,0,0,2,2
20140326-M-Miami_Masters-QF-Roger_Federer-Kei_Nishikori,2,S-DTL,2,0,0,0,0,1,1
20140323-M-Miami_Masters-R32-Roger_Federer-Thiemo_De_Bakker,1,F-XC,13,6,3,1,2,9,4
20140323-M-Miami_Masters-R32-Roger_Federer-Thiemo_De_Bakker,1,F-DTM,15,3,0,3,0,12,3
20140323-M-Miami_Masters-R32-Roger_Federer-Thiemo_De_Bakker,1,F-DTL,2,2,2,0,0,2,0
20140323-M-Miami_Masters-R32-Roger_Federer-Thiemo_De_Bakker,1,F-IO,11,5,3,2,0,11,0
20140323-M-Miami_Masters-R32-Roger_Federer-Thiemo_De_Bakker,1,F-II,1,1,0,0,1,0,1
20140323-M-Miami_Masters-R32-Roger_Federer-Thiemo_De_Bakker,1,B-XC,8,2,1,0,1,5,3
20140323-M-Miami_Masters-R32-Roger_Federer-Thiemo_De_Bakker,1,B-DTM,3,1,0,0,1,0,3
20140323-M-Miami_Masters-R32-Roger_Federer-Thiemo_De_Bakker,1,B-DTL,1,1,1,0,0,1,0
20140323-M-Miami_Masters-R32-Roger_Federer-Thiemo_De_Bakker,1,B-IO,1,1,0,0,1,0,1
20140323-M-Miami_Masters-R32-Roger_Federer-Thiemo_De_Bakker,1,S-XC,3,0,0,0,0,2,1
20140323-M-Miami_Masters-R32-Roger_Federer-Thiemo_De_Bakker,1,S-DTM,2,0,0,0,0,1,1
20140323-M-Miami_Masters-R32-Roger_Federer-Thiemo_De_Bakker,1,S-DTL,2,1,0,1,0,1,1
20140323-M-Miami_Masters-R32-Roger_Federer-Thiemo_De_Bakker,2,F-XC,8,3,0,0,3,1,7
20140323-M-Miami_Masters-R32-Roger_Federer-Thiemo_De_Bakker,2,F-DTM,11,3,1,0,2,2,9
20140323-M-Miami_Masters-R32-Roger_Federer-Thiemo_De_Bakker,2,F-DTL,3,2,0,1,1,1,2
20140323-M-Miami_Masters-R32-Roger_Federer-Thiemo_De_Bakker,2,F-IO,13,1,0,0,1,6,7
20140323-M-Miami_Masters-R32-Roger_Federer-Thiemo_De_Bakker,2,F-II,2,1,1,0,0,2,0
20140323-M-Miami_Masters-R32-Roger_Federer-Thiemo_De_Bakker,2,B-XC,5,1,0,0,1,2,3
20140323-M-Miami_Masters-R32-Roger_Federer-Thiemo_De_Bakker,2,B-DTM,18,4,0,1,3,4,14
20140323-M-Miami_Masters-R32-Roger_Federer-Thiemo_De_Bakker,2,S-XC,1,1,1,0,0,1,0
20140323-M-Miami_Masters-R32-Roger_Federer-Thiemo_De_Bakker,2,S-DTM,2,2,0,0,2,0,2
20140323-M-Miami_Masters-R32-Roger_Federer-Thiemo_De_Bakker,2,S-IO,2,0,0,0,0,0,2
20130327-M-Miami_Masters-R16-Novak_Djokovic-Tommy_Haas,1,F-XC,83,12,2,2,8,40,43
20130327-M-Miami_Masters-R16-Novak_Djokovic-Tommy_Haas,1,F-DTM,40,5,0,0,5,20,20
20130327-M-Miami_Masters-R16-Novak_Djokovic-Tommy_Haas,1,F-DTL,19,7,1,2,4,7,12
20130327-M-Miami_Masters-R16-Novak_Djokovic-Tommy_Haas,1,F-IO,28,4,0,1,3,11,17
20130327-M-Miami_Masters-R16-Novak_Djokovic-Tommy_Haas,1,F-II,3,1,0,1,0,1,2
20130327-M-Miami_Masters-R16-Novak_Djokovic-Tommy_Haas,1,B-XC,26,2,0,0,2,9,17
20130327-M-Miami_Masters-R16-Novak_Djokovic-Tommy_Haas,1,B-DTM,27,2,0,0,2,9,18
20130327-M-Miami_Masters-R16-Novak_Djokovic-Tommy_Haas,1,B-DTL,4,0,0,0,0,2,2
20130327-M-Miami_Masters-R16-Novak_Djokovic-Tommy_Haas,1,B-IO,9,2,0,0,2,5,4
20130327-M-Miami_Masters-R16-Novak_Djokovic-Tommy_Haas,1,S-XC,3,1,0,0,1,1,2
20130327-M-Miami_Masters-R16-Novak_Djokovic-Tommy_Haas,1,S-DTM,11,0,0,0,0,7,4
20130327-M-Miami_Masters-R16-Novak_Djokovic-Tommy_Haas,1,S-DTL,1,1,0,0,1,0,1
20130327-M-Miami_Masters-R16-Novak_Djokovic-Tommy_Haas,1,S-IO,1,0,0,0,0,0,1
20130327-M-Miami_Masters-R16-Novak_Djokovic-Tommy_Haas,2,F-XC,75,4,1,0,3,43,32
20130327-M-Miami_Masters-R16-Novak_Djokovic-Tommy_Haas,2,F-DTM,36,4,0,0,4,18,18
20130327-M-Miami_Masters-R16-Novak_Djokovic-Tommy_Haas,2,F-DTL,15,6,3,1,2,8,7
20130327-M-Miami_Masters-R16-Novak_Djokovic-Tommy_Haas,2,F-IO,9,3,2,1,0,8,1
20130327-M-Miami_Masters-R16-Novak_Djokovic-Tommy_Haas,2,F-II,1,0,0,0,0,0,1
20130327-M-Miami_Masters-R16-Novak_Djokovic-Tommy_Haas,2,B-XC,20,4,0,2,2,11,9
20130327-M-Miami_Masters-R16-Novak_Djokovic-Tommy_Haas,2,B-DTM,24,1,0,0,1,12,12
20130327-M-Miami_Masters-R16-Novak_Djokovic-Tommy_Haas,2,B-DTL,6,2,0,0,2,2,4
20130327-M-Miami_Masters-R16-Novak_Djokovic-Tommy_Haas,2,B-IO,4,2,1,1,0,3,1
20130327-M-Miami_Masters-R16-Novak_Djokovic-Tommy_Haas,2,B-II,1,0,0,0,0,0,1
20130327-M-Miami_Masters-R16-Novak_Djokovic-Tommy_Haas,2,S-XC,18,3,0,0,3,12,6
20130327-M-Miami_Masters-R16-Novak_Djokovic-Tommy_Haas,2,S-DTM,24,1,0,0,1,12,12
20130327-M-Miami_Masters-R16-Novak_Djokovic-Tommy_Haas,2,S-DTL,1,1,0,1,0,1,0
20130327-M-Miami_Masters-R16-Novak_Djokovic-Tommy_Haas,2,S-IO,7,1,0,1,0,2,5
20140325-M-Miami_Masters-R16-Jo_Wilfried_Tsonga-Andy_Murray,1,F-XC,28,10,2,3,5,14,14
20140325-M-Miami_Masters-R16-Jo_Wilfried_Tsonga-Andy_Murray,1,F-DTM,12,1,0,0,1,4,8
20140325-M-Miami_Masters-R16-Jo_Wilfried_Tsonga-Andy_Murray,1,F-DTL,6,2,0,1,1,2,4
20140325-M-Miami_Masters-R16-Jo_Wilfried_Tsonga-Andy_Murray,1,F-IO,31,10,3,2,5,16,15
20140325-M-Miami_Masters-R16-Jo_Wilfried_Tsonga-Andy_Murray,1,F-II,2,1,1,0,0,2,0
20140325-M-Miami_Masters-R16-Jo_Wilfried_Tsonga-Andy_Murray,1,B-XC,23,7,2,1,4,9,14
20140325-M-Miami_Masters-R16-Jo_Wilfried_Tsonga-Andy_Murray,1,B-DTM,7,1,0,0,1,2,5
20140325-M-Miami_Masters-R16-Jo_Wilfried_Tsonga-Andy_Murray,1,B-DTL,2,1,1,0,0,1,1
20140325-M-Miami_Masters-R16-Jo_Wilfried_Tsonga-Andy_Murray,1,B-IO,7,2,0,0,2,2,5
20140325-M-Miami_Masters-R16-Jo_Wilfried_Tsonga-Andy_Murray,1,S-XC,14,3,0,0,3,4,10
20140325-M-Miami_Masters-R16-Jo_Wilfried_Tsonga-Andy_Murray,1,S-DTM,4,1,0,0,1,1,3
20140325-M-Miami_Masters-R16-Jo_Wilfried_Tsonga-Andy_Murray,1,S-DTL,1,1,0,0,1,0,1
20140325-M-Miami_Masters-R16-Jo_Wilfried_Tsonga-Andy_Murray,1,S-IO,1,0,0,0,0,0,1
20140325-M-Miami_Masters-R16-Jo_Wilfried_Tsonga-Andy_Murray,2,F-XC,20,2,2,0,0,13,7
20140325-M-Miami_Masters-R16-Jo_Wilfried_Tsonga-Andy_Murray,2,F-DTM,10,1,0,0,1,5,5
20140325-M-Miami_Masters-R16-Jo_Wilfried_Tsonga-Andy_Murray,2,F-DTL,6,1,0,1,0,5,1
20140325-M-Miami_Masters-R16-Jo_Wilfried_Tsonga-Andy_Murray,2,F-IO,16,3,0,3,0,16,0
20140325-M-Miami_Masters-R16-Jo_Wilfried_Tsonga-Andy_Murray,2,F-II,2,1,0,0,1,1,1
20140325-M-Miami_Masters-R16-Jo_Wilfried_Tsonga-Andy_Murray,2,B-XC,21,2,0,1,1,10,11
20140325-M-Miami_Masters-R16-Jo_Wilfried_Tsonga-Andy_Murray,2,B-DTM,13,1,0,0,1,6,7
20140325-M-Miami_Masters-R16-Jo_Wilfried_Tsonga-Andy_Murray,2,B-DTL,5,1,0,1,0,5,0
20140325-M-Miami_Masters-R16-Jo_Wilfried_Tsonga-Andy_Murray,2,B-IO,5,4,2,1,1,4,1
20140325-M-Miami_Masters-R16-Jo_Wilfried_Tsonga-Andy_Murray,2,S-XC,3,1,0,0,1,1,2
20140325-M-Miami_Masters-R16-Jo_Wilfried_Tsonga-Andy_Murray,2,S-DTM,8,0,0,0,0,5,3
20140325-M-Miami_Masters-R16-Jo_Wilfried_Tsonga-Andy_Murray,2,S-DTL,5,0,0,0,0,3,2
20140325-M-Miami_Masters-R16-Jo_Wilfried_Tsonga-Andy_Murray,2,S-IO,1,1,0,1,0,1,0
20140321-M-Miami_Masters-R64-Adrian_Mannarino-Jo_Wilfried_Tsonga,1,F-XC,18,5,0,2,3,7,11
20140321-M-Miami_Masters-R64-Adrian_Mannarino-Jo_Wilfried_Tsonga,1,F-DTM,27,8,0,1,7,8,19
20140321-M-Miami_Masters-R64-Adrian_Mannarino-Jo_Wilfried_Tsonga,1,F-DTL,1,0,0,0,0,0,1
20140321-M-Miami_Masters-R64-Adrian_Mannarino-Jo_Wilfried_Tsonga,1,F-IO,4,3,2,0,1,2,2
20140321-M-Miami_Masters-R64-Adrian_Mannarino-Jo_Wilfried_Tsonga,1,B-XC,22,7,3,0,4,9,13
20140321-M-Miami_Masters-R64-Adrian_Mannarino-Jo_Wilfried_Tsonga,1,B-DTM,15,3,0,0,3,5,10
20140321-M-Miami_Masters-R64-Adrian_Mannarino-Jo_Wilfried_Tsonga,1,B-DTL,2,2,1,0,1,1,1
20140321-M-Miami_Masters-R64-Adrian_Mannarino-Jo_Wilfried_Tsonga,1,B-IO,2,1,0,0,1,0,2
20140321-M-Miami_Masters-R64-Adrian_Mannarino-Jo_Wilfried_Tsonga,1,S-XC,1,0,0,0,0,1,0
20140321-M-Miami_Masters-R64-Adrian_Mannarino-Jo_Wilfried_Tsonga,1,S-DTM,2,1,0,0,1,0,2
20140321-M-Miami_Masters-R64-Adrian_Mannarino-Jo_Wilfried_Tsonga,1,S-DTL,1,0,0,0,0,0,1
20140321-M-Miami_Masters-R64-Adrian_Mannarino-Jo_Wilfried_Tsonga,1,S-IO,1,1,0,0,1,0,1
20140321-M-Miami_Masters-R64-Adrian_Mannarino-Jo_Wilfried_Tsonga,2,F-XC,20,6,1,1,4,12,8
20140321-M-Miami_Masters-R64-Adrian_Mannarino-Jo_Wilfried_Tsonga,2,F-DTM,18,1,0,0,1,12,6
20140321-M-Miami_Masters-R64-Adrian_Mannarino-Jo_Wilfried_Tsonga,2,F-DTL,2,1,1,0,0,1,1
20140321-M-Miami_Masters-R64-Adrian_Mannarino-Jo_Wilfried_Tsonga,2,F-IO,16,3,1,2,0,13,3
20140321-M-Miami_Masters-R64-Adrian_Mannarino-Jo_Wilfried_Tsonga,2,F-II,2,0,0,0,0,2,0
20140321-M-Miami_Masters-R64-Adrian_Mannarino-Jo_Wilfried_Tsonga,2,B-XC,4,0,0,0,0,2,2
20140321-M-Miami_Masters-R64-Adrian_Mannarino-Jo_Wilfried_Tsonga,2,B-DTM,4,0,0,0,0,4,0
20140321-M-Miami_Masters-R64-Adrian_Mannarino-Jo_Wilfried_Tsonga,2,B-IO,1,0,0,0,0,0,1
20140321-M-Miami_Masters-R64-Adrian_Mannarino-Jo_Wilfried_Tsonga,2,S-XC,1,0,0,0,0,1,0
20140321-M-Miami_Masters-R64-Adrian_Mannarino-Jo_Wilfried_Tsonga,2,S-DTM,4,0,0,0,0,3,1
20140321-M-Miami_Masters-R64-Adrian_Mannarino-Jo_Wilfried_Tsonga,2,S-DTL,3,1,0,0,1,1,2
20140321-M-Miami_Masters-R64-Adrian_Mannarino-Jo_Wilfried_Tsonga,2,S-IO,4,0,0,0,0,3,1
20130323-M-Miami_Masters-R64-Bernard_Tomic-Andy_Murray,1,F-XC,19,12,3,2,7,9,10
20130323-M-Miami_Masters-R64-Bernard_Tomic-Andy_Murray,1,F-DTM,9,1,0,0,1,3,6
20130323-M-Miami_Masters-R64-Bernard_Tomic-Andy_Murray,1,F-DTL,11,4,1,1,2,4,7
20130323-M-Miami_Masters-R64-Bernard_Tomic-Andy_Murray,1,F-IO,20,8,2,0,6,7,13
20130323-M-Miami_Masters-R64-Bernard_Tomic-Andy_Murray,1,F-II,1,0,0,0,0,1,0
20130323-M-Miami_Masters-R64-Bernard_Tomic-Andy_Murray,1,B-XC,12,4,0,1,3,6,6
20130323-M-Miami_Masters-R64-Bernard_Tomic-Andy_Murray,1,B-DTM,14,3,0,0,3,8,6
20130323-M-Miami_Masters-R64-Bernard_Tomic-Andy_Murray,1,B-DTL,6,3,1,0,2,2,4
20130323-M-Miami_Masters-R64-Bernard_Tomic-Andy_Murray,1,B-IO,4,3,2,0,1,3,1
20130323-M-Miami_Masters-R64-Bernard_Tomic-Andy_Murray,1,S-XC,10,0,0,0,0,2,8
20130323-M-Miami_Masters-R64-Bernard_Tomic-Andy_Murray,1,S-DTM,12,2,0,0,2,5,7
20130323-M-Miami_Masters-R64-Bernard_Tomic-Andy_Murray,1,S-DTL,2,1,0,0,1,1,1
20130323-M-Miami_Masters-R64-Bernard_Tomic-Andy_Murray,1,S-IO,4,2,0,1,1,2,2
20130323-M-Miami_Masters-R64-Bernard_Tomic-Andy_Murray,2,F-XC,17,3,2,0,1,11,6
20130323-M-Miami_Masters-R64-Bernard_Tomic-Andy_Murray,2,F-DTM,15,0,0,0,0,8,7
20130323-M-Miami_Masters-R64-Bernard_Tomic-Andy_Murray,2,F-DTL,4,1,0,0,1,1,3
20130323-M-Miami_Masters-R64-Bernard_Tomic-Andy_Murray,2,F-IO,7,0,0,0,0,4,3
20130323-M-Miami_Masters-R64-Bernard_Tomic-Andy_Murray,2,B-XC,16,4,2,0,2,10,6
20130323-M-Miami_Masters-R64-Bernard_Tomic-Andy_Murray,2,B-DTM,17,1,0,0,1,10,7
20130323-M-Miami_Masters-R64-Bernard_Tomic-Andy_Murray,2,B-DTL,4,1,0,0,1,3,1
20130323-M-Miami_Masters-R64-Bernard_Tomic-Andy_Murray,2,B-IO,2,1,0,0,1,1,1
20130323-M-Miami_Masters-R64-Bernard_Tomic-Andy_Murray,2,S-XC,9,0,0,0,0,6,3
20130323-M-Miami_Masters-R64-Bernard_Tomic-Andy_Murray,2,S-DTM,11,0,0,0,0,5,6
20130323-M-Miami_Masters-R64-Bernard_Tomic-Andy_Murray,2,S-DTL,1,1,0,0,1,0,1
20130323-M-Miami_Masters-R64-Bernard_Tomic-Andy_Murray,2,S-IO,2,0,0,0,0,1,1
20130323-M-Miami_Masters-R64-Bernard_Tomic-Andy_Murray,2,S-II,1,0,0,0,0,0,1
20140322-M-Miami_Masters-R64-Lleyton_Hewitt-Rafael_Nadal,1,F-XC,47,11,3,2,6,13,34
20140322-M-Miami_Masters-R64-Lleyton_Hewitt-Rafael_Nadal,1,F-DTM,28,2,0,1,1,10,18
20140322-M-Miami_Masters-R64-Lleyton_Hewitt-Rafael_Nadal,1,F-DTL,1,0,0,0,0,1,0
20140322-M-Miami_Masters-R64-Lleyton_Hewitt-Rafael_Nadal,1,F-IO,17,5,2,0,3,7,10
20140322-M-Miami_Masters-R64-Lleyton_Hewitt-Rafael_Nadal,1,F-II,7,1,0,1,0,3,4
20140322-M-Miami_Masters-R64-Lleyton_Hewitt-Rafael_Nadal,1,B-XC,22,8,1,1,6,4,18
20140322-M-Miami_Masters-R64-Lleyton_Hewitt-Rafael_Nadal,1,B-DTM,26,1,0,0,1,4,22
20140322-M-Miami_Masters-R64-Lleyton_Hewitt-Rafael_Nadal,1,B-DTL,15,5,0,0,5,1,14
20140322-M-Miami_Masters-R64-Lleyton_Hewitt-Rafael_Nadal,1,S-DTM,4,0,0,0,0,0,4
20140322-M-Miami_Masters-R64-Lleyton_Hewitt-Rafael_Nadal,1,S-DTL,3,0,0,0,0,0,3
20140322-M-Miami_Masters-R64-Lleyton_Hewitt-Rafael_Nadal,2,F-XC,22,8,6,1,1,17,5
20140322-M-Miami_Masters-R64-Lleyton_Hewitt-Rafael_Nadal,2,F-DTM,18,1,0,0,1,13,5
20140322-M-Miami_Masters-R64-Lleyton_Hewitt-Rafael_Nadal,2,F-DTL,4,1,0,1,0,4,0
20140322-M-Miami_Masters-R64-Lleyton_Hewitt-Rafael_Nadal,2,F-IO,60,5,1,3,1,50,10
20140322-M-Miami_Masters-R64-Lleyton_Hewitt-Rafael_Nadal,2,F-II,7,5,3,1,1,6,1
20140322-M-Miami_Masters-R64-Lleyton_Hewitt-Rafael_Nadal,2,B-XC,1,0,0,0,0,0,1
20140322-M-Miami_Masters-R64-Lleyton_Hewitt-Rafael_Nadal,2,B-DTM,14,2,0,2,0,11,3
20140322-M-Miami_Masters-R64-Lleyton_Hewitt-Rafael_Nadal,2,B-DTL,1,0,0,0,0,1,0
20140322-M-Miami_Masters-R64-Lleyton_Hewitt-Rafael_Nadal,2,B-IO,25,6,1,2,3,17,8
20140322-M-Miami_Masters-R64-Lleyton_Hewitt-Rafael_Nadal,2,B-II,10,2,0,0,2,8,2
20140322-M-Miami_Masters-R64-Lleyton_Hewitt-Rafael_Nadal,2,S-XC,1,0,0,0,0,0,1
20140322-M-Miami_Masters-R64-Lleyton_Hewitt-Rafael_Nadal,2,S-DTM,3,0,0,0,0,2,1
20140322-M-Miami_Masters-R64-Lleyton_Hewitt-Rafael_Nadal,2,S-II,4,0,0,0,0,4,0
20140320-M-Miami_Masters-R128-Pablo_Carreno_Busta-Joao_Sousa,1,F-XC,64,21,4,7,10,33,31
20140320-M-Miami_Masters-R128-Pablo_Carreno_Busta-Joao_Sousa,1,F-DTM,36,5,0,0,5,11,25
20140320-M-Miami_Masters-R128-Pablo_Carreno_Busta-Joao_Sousa,1,F-DTL,15,4,2,1,1,8,7
20140320-M-Miami_Masters-R128-Pablo_Carreno_Busta-Joao_Sousa,1,F-IO,38,9,2,0,7,15,23
20140320-M-Miami_Masters-R128-Pablo_Carreno_Busta-Joao_Sousa,1,F-II,5,2,2,0,0,3,2
20140320-M-Miami_Masters-R128-Pablo_Carreno_Busta-Joao_Sousa,1,B-XC,66,4,1,1,2,32,34
20140320-M-Miami_Masters-R128-Pablo_Carreno_Busta-Joao_Sousa,1,B-DTM,27,1,0,0,1,13,14
20140320-M-Miami_Masters-R128-Pablo_Carreno_Busta-Joao_Sousa,1,B-DTL,15,8,1,1,6,3,12
20140320-M-Miami_Masters-R128-Pablo_Carreno_Busta-Joao_Sousa,1,B-IO,9,4,2,1,1,4,5
20140320-M-Miami_Masters-R128-Pablo_Carreno_Busta-Joao_Sousa,1,S-XC,2,0,0,0,0,1,1
20140320-M-Miami_Masters-R128-Pablo_Carreno_Busta-Joao_Sousa,1,S-DTM,5,1,0,0,1,1,4
20140320-M-Miami_Masters-R128-Pablo_Carreno_Busta-Joao_Sousa,2,F-XC,53,13,3,5,5,30,23
20140320-M-Miami_Masters-R128-Pablo_Carreno_Busta-Joao_Sousa,2,F-DTM,49,5,0,0,5,30,19
20140320-M-Miami_Masters-R128-Pablo_Carreno_Busta-Joao_Sousa,2,F-DTL,8,5,2,1,2,4,4
20140320-M-Miami_Masters-R128-Pablo_Carreno_Busta-Joao_Sousa,2,F-IO,61,12,4,4,4,34,27
20140320-M-Miami_Masters-R128-Pablo_Carreno_Busta-Joao_Sousa,2,F-II,9,3,0,1,2,4,5
20140320-M-Miami_Masters-R128-Pablo_Carreno_Busta-Joao_Sousa,2,B-XC,33,1,0,0,1,20,13
20140320-M-Miami_Masters-R128-Pablo_Carreno_Busta-Joao_Sousa,2,B-DTM,46,2,0,1,1,24,22
20140320-M-Miami_Masters-R128-Pablo_Carreno_Busta-Joao_Sousa,2,B-DTL,3,1,0,0,1,2,1
20140320-M-Miami_Masters-R128-Pablo_Carreno_Busta-Joao_Sousa,2,S-XC,11,0,0,0,0,8,3
20140320-M-Miami_Masters-R128-Pablo_Carreno_Busta-Joao_Sousa,2,S-DTM,9,0,0,0,0,2,7
20140320-M-Miami_Masters-R128-Pablo_Carreno_Busta-Joao_Sousa,2,S-DTL,1,0,0,0,0,1,0
20140324-M-Miami_Masters-R32-Denis_Istomin-Rafael_Nadal,1,F-XC,20,1,0,1,0,5,15
20140324-M-Miami_Masters-R32-Denis_Istomin-Rafael_Nadal,1,F-DTM,17,1,0,0,1,3,14
20140324-M-Miami_Masters-R32-Denis_Istomin-Rafael_Nadal,1,F-DTL,11,6,4,0,2,6,5
20140324-M-Miami_Masters-R32-Denis_Istomin-Rafael_Nadal,1,F-IO,13,6,1,0,5,4,9
20140324-M-Miami_Masters-R32-Denis_Istomin-Rafael_Nadal,1,F-II,1,1,1,0,0,1,0
20140324-M-Miami_Masters-R32-Denis_Istomin-Rafael_Nadal,1,B-XC,20,2,0,0,2,4,16
20140324-M-Miami_Masters-R32-Denis_Istomin-Rafael_Nadal,1,B-DTM,16,2,0,0,2,4,12
20140324-M-Miami_Masters-R32-Denis_Istomin-Rafael_Nadal,1,B-DTL,11,3,1,0,2,4,7
20140324-M-Miami_Masters-R32-Denis_Istomin-Rafael_Nadal,1,B-IO,5,2,0,1,1,1,4
20140324-M-Miami_Masters-R32-Denis_Istomin-Rafael_Nadal,1,S-XC,2,0,0,0,0,0,2
20140324-M-Miami_Masters-R32-Denis_Istomin-Rafael_Nadal,1,S-DTM,3,0,0,0,0,1,2
20140324-M-Miami_Masters-R32-Denis_Istomin-Rafael_Nadal,1,S-DTL,1,0,0,0,0,0,1
20140324-M-Miami_Masters-R32-Denis_Istomin-Rafael_Nadal,1,S-IO,1,0,0,0,0,0,1
20140324-M-Miami_Masters-R32-Denis_Istomin-Rafael_Nadal,2,F-XC,45,7,1,6,0,34,11
20140324-M-Miami_Masters-R32-Denis_Istomin-Rafael_Nadal,2,F-DTM,19,0,0,0,0,12,7
20140324-M-Miami_Masters-R32-Denis_Istomin-Rafael_Nadal,2,F-DTL,10,5,5,0,0,8,2
20140324-M-Miami_Masters-R32-Denis_Istomin-Rafael_Nadal,2,F-IO,21,12,3,6,3,16,5
20140324-M-Miami_Masters-R32-Denis_Istomin-Rafael_Nadal,2,F-II,2,0,0,0,0,2,0
20140324-M-Miami_Masters-R32-Denis_Istomin-Rafael_Nadal,2,B-XC,11,3,0,1,2,5,6
20140324-M-Miami_Masters-R32-Denis_Istomin-Rafael_Nadal,2,B-DTM,6,1,0,0,1,4,2
20140324-M-Miami_Masters-R32-Denis_Istomin-Rafael_Nadal,2,B-DTL,4,2,1,1,0,4,0
20140324-M-Miami_Masters-R32-Denis_Istomin-Rafael_Nadal,2,B-IO,1,1,0,1,0,1,0
20140324-M-Miami_Masters-R32-Denis_Istomin-Rafael_Nadal,2,S-XC,1,0,0,0,0,1,0
20140324-M-Miami_Masters-R32-Denis_Istomin-Rafael_Nadal,2,S-DTM,7,1,0,1,0,7,0
20140324-M-Miami_Masters-R32-Denis_Istomin-Rafael_Nadal,2,S-DTL,1,0,0,0,0,1,0
20140327-M-Miami_Masters-QF-Milos_Raonic-Rafael_Nadal,1,F-XC,56,12,4,2,6,23,33
20140327-M-Miami_Masters-QF-Milos_Raonic-Rafael_Nadal,1,F-DTM,48,5,0,0,5,22,26
20140327-M-Miami_Masters-QF-Milos_Raonic-Rafael_Nadal,1,F-DTL,2,2,1,0,1,1,1
20140327-M-Miami_Masters-QF-Milos_Raonic-Rafael_Nadal,1,F-IO,43,22,4,8,10,20,23
20140327-M-Miami_Masters-QF-Milos_Raonic-Rafael_Nadal,1,F-II,8,4,0,0,4,2,6
20140327-M-Miami_Masters-QF-Milos_Raonic-Rafael_Nadal,1,B-XC,13,6,0,3,3,6,7
20140327-M-Miami_Masters-QF-Milos_Raonic-Rafael_Nadal,1,B-DTM,29,9,0,1,8,10,19
20140327-M-Miami_Masters-QF-Milos_Raonic-Rafael_Nadal,1,B-DTL,13,2,0,0,2,5,8
20140327-M-Miami_Masters-QF-Milos_Raonic-Rafael_Nadal,1,B-IO,2,1,0,0,1,0,2
20140327-M-Miami_Masters-QF-Milos_Raonic-Rafael_Nadal,1,S-XC,1,0,0,0,0,0,1
20140327-M-Miami_Masters-QF-Milos_Raonic-Rafael_Nadal,1,S-DTM,4,0,0,0,0,3,1
20140327-M-Miami_Masters-QF-Milos_Raonic-Rafael_Nadal,2,F-XC,51,10,3,6,1,38,13
20140327-M-Miami_Masters-QF-Milos_Raonic-Rafael_Nadal,2,F-DTM,35,2,0,0,2,16,19
20140327-M-Miami_Masters-QF-Milos_Raonic-Rafael_Nadal,2,F-DTL,12,5,3,0,2,8,4
20140327-M-Miami_Masters-QF-Milos_Raonic-Rafael_Nadal,2,F-IO,42,16,8,4,4,27,15
20140327-M-Miami_Masters-QF-Milos_Raonic-Rafael_Nadal,2,F-II,5,1,1,0,0,4,1
20140327-M-Miami_Masters-QF-Milos_Raonic-Rafael_Nadal,2,B-XC,23,9,0,3,6,14,9
20140327-M-Miami_Masters-QF-Milos_Raonic-Rafael_Nadal,2,B-DTM,24,1,0,0,1,14,10
20140327-M-Miami_Masters-QF-Milos_Raonic-Rafael_Nadal,2,B-DTL,10,2,1,0,1,6,4
20140327-M-Miami_Masters-QF-Milos_Raonic-Rafael_Nadal,2,B-IO,5,1,1,0,0,3,2
20140327-M-Miami_Masters-QF-Milos_Raonic-Rafael_Nadal,2,S-XC,3,0,0,0,0,1,2
20140327-M-Miami_Masters-QF-Milos_Raonic-Rafael_Nadal,2,S-DTM,8,0,0,0,0,1,7
20140327-M-Miami_Masters-QF-Milos_Raonic-Rafael_Nadal,2,S-DTL,5,0,0,0,0,3,2
20140327-M-Miami_Masters-QF-Milos_Raonic-Rafael_Nadal,2,S-IO,1,0,0,0,0,0,1
20140325-M-Miami_Masters-R16-Fabio_Fognini-Rafael_Nadal,1,F-XC,31,10,0,2,8,8,23
20140325-M-Miami_Masters-R16-Fabio_Fognini-Rafael_Nadal,1,F-DTM,13,3,0,0,3,4,9
20140325-M-Miami_Masters-R16-Fabio_Fognini-Rafael_Nadal,1,F-DTL,5,2,1,0,1,4,1
20140325-M-Miami_Masters-R16-Fabio_Fognini-Rafael_Nadal,1,F-IO,10,1,0,0,1,4,6
20140325-M-Miami_Masters-R16-Fabio_Fognini-Rafael_Nadal,1,F-II,4,2,0,1,1,1,3
20140325-M-Miami_Masters-R16-Fabio_Fognini-Rafael_Nadal,1,B-XC,26,9,1,1,7,8,18
20140325-M-Miami_Masters-R16-Fabio_Fognini-Rafael_Nadal,1,B-DTM,23,2,0,0,2,6,17
20140325-M-Miami_Masters-R16-Fabio_Fognini-Rafael_Nadal,1,B-DTL,6,2,0,0,2,0,6
20140325-M-Miami_Masters-R16-Fabio_Fognini-Rafael_Nadal,1,B-IO,3,1,0,0,1,0,3
20140325-M-Miami_Masters-R16-Fabio_Fognini-Rafael_Nadal,2,F-XC,38,6,2,2,2,28,10
20140325-M-Miami_Masters-R16-Fabio_Fognini-Rafael_Nadal,2,F-DTM,13,0,0,0,0,9,4
20140325-M-Miami_Masters-R16-Fabio_Fognini-Rafael_Nadal,2,F-DTL,7,1,0,0,1,4,3
20140325-M-Miami_Masters-R16-Fabio_Fognini-Rafael_Nadal,2,F-IO,9,2,2,0,0,5,4
20140325-M-Miami_Masters-R16-Fabio_Fognini-Rafael_Nadal,2,F-II,2,1,1,0,0,2,0
20140325-M-Miami_Masters-R16-Fabio_Fognini-Rafael_Nadal,2,B-XC,16,4,1,0,3,9,7
20140325-M-Miami_Masters-R16-Fabio_Fognini-Rafael_Nadal,2,B-DTM,8,1,0,0,1,5,3
20140325-M-Miami_Masters-R16-Fabio_Fognini-Rafael_Nadal,2,B-DTL,8,2,2,0,0,7,1
20140325-M-Miami_Masters-R16-Fabio_Fognini-Rafael_Nadal,2,B-IO,4,1,0,1,0,4,0
20140325-M-Miami_Masters-R16-Fabio_Fognini-Rafael_Nadal,2,B-II,2,0,0,0,0,0,2
20140325-M-Miami_Masters-R16-Fabio_Fognini-Rafael_Nadal,2,S-XC,2,0,0,0,0,2,0
20140325-M-Miami_Masters-R16-Fabio_Fognini-Rafael_Nadal,2,S-DTM,1,0,0,0,0,0,1
20140325-M-Miami_Masters-R16-Fabio_Fognini-Rafael_Nadal,2,S-DTL,2,0,0,0,0,2,0
20140325-M-Miami_Masters-R16-Fabio_Fognini-Rafael_Nadal,2,S-IO,1,1,0,0,1,0,1
20140330-M-Miami_Masters-F-Novak_Djokovic-Rafael_Nadal,1,F-XC,39,6,4,1,1,30,9
20140330-M-Miami_Masters-F-Novak_Djokovic-Rafael_Nadal,1,F-DTM,23,2,0,0,2,10,13
20140330-M-Miami_Masters-F-Novak_Djokovic-Rafael_Nadal,1,F-DTL,4,2,1,0,1,3,1
20140330-M-Miami_Masters-F-Novak_Djokovic-Rafael_Nadal,1,F-IO,24,6,2,3,1,17,7
20140330-M-Miami_Masters-F-Novak_Djokovic-Rafael_Nadal,1,B-XC,30,8,5,3,0,23,7
20140330-M-Miami_Masters-F-Novak_Djokovic-Rafael_Nadal,1,B-DTM,30,4,0,0,4,15,15
20140330-M-Miami_Masters-F-Novak_Djokovic-Rafael_Nadal,1,B-DTL,14,1,0,1,0,11,3
20140330-M-Miami_Masters-F-Novak_Djokovic-Rafael_Nadal,1,B-IO,6,1,0,1,0,3,3
20140330-M-Miami_Masters-F-Novak_Djokovic-Rafael_Nadal,1,S-XC,2,2,0,2,0,2,0
20140330-M-Miami_Masters-F-Novak_Djokovic-Rafael_Nadal,2,F-XC,41,6,2,3,1,20,21
20140330-M-Miami_Masters-F-Novak_Djokovic-Rafael_Nadal,2,F-DTM,37,4,0,1,3,10,27
20140330-M-Miami_Masters-F-Novak_Djokovic-Rafael_Nadal,2,F-DTL,10,3,2,0,1,3,7
20140330-M-Miami_Masters-F-Novak_Djokovic-Rafael_Nadal,2,F-IO,26,7,5,1,1,17,9
20140330-M-Miami_Masters-F-Novak_Djokovic-Rafael_Nadal,2,F-II,3,1,0,0,1,0,3
20140330-M-Miami_Masters-F-Novak_Djokovic-Rafael_Nadal,2,B-XC,16,4,1,1,2,5,11
20140330-M-Miami_Masters-F-Novak_Djokovic-Rafael_Nadal,2,B-DTM,27,5,0,0,5,10,17
20140330-M-Miami_Masters-F-Novak_Djokovic-Rafael_Nadal,2,B-DTL,7,0,0,0,0,1,6
20140330-M-Miami_Masters-F-Novak_Djokovic-Rafael_Nadal,2,B-IO,1,0,0,0,0,0,1
20140330-M-Miami_Masters-F-Novak_Djokovic-Rafael_Nadal,2,B-II,1,0,0,0,0,0,1
20140330-M-Miami_Masters-F-Novak_Djokovic-Rafael_Nadal,2,S-XC,2,0,0,0,0,1,1
20140330-M-Miami_Masters-F-Novak_Djokovic-Rafael_Nadal,2,S-DTM,9,0,0,0,0,2,7
20140330-M-Miami_Masters-F-Novak_Djokovic-Rafael_Nadal,2,S-DTL,2,1,0,0,1,0,2
20140330-M-Miami_Masters-F-Novak_Djokovic-Rafael_Nadal,2,S-IO,1,0,0,0,0,0,1
20130807-M-Montreal_Masters-R32-Marcel_Granollers-Andy_Murray,1,F-XC,59,10,0,1,9,31,28
20130807-M-Montreal_Masters-R32-Marcel_Granollers-Andy_Murray,1,F-DTM,48,3,0,0,3,19,29
20130807-M-Montreal_Masters-R32-Marcel_Granollers-Andy_Murray,1,F-DTL,9,3,2,0,1,4,5
20130807-M-Montreal_Masters-R32-Marcel_Granollers-Andy_Murray,1,F-IO,12,3,0,2,1,7,5
20130807-M-Montreal_Masters-R32-Marcel_Granollers-Andy_Murray,1,F-II,1,0,0,0,0,1,0
20130807-M-Montreal_Masters-R32-Marcel_Granollers-Andy_Murray,1,B-XC,56,9,1,3,5,20,36
20130807-M-Montreal_Masters-R32-Marcel_Granollers-Andy_Murray,1,B-DTM,68,10,0,0,10,29,39
20130807-M-Montreal_Masters-R32-Marcel_Granollers-Andy_Murray,1,B-DTL,2,0,0,0,0,0,2
20130807-M-Montreal_Masters-R32-Marcel_Granollers-Andy_Murray,1,B-IO,3,0,0,0,0,3,0
20130807-M-Montreal_Masters-R32-Marcel_Granollers-Andy_Murray,1,S-XC,13,1,0,1,0,7,6
20130807-M-Montreal_Masters-R32-Marcel_Granollers-Andy_Murray,1,S-DTM,14,0,0,0,0,4,10
20130807-M-Montreal_Masters-R32-Marcel_Granollers-Andy_Murray,2,F-XC,64,9,3,3,3,34,30
20130807-M-Montreal_Masters-R32-Marcel_Granollers-Andy_Murray,2,F-DTM,52,5,0,1,4,26,26
20130807-M-Montreal_Masters-R32-Marcel_Granollers-Andy_Murray,2,F-DTL,12,5,1,1,3,6,6
20130807-M-Montreal_Masters-R32-Marcel_Granollers-Andy_Murray,2,F-IO,53,13,6,5,2,38,15
20130807-M-Montreal_Masters-R32-Marcel_Granollers-Andy_Murray,2,F-II,3,2,1,0,1,1,2
20130807-M-Montreal_Masters-R32-Marcel_Granollers-Andy_Murray,2,B-XC,37,10,3,2,5,21,16
20130807-M-Montreal_Masters-R32-Marcel_Granollers-Andy_Murray,2,B-DTM,40,5,0,0,5,20,20
20130807-M-Montreal_Masters-R32-Marcel_Granollers-Andy_Murray,2,B-DTL,4,1,1,0,0,3,1
20130807-M-Montreal_Masters-R32-Marcel_Granollers-Andy_Murray,2,B-IO,7,1,1,0,0,5,2
20130807-M-Montreal_Masters-R32-Marcel_Granollers-Andy_Murray,2,S-XC,13,2,0,0,2,9,4
20130807-M-Montreal_Masters-R32-Marcel_Granollers-Andy_Murray,2,S-DTM,11,1,0,0,1,5,6
20130807-M-Montreal_Masters-R32-Marcel_Granollers-Andy_Murray,2,S-DTL,2,2,0,0,2,0,2
20130807-M-Montreal_Masters-R32-Marcel_Granollers-Andy_Murray,2,S-IO,2,1,0,0,1,1,1
20130504-M-Munich-SF-Tommy_Haas-Ivan_Dodig,1,F-XC,44,13,3,4,6,27,17
20130504-M-Munich-SF-Tommy_Haas-Ivan_Dodig,1,F-DTM,34,3,1,0,2,14,20
20130504-M-Munich-SF-Tommy_Haas-Ivan_Dodig,1,F-DTL,7,1,0,0,1,2,5
20130504-M-Munich-SF-Tommy_Haas-Ivan_Dodig,1,F-IO,22,5,1,1,3,11,11
20130504-M-Munich-SF-Tommy_Haas-Ivan_Dodig,1,F-II,2,1,1,0,0,2,0
20130504-M-Munich-SF-Tommy_Haas-Ivan_Dodig,1,B-XC,28,5,2,0,3,16,12
20130504-M-Munich-SF-Tommy_Haas-Ivan_Dodig,1,B-DTM,21,2,0,0,2,10,11
20130504-M-Munich-SF-Tommy_Haas-Ivan_Dodig,1,B-DTL,7,5,3,0,2,4,3
20130504-M-Munich-SF-Tommy_Haas-Ivan_Dodig,1,B-IO,2,0,0,0,0,1,1
20130504-M-Munich-SF-Tommy_Haas-Ivan_Dodig,1,S-XC,13,0,0,0,0,6,7
20130504-M-Munich-SF-Tommy_Haas-Ivan_Dodig,1,S-DTM,14,1,0,0,1,7,7
20130504-M-Munich-SF-Tommy_Haas-Ivan_Dodig,1,S-DTL,2,1,0,0,1,1,1
20130504-M-Munich-SF-Tommy_Haas-Ivan_Dodig,1,S-IO,1,0,0,0,0,1,0
20130504-M-Munich-SF-Tommy_Haas-Ivan_Dodig,2,F-XC,38,8,1,2,5,14,24
20130504-M-Munich-SF-Tommy_Haas-Ivan_Dodig,2,F-DTM,28,5,1,0,4,13,15
20130504-M-Munich-SF-Tommy_Haas-Ivan_Dodig,2,F-DTL,15,3,0,1,2,6,9
20130504-M-Munich-SF-Tommy_Haas-Ivan_Dodig,2,F-IO,27,3,1,1,1,15,12
20130504-M-Munich-SF-Tommy_Haas-Ivan_Dodig,2,F-II,3,1,1,0,0,2,1
20130504-M-Munich-SF-Tommy_Haas-Ivan_Dodig,2,B-XC,32,7,0,1,6,17,15
20130504-M-Munich-SF-Tommy_Haas-Ivan_Dodig,2,B-DTM,29,3,0,0,3,13,16
20130504-M-Munich-SF-Tommy_Haas-Ivan_Dodig,2,B-DTL,7,2,1,0,1,3,4
20130504-M-Munich-SF-Tommy_Haas-Ivan_Dodig,2,B-IO,2,0,0,0,0,1,1
20130504-M-Munich-SF-Tommy_Haas-Ivan_Dodig,2,S-XC,5,0,0,0,0,2,3
20130504-M-Munich-SF-Tommy_Haas-Ivan_Dodig,2,S-DTM,7,1,0,0,1,2,5
20130504-M-Munich-SF-Tommy_Haas-Ivan_Dodig,2,S-DTL,1,0,0,0,0,0,1
20130504-M-Munich-SF-Tommy_Haas-Ivan_Dodig,2,S-IO,1,0,0,0,0,0,1
20140503-M-Munich-SF-Jan_Lennard_Struff-Fabio_Fognini,1,F-XC,34,10,2,3,5,18,16
20140503-M-Munich-SF-Jan_Lennard_Struff-Fabio_Fognini,1,F-DTM,21,1,0,0,1,8,13
20140503-M-Munich-SF-Jan_Lennard_Struff-Fabio_Fognini,1,F-DTL,8,3,1,0,2,2,6
20140503-M-Munich-SF-Jan_Lennard_Struff-Fabio_Fognini,1,F-IO,26,8,2,4,2,11,15
20140503-M-Munich-SF-Jan_Lennard_Struff-Fabio_Fognini,1,F-II,3,0,0,0,0,1,2
20140503-M-Munich-SF-Jan_Lennard_Struff-Fabio_Fognini,1,B-XC,58,9,1,1,7,23,35
20140503-M-Munich-SF-Jan_Lennard_Struff-Fabio_Fognini,1,B-DTM,22,6,1,1,4,5,17
20140503-M-Munich-SF-Jan_Lennard_Struff-Fabio_Fognini,1,B-DTL,6,3,0,0,3,0,6
20140503-M-Munich-SF-Jan_Lennard_Struff-Fabio_Fognini,1,B-IO,5,3,1,1,1,2,3
20140503-M-Munich-SF-Jan_Lennard_Struff-Fabio_Fognini,1,S-XC,2,0,0,0,0,1,1
20140503-M-Munich-SF-Jan_Lennard_Struff-Fabio_Fognini,1,S-DTM,1,0,0,0,0,1,0
20140503-M-Munich-SF-Jan_Lennard_Struff-Fabio_Fognini,1,S-IO,1,0,0,0,0,0,1
20140503-M-Munich-SF-Jan_Lennard_Struff-Fabio_Fognini,2,F-XC,27,8,2,5,1,22,5
20140503-M-Munich-SF-Jan_Lennard_Struff-Fabio_Fognini,2,F-DTM,21,1,0,0,1,10,11
20140503-M-Munich-SF-Jan_Lennard_Struff-Fabio_Fognini,2,F-DTL,7,2,1,0,1,3,4
20140503-M-Munich-SF-Jan_Lennard_Struff-Fabio_Fognini,2,F-IO,16,5,3,1,1,11,5
20140503-M-Munich-SF-Jan_Lennard_Struff-Fabio_Fognini,2,F-II,4,1,0,1,0,4,0
20140503-M-Munich-SF-Jan_Lennard_Struff-Fabio_Fognini,2,B-XC,27,5,3,0,2,21,6
20140503-M-Munich-SF-Jan_Lennard_Struff-Fabio_Fognini,2,B-DTM,42,3,0,0,3,25,17
20140503-M-Munich-SF-Jan_Lennard_Struff-Fabio_Fognini,2,B-DTL,4,2,0,1,1,2,2
20140503-M-Munich-SF-Jan_Lennard_Struff-Fabio_Fognini,2,B-IO,8,0,0,0,0,5,3
20140503-M-Munich-SF-Jan_Lennard_Struff-Fabio_Fognini,2,S-XC,8,0,0,0,0,4,4
20140503-M-Munich-SF-Jan_Lennard_Struff-Fabio_Fognini,2,S-DTM,10,0,0,0,0,7,3
20140503-M-Munich-SF-Jan_Lennard_Struff-Fabio_Fognini,2,S-DTL,1,0,0,0,0,0,1
20140503-M-Munich-SF-Jan_Lennard_Struff-Fabio_Fognini,2,S-IO,1,1,0,0,1,0,1
20140503-M-Munich-SF-Tommy_Haas-Martin_Klizan,1,F-XC,38,4,1,0,3,16,22
20140503-M-Munich-SF-Tommy_Haas-Martin_Klizan,1,F-DTM,17,1,0,0,1,5,12
20140503-M-Munich-SF-Tommy_Haas-Martin_Klizan,1,F-DTL,6,4,1,0,3,1,5
20140503-M-Munich-SF-Tommy_Haas-Martin_Klizan,1,F-IO,15,5,0,1,4,7,8
20140503-M-Munich-SF-Tommy_Haas-Martin_Klizan,1,F-II,1,1,0,0,1,0,1
20140503-M-Munich-SF-Tommy_Haas-Martin_Klizan,1,B-XC,15,5,1,1,3,7,8
20140503-M-Munich-SF-Tommy_Haas-Martin_Klizan,1,B-DTM,26,3,0,0,3,4,22
20140503-M-Munich-SF-Tommy_Haas-Martin_Klizan,1,B-DTL,6,3,0,1,2,4,2
20140503-M-Munich-SF-Tommy_Haas-Martin_Klizan,1,B-IO,4,0,0,0,0,4,0
20140503-M-Munich-SF-Tommy_Haas-Martin_Klizan,1,S-DTM,10,2,0,0,2,2,8
20140503-M-Munich-SF-Tommy_Haas-Martin_Klizan,1,S-DTL,6,0,0,0,0,3,3
20140503-M-Munich-SF-Tommy_Haas-Martin_Klizan,1,S-IO,1,0,0,0,0,0,1
20140503-M-Munich-SF-Tommy_Haas-Martin_Klizan,2,F-XC,24,4,1,1,2,17,7
20140503-M-Munich-SF-Tommy_Haas-Martin_Klizan,2,F-DTM,18,1,0,0,1,9,9
20140503-M-Munich-SF-Tommy_Haas-Martin_Klizan,2,F-DTL,6,2,1,0,1,3,3
20140503-M-Munich-SF-Tommy_Haas-Martin_Klizan,2,F-IO,11,4,1,1,2,6,5
20140503-M-Munich-SF-Tommy_Haas-Martin_Klizan,2,F-II,3,1,1,0,0,3,0
20140503-M-Munich-SF-Tommy_Haas-Martin_Klizan,2,B-XC,34,8,1,1,6,21,13
20140503-M-Munich-SF-Tommy_Haas-Martin_Klizan,2,B-DTM,18,0,0,0,0,8,10
20140503-M-Munich-SF-Tommy_Haas-Martin_Klizan,2,B-DTL,12,7,0,1,6,4,8
20140503-M-Munich-SF-Tommy_Haas-Martin_Klizan,2,B-IO,6,1,0,0,1,2,4
20140503-M-Munich-SF-Tommy_Haas-Martin_Klizan,2,S-DTM,3,0,0,0,0,0,3
20140503-M-Munich-SF-Tommy_Haas-Martin_Klizan,2,S-DTL,4,0,0,0,0,2,2
20140503-M-Munich-SF-Tommy_Haas-Martin_Klizan,2,S-IO,1,0,0,0,0,0,1
20130501-M-Munich-R16-Dmitry_Tursunov-Alexandr_Dolgopolov,1,F-XC,30,11,3,5,3,19,11
20130501-M-Munich-R16-Dmitry_Tursunov-Alexandr_Dolgopolov,1,F-DTM,7,2,0,0,2,0,7
20130501-M-Munich-R16-Dmitry_Tursunov-Alexandr_Dolgopolov,1,F-DTL,5,2,1,0,1,3,2
20130501-M-Munich-R16-Dmitry_Tursunov-Alexandr_Dolgopolov,1,F-IO,11,3,0,2,1,8,3
20130501-M-Munich-R16-Dmitry_Tursunov-Alexandr_Dolgopolov,1,F-II,4,2,0,2,0,3,1
20130501-M-Munich-R16-Dmitry_Tursunov-Alexandr_Dolgopolov,1,B-XC,20,4,1,1,2,12,8
20130501-M-Munich-R16-Dmitry_Tursunov-Alexandr_Dolgopolov,1,B-DTM,20,0,0,0,0,7,13
20130501-M-Munich-R16-Dmitry_Tursunov-Alexandr_Dolgopolov,1,B-DTL,12,9,2,3,4,6,6
20130501-M-Munich-R16-Dmitry_Tursunov-Alexandr_Dolgopolov,1,B-IO,6,3,3,0,0,4,2
20130501-M-Munich-R16-Dmitry_Tursunov-Alexandr_Dolgopolov,1,S-XC,4,1,0,0,1,0,4
20130501-M-Munich-R16-Dmitry_Tursunov-Alexandr_Dolgopolov,1,S-DTM,3,0,0,0,0,1,2
20130501-M-Munich-R16-Dmitry_Tursunov-Alexandr_Dolgopolov,2,F-XC,29,6,2,1,3,18,11
20130501-M-Munich-R16-Dmitry_Tursunov-Alexandr_Dolgopolov,2,F-DTM,9,3,0,0,3,6,3
20130501-M-Munich-R16-Dmitry_Tursunov-Alexandr_Dolgopolov,2,F-DTL,6,2,0,0,2,4,2
20130501-M-Munich-R16-Dmitry_Tursunov-Alexandr_Dolgopolov,2,F-IO,14,8,3,1,4,9,5
20130501-M-Munich-R16-Dmitry_Tursunov-Alexandr_Dolgopolov,2,F-II,1,1,1,0,0,1,0
20130501-M-Munich-R16-Dmitry_Tursunov-Alexandr_Dolgopolov,2,B-XC,18,2,1,1,0,7,11
20130501-M-Munich-R16-Dmitry_Tursunov-Alexandr_Dolgopolov,2,B-DTM,7,2,0,0,2,1,6
20130501-M-Munich-R16-Dmitry_Tursunov-Alexandr_Dolgopolov,2,B-DTL,1,1,0,0,1,0,1
20130501-M-Munich-R16-Dmitry_Tursunov-Alexandr_Dolgopolov,2,B-IO,1,1,1,0,0,1,0
20130501-M-Munich-R16-Dmitry_Tursunov-Alexandr_Dolgopolov,2,S-XC,6,1,0,0,1,3,3
20130501-M-Munich-R16-Dmitry_Tursunov-Alexandr_Dolgopolov,2,S-DTM,2,0,0,0,0,1,1
20130501-M-Munich-R16-Dmitry_Tursunov-Alexandr_Dolgopolov,2,S-DTL,1,1,1,0,0,1,0
20130903-M-US_Open-R16-Denis_Istomin-Andy_Murray,1,F-XC,47,7,2,1,4,18,29
20130903-M-US_Open-R16-Denis_Istomin-Andy_Murray,1,F-DTM,62,8,0,0,8,22,40
20130903-M-US_Open-R16-Denis_Istomin-Andy_Murray,1,F-DTL,25,10,5,0,5,14,11
20130903-M-US_Open-R16-Denis_Istomin-Andy_Murray,1,F-IO,14,8,0,3,5,6,8
20130903-M-US_Open-R16-Denis_Istomin-Andy_Murray,1,B-XC,50,6,1,1,4,17,33
20130903-M-US_Open-R16-Denis_Istomin-Andy_Murray,1,B-DTM,73,4,0,0,4,25,48
20130903-M-US_Open-R16-Denis_Istomin-Andy_Murray,1,B-DTL,22,8,0,1,7,10,12
20130903-M-US_Open-R16-Denis_Istomin-Andy_Murray,1,B-IO,13,1,0,0,1,7,6
20130903-M-US_Open-R16-Denis_Istomin-Andy_Murray,1,S-XC,7,1,0,0,1,1,6
20130903-M-US_Open-R16-Denis_Istomin-Andy_Murray,1,S-DTM,7,1,0,0,1,1,6
20130903-M-US_Open-R16-Denis_Istomin-Andy_Murray,1,S-DTL,1,1,0,0,1,0,1
20130903-M-US_Open-R16-Denis_Istomin-Andy_Murray,1,S-IO,1,0,0,0,0,0,1
20130903-M-US_Open-R16-Denis_Istomin-Andy_Murray,2,F-XC,87,15,4,4,6,49,38
20130903-M-US_Open-R16-Denis_Istomin-Andy_Murray,2,F-DTM,40,4,0,0,4,19,21
20130903-M-US_Open-R16-Denis_Istomin-Andy_Murray,2,F-DTL,12,1,0,0,1,8,4
20130903-M-US_Open-R16-Denis_Istomin-Andy_Murray,2,F-IO,34,6,3,1,2,24,10
20130903-M-US_Open-R16-Denis_Istomin-Andy_Murray,2,F-II,3,0,0,0,0,2,1
20130903-M-US_Open-R16-Denis_Istomin-Andy_Murray,2,B-XC,30,4,0,0,4,20,10
20130903-M-US_Open-R16-Denis_Istomin-Andy_Murray,2,B-DTM,47,8,0,2,6,29,18
20130903-M-US_Open-R16-Denis_Istomin-Andy_Murray,2,B-DTL,6,2,0,0,2,2,4
20130903-M-US_Open-R16-Denis_Istomin-Andy_Murray,2,B-IO,13,3,1,0,2,6,7
20130903-M-US_Open-R16-Denis_Istomin-Andy_Murray,2,S-XC,19,0,0,0,0,12,7
20130903-M-US_Open-R16-Denis_Istomin-Andy_Murray,2,S-DTM,37,2,0,1,1,18,19
20130903-M-US_Open-R16-Denis_Istomin-Andy_Murray,2,S-DTL,3,1,1,0,0,3,0
20130903-M-US_Open-R16-Denis_Istomin-Andy_Murray,2,S-IO,4,1,0,1,0,4,0
20130905-M-US_Open-QF-Stanislas_Wawrinka-Andy_Murray,1,F-XC,45,15,4,2,9,21,24
20130905-M-US_Open-QF-Stanislas_Wawrinka-Andy_Murray,1,F-DTM,32,4,0,1,3,10,22
20130905-M-US_Open-QF-Stanislas_Wawrinka-Andy_Murray,1,F-DTL,12,6,3,1,2,5,7
20130905-M-US_Open-QF-Stanislas_Wawrinka-Andy_Murray,1,F-IO,12,6,1,1,4,6,6
20130905-M-US_Open-QF-Stanislas_Wawrinka-Andy_Murray,1,B-XC,36,6,1,0,5,16,20
20130905-M-US_Open-QF-Stanislas_Wawrinka-Andy_Murray,1,B-DTM,19,1,0,0,1,5,14
20130905-M-US_Open-QF-Stanislas_Wawrinka-Andy_Murray,1,B-DTL,8,3,2,0,1,5,3
20130905-M-US_Open-QF-Stanislas_Wawrinka-Andy_Murray,1,B-IO,9,5,1,0,4,3,6
20130905-M-US_Open-QF-Stanislas_Wawrinka-Andy_Murray,1,S-XC,17,1,0,0,1,10,7
20130905-M-US_Open-QF-Stanislas_Wawrinka-Andy_Murray,1,S-DTM,11,1,0,0,1,1,10
20130905-M-US_Open-QF-Stanislas_Wawrinka-Andy_Murray,2,F-XC,32,2,0,0,2,20,12
20130905-M-US_Open-QF-Stanislas_Wawrinka-Andy_Murray,2,F-DTM,40,5,0,0,5,16,24
20130905-M-US_Open-QF-Stanislas_Wawrinka-Andy_Murray,2,F-DTL,5,1,0,0,1,3,2
20130905-M-US_Open-QF-Stanislas_Wawrinka-Andy_Murray,2,F-IO,17,3,0,0,3,11,6
20130905-M-US_Open-QF-Stanislas_Wawrinka-Andy_Murray,2,F-II,4,1,0,0,1,2,2
20130905-M-US_Open-QF-Stanislas_Wawrinka-Andy_Murray,2,B-XC,23,4,0,1,3,11,12
20130905-M-US_Open-QF-Stanislas_Wawrinka-Andy_Murray,2,B-DTM,20,1,0,0,1,9,11
20130905-M-US_Open-QF-Stanislas_Wawrinka-Andy_Murray,2,B-DTL,2,0,0,0,0,2,0
20130905-M-US_Open-QF-Stanislas_Wawrinka-Andy_Murray,2,B-IO,6,0,0,0,0,4,2
20130905-M-US_Open-QF-Stanislas_Wawrinka-Andy_Murray,2,S-XC,8,0,0,0,0,5,3
20130905-M-US_Open-QF-Stanislas_Wawrinka-Andy_Murray,2,S-DTM,20,0,0,0,0,9,11
20130905-M-US_Open-QF-Stanislas_Wawrinka-Andy_Murray,2,S-DTL,3,1,0,0,1,0,3
20130905-M-US_Open-QF-Stanislas_Wawrinka-Andy_Murray,2,S-IO,3,1,0,0,1,2,1
20130714-M-Newport-F-Nicolas_Mahut-Lleyton_Hewitt,1,F-XC,19,8,5,1,2,14,5
20130714-M-Newport-F-Nicolas_Mahut-Lleyton_Hewitt,1,F-DTM,20,4,0,0,4,9,11
20130714-M-Newport-F-Nicolas_Mahut-Lleyton_Hewitt,1,F-DTL,7,7,2,0,5,2,5
20130714-M-Newport-F-Nicolas_Mahut-Lleyton_Hewitt,1,F-IO,10,3,1,1,1,4,6
20130714-M-Newport-F-Nicolas_Mahut-Lleyton_Hewitt,1,B-XC,5,2,1,0,1,2,3
20130714-M-Newport-F-Nicolas_Mahut-Lleyton_Hewitt,1,B-DTM,8,1,0,0,1,0,8
20130714-M-Newport-F-Nicolas_Mahut-Lleyton_Hewitt,1,B-DTL,2,2,0,0,2,0,2
20130714-M-Newport-F-Nicolas_Mahut-Lleyton_Hewitt,1,S-XC,15,0,0,0,0,9,6
20130714-M-Newport-F-Nicolas_Mahut-Lleyton_Hewitt,1,S-DTM,18,1,0,0,1,7,11
20130714-M-Newport-F-Nicolas_Mahut-Lleyton_Hewitt,1,S-DTL,3,0,0,0,0,2,1
20130714-M-Newport-F-Nicolas_Mahut-Lleyton_Hewitt,1,S-IO,1,0,0,0,0,0,1
20130714-M-Newport-F-Nicolas_Mahut-Lleyton_Hewitt,2,F-XC,36,9,1,3,5,19,17
20130714-M-Newport-F-Nicolas_Mahut-Lleyton_Hewitt,2,F-DTM,16,1,0,0,1,6,10
20130714-M-Newport-F-Nicolas_Mahut-Lleyton_Hewitt,2,F-DTL,3,2,0,1,1,2,1
20130714-M-Newport-F-Nicolas_Mahut-Lleyton_Hewitt,2,F-IO,21,3,0,0,3,11,10
20130714-M-Newport-F-Nicolas_Mahut-Lleyton_Hewitt,2,F-II,1,0,0,0,0,0,1
20130714-M-Newport-F-Nicolas_Mahut-Lleyton_Hewitt,2,B-XC,15,5,2,0,3,9,6
20130714-M-Newport-F-Nicolas_Mahut-Lleyton_Hewitt,2,B-DTM,16,3,0,0,3,9,7
20130714-M-Newport-F-Nicolas_Mahut-Lleyton_Hewitt,2,B-DTL,2,1,0,0,1,0,2
20130714-M-Newport-F-Nicolas_Mahut-Lleyton_Hewitt,2,B-IO,4,3,1,0,2,2,2
20130714-M-Newport-F-Nicolas_Mahut-Lleyton_Hewitt,2,S-XC,9,0,0,0,0,7,2
20130714-M-Newport-F-Nicolas_Mahut-Lleyton_Hewitt,2,S-DTM,5,1,0,0,1,1,4
20130714-M-Newport-F-Nicolas_Mahut-Lleyton_Hewitt,2,S-DTL,3,2,0,1,1,1,2
20130714-M-Newport-F-Nicolas_Mahut-Lleyton_Hewitt,2,S-IO,1,0,0,0,0,0,1
20140524-M-Nice-F-Ernests_Gulbis-Federico_Delbonis,1,F-XC,38,6,1,2,3,21,17
20140524-M-Nice-F-Ernests_Gulbis-Federico_Delbonis,1,F-DTM,31,0,0,0,0,16,15
20140524-M-Nice-F-Ernests_Gulbis-Federico_Delbonis,1,F-DTL,7,1,0,0,1,4,3
20140524-M-Nice-F-Ernests_Gulbis-Federico_Delbonis,1,F-IO,18,8,5,1,2,8,10
20140524-M-Nice-F-Ernests_Gulbis-Federico_Delbonis,1,B-XC,28,11,4,3,4,15,13
20140524-M-Nice-F-Ernests_Gulbis-Federico_Delbonis,1,B-DTM,34,5,0,1,4,15,19
20140524-M-Nice-F-Ernests_Gulbis-Federico_Delbonis,1,B-DTL,19,3,1,0,2,8,11
20140524-M-Nice-F-Ernests_Gulbis-Federico_Delbonis,1,B-IO,15,2,1,0,1,10,5
20140524-M-Nice-F-Ernests_Gulbis-Federico_Delbonis,1,S-XC,1,0,0,0,0,1,0
20140524-M-Nice-F-Ernests_Gulbis-Federico_Delbonis,1,S-DTM,2,0,0,0,0,0,2
20140524-M-Nice-F-Ernests_Gulbis-Federico_Delbonis,1,S-DTL,2,0,0,0,0,0,2
20140524-M-Nice-F-Ernests_Gulbis-Federico_Delbonis,1,S-IO,1,0,0,0,0,1,0
20140524-M-Nice-F-Ernests_Gulbis-Federico_Delbonis,2,F-XC,38,6,3,2,1,23,15
20140524-M-Nice-F-Ernests_Gulbis-Federico_Delbonis,2,F-DTM,35,2,0,0,2,17,18
20140524-M-Nice-F-Ernests_Gulbis-Federico_Delbonis,2,F-DTL,9,0,0,0,0,5,4
20140524-M-Nice-F-Ernests_Gulbis-Federico_Delbonis,2,F-IO,22,6,2,3,1,11,11
20140524-M-Nice-F-Ernests_Gulbis-Federico_Delbonis,2,F-II,5,2,2,0,0,3,2
20140524-M-Nice-F-Ernests_Gulbis-Federico_Delbonis,2,B-XC,21,6,0,2,4,12,9
20140524-M-Nice-F-Ernests_Gulbis-Federico_Delbonis,2,B-DTM,40,2,0,0,2,19,21
20140524-M-Nice-F-Ernests_Gulbis-Federico_Delbonis,2,B-DTL,15,3,0,1,2,9,6
20140524-M-Nice-F-Ernests_Gulbis-Federico_Delbonis,2,B-IO,7,2,0,0,2,3,4
20140524-M-Nice-F-Ernests_Gulbis-Federico_Delbonis,2,S-XC,5,0,0,0,0,1,4
20140524-M-Nice-F-Ernests_Gulbis-Federico_Delbonis,2,S-DTM,8,0,0,0,0,3,5
20140524-M-Nice-F-Ernests_Gulbis-Federico_Delbonis,2,S-DTL,4,1,0,1,0,2,2
20140524-M-Nice-F-Ernests_Gulbis-Federico_Delbonis,2,S-IO,1,0,0,0,0,0,1
20130909-M-US_Open-F-Novak_Djokovic-Rafael_Nadal,1,F-XC,129,17,4,4,9,67,62
20130909-M-US_Open-F-Novak_Djokovic-Rafael_Nadal,1,F-DTM,59,7,1,0,6,24,35
20130909-M-US_Open-F-Novak_Djokovic-Rafael_Nadal,1,F-DTL,11,2,0,0,2,5,6
20130909-M-US_Open-F-Novak_Djokovic-Rafael_Nadal,1,F-IO,46,15,4,5,6,25,21
20130909-M-US_Open-F-Novak_Djokovic-Rafael_Nadal,1,F-II,6,2,1,0,1,3,3
20130909-M-US_Open-F-Novak_Djokovic-Rafael_Nadal,1,B-XC,70,11,1,1,9,27,43
20130909-M-US_Open-F-Novak_Djokovic-Rafael_Nadal,1,B-DTM,68,9,1,0,8,34,34
20130909-M-US_Open-F-Novak_Djokovic-Rafael_Nadal,1,B-DTL,22,4,2,0,2,9,13
20130909-M-US_Open-F-Novak_Djokovic-Rafael_Nadal,1,B-IO,10,1,0,1,0,6,4
20130909-M-US_Open-F-Novak_Djokovic-Rafael_Nadal,1,S-XC,2,1,1,0,0,1,1
20130909-M-US_Open-F-Novak_Djokovic-Rafael_Nadal,1,S-DTM,4,0,0,0,0,0,4
20130909-M-US_Open-F-Novak_Djokovic-Rafael_Nadal,1,S-DTL,2,0,0,0,0,0,2
20130909-M-US_Open-F-Novak_Djokovic-Rafael_Nadal,1,S-IO,1,0,0,0,0,0,1
20130909-M-US_Open-F-Novak_Djokovic-Rafael_Nadal,2,F-XC,84,7,2,4,1,47,37
20130909-M-US_Open-F-Novak_Djokovic-Rafael_Nadal,2,F-DTM,58,2,0,0,2,27,31
20130909-M-US_Open-F-Novak_Djokovic-Rafael_Nadal,2,F-DTL,20,10,3,3,4,13,7
20130909-M-US_Open-F-Novak_Djokovic-Rafael_Nadal,2,F-IO,30,4,1,1,2,10,20
20130909-M-US_Open-F-Novak_Djokovic-Rafael_Nadal,2,F-II,6,3,1,0,2,4,2
20130909-M-US_Open-F-Novak_Djokovic-Rafael_Nadal,2,B-XC,48,10,4,2,4,29,19
20130909-M-US_Open-F-Novak_Djokovic-Rafael_Nadal,2,B-DTM,78,4,0,0,4,42,36
20130909-M-US_Open-F-Novak_Djokovic-Rafael_Nadal,2,B-DTL,8,2,0,0,2,2,6
20130909-M-US_Open-F-Novak_Djokovic-Rafael_Nadal,2,B-IO,7,2,0,1,1,5,2
20130909-M-US_Open-F-Novak_Djokovic-Rafael_Nadal,2,B-II,1,0,0,0,0,0,1
20130909-M-US_Open-F-Novak_Djokovic-Rafael_Nadal,2,S-XC,6,1,1,0,0,4,2
20130909-M-US_Open-F-Novak_Djokovic-Rafael_Nadal,2,S-DTM,38,2,1,0,1,15,23
20130909-M-US_Open-F-Novak_Djokovic-Rafael_Nadal,2,S-DTL,16,2,0,0,2,8,8
20130909-M-US_Open-F-Novak_Djokovic-Rafael_Nadal,2,S-IO,12,0,0,0,0,6,6
20131101-M-Paris_Masters-QF-Roger_Federer-Juan_Martin_Del_Potro,1,F-XC,33,9,4,2,3,21,12
20131101-M-Paris_Masters-QF-Roger_Federer-Juan_Martin_Del_Potro,1,F-DTM,26,0,0,0,0,14,12
20131101-M-Paris_Masters-QF-Roger_Federer-Juan_Martin_Del_Potro,1,F-DTL,12,5,3,1,1,10,2
20131101-M-Paris_Masters-QF-Roger_Federer-Juan_Martin_Del_Potro,1,F-IO,18,6,3,1,2,14,4
20131101-M-Paris_Masters-QF-Roger_Federer-Juan_Martin_Del_Potro,1,F-II,5,3,0,3,0,4,1
20131101-M-Paris_Masters-QF-Roger_Federer-Juan_Martin_Del_Potro,1,B-XC,38,4,0,1,3,20,18
20131101-M-Paris_Masters-QF-Roger_Federer-Juan_Martin_Del_Potro,1,B-DTM,25,3,0,1,2,14,11
20131101-M-Paris_Masters-QF-Roger_Federer-Juan_Martin_Del_Potro,1,B-DTL,17,6,3,1,2,11,6
20131101-M-Paris_Masters-QF-Roger_Federer-Juan_Martin_Del_Potro,1,B-IO,3,1,0,1,0,2,1
20131101-M-Paris_Masters-QF-Roger_Federer-Juan_Martin_Del_Potro,1,B-II,1,0,0,0,0,1,0
20131101-M-Paris_Masters-QF-Roger_Federer-Juan_Martin_Del_Potro,1,S-XC,12,0,0,0,0,6,6
20131101-M-Paris_Masters-QF-Roger_Federer-Juan_Martin_Del_Potro,1,S-DTM,6,0,0,0,0,5,1
20131101-M-Paris_Masters-QF-Roger_Federer-Juan_Martin_Del_Potro,1,S-DTL,6,0,0,0,0,4,2
20131101-M-Paris_Masters-QF-Roger_Federer-Juan_Martin_Del_Potro,2,F-XC,38,16,2,6,8,15,23
20131101-M-Paris_Masters-QF-Roger_Federer-Juan_Martin_Del_Potro,2,F-DTM,24,2,0,2,0,13,11
20131101-M-Paris_Masters-QF-Roger_Federer-Juan_Martin_Del_Potro,2,F-DTL,19,5,0,1,4,8,11
20131101-M-Paris_Masters-QF-Roger_Federer-Juan_Martin_Del_Potro,2,F-IO,35,8,1,1,6,11,24
20131101-M-Paris_Masters-QF-Roger_Federer-Juan_Martin_Del_Potro,2,F-II,5,5,3,1,1,4,1
20131101-M-Paris_Masters-QF-Roger_Federer-Juan_Martin_Del_Potro,2,B-XC,44,4,0,2,2,21,23
20131101-M-Paris_Masters-QF-Roger_Federer-Juan_Martin_Del_Potro,2,B-DTM,18,2,0,0,2,6,12
20131101-M-Paris_Masters-QF-Roger_Federer-Juan_Martin_Del_Potro,2,B-DTL,8,2,0,0,2,2,6
20131101-M-Paris_Masters-QF-Roger_Federer-Juan_Martin_Del_Potro,2,B-IO,4,1,1,0,0,2,2
20131101-M-Paris_Masters-QF-Roger_Federer-Juan_Martin_Del_Potro,2,S-XC,12,1,0,0,1,3,9
20131101-M-Paris_Masters-QF-Roger_Federer-Juan_Martin_Del_Potro,2,S-DTM,5,0,0,0,0,1,4
20131103-M-Paris_Masters-F-Novak_Djokovic-David_Ferrer,1,F-XC,55,14,5,4,5,35,20
20131103-M-Paris_Masters-F-Novak_Djokovic-David_Ferrer,1,F-DTM,33,1,0,0,1,17,16
20131103-M-Paris_Masters-F-Novak_Djokovic-David_Ferrer,1,F-DTL,20,6,2,2,2,14,6
20131103-M-Paris_Masters-F-Novak_Djokovic-David_Ferrer,1,F-IO,32,7,4,2,1,24,8
20131103-M-Paris_Masters-F-Novak_Djokovic-David_Ferrer,1,F-II,3,1,0,1,0,3,0
20131103-M-Paris_Masters-F-Novak_Djokovic-David_Ferrer,1,B-XC,78,11,3,3,5,45,33
20131103-M-Paris_Masters-F-Novak_Djokovic-David_Ferrer,1,B-DTM,58,4,0,1,3,31,27
20131103-M-Paris_Masters-F-Novak_Djokovic-David_Ferrer,1,B-DTL,31,5,2,0,3,16,15
20131103-M-Paris_Masters-F-Novak_Djokovic-David_Ferrer,1,B-IO,8,2,1,0,1,5,3
20131103-M-Paris_Masters-F-Novak_Djokovic-David_Ferrer,1,B-II,1,0,0,0,0,0,1
20131103-M-Paris_Masters-F-Novak_Djokovic-David_Ferrer,1,S-XC,7,1,0,0,1,3,4
20131103-M-Paris_Masters-F-Novak_Djokovic-David_Ferrer,1,S-DTM,11,0,0,0,0,5,6
20131103-M-Paris_Masters-F-Novak_Djokovic-David_Ferrer,1,S-IO,2,0,0,0,0,1,1
20131103-M-Paris_Masters-F-Novak_Djokovic-David_Ferrer,2,F-XC,66,10,2,3,5,31,35
20131103-M-Paris_Masters-F-Novak_Djokovic-David_Ferrer,2,F-DTM,41,2,0,0,2,13,28
20131103-M-Paris_Masters-F-Novak_Djokovic-David_Ferrer,2,F-DTL,20,5,1,1,3,7,13
20131103-M-Paris_Masters-F-Novak_Djokovic-David_Ferrer,2,F-IO,48,3,1,0,2,30,18
20131103-M-Paris_Masters-F-Novak_Djokovic-David_Ferrer,2,F-II,6,1,0,1,0,2,4
20131103-M-Paris_Masters-F-Novak_Djokovic-David_Ferrer,2,B-XC,69,2,0,1,1,28,41
20131103-M-Paris_Masters-F-Novak_Djokovic-David_Ferrer,2,B-DTM,67,5,0,0,5,19,48
20131103-M-Paris_Masters-F-Novak_Djokovic-David_Ferrer,2,B-DTL,15,9,3,1,5,7,8
20131103-M-Paris_Masters-F-Novak_Djokovic-David_Ferrer,2,B-IO,2,1,0,0,1,1,1
20131103-M-Paris_Masters-F-Novak_Djokovic-David_Ferrer,2,S-XC,4,0,0,0,0,0,4
20131103-M-Paris_Masters-F-Novak_Djokovic-David_Ferrer,2,S-DTM,2,0,0,0,0,1,1
20131103-M-Paris_Masters-F-Novak_Djokovic-David_Ferrer,2,S-DTL,1,0,0,0,0,0,1
20131030-M-Paris_Masters-R32-David_Ferrer-Lukas_Rosol,1,F-XC,35,13,3,6,4,24,11
20131030-M-Paris_Masters-R32-David_Ferrer-Lukas_Rosol,1,F-DTM,35,3,0,0,3,18,17
20131030-M-Paris_Masters-R32-David_Ferrer-Lukas_Rosol,1,F-DTL,6,3,1,0,2,3,3
20131030-M-Paris_Masters-R32-David_Ferrer-Lukas_Rosol,1,F-IO,22,4,1,1,2,16,6
20131030-M-Paris_Masters-R32-David_Ferrer-Lukas_Rosol,1,F-II,6,1,1,0,0,5,1
20131030-M-Paris_Masters-R32-David_Ferrer-Lukas_Rosol,1,B-XC,37,6,0,0,6,18,19
20131030-M-Paris_Masters-R32-David_Ferrer-Lukas_Rosol,1,B-DTM,49,6,0,1,5,24,25
20131030-M-Paris_Masters-R32-David_Ferrer-Lukas_Rosol,1,B-DTL,2,2,0,0,2,0,2
20131030-M-Paris_Masters-R32-David_Ferrer-Lukas_Rosol,1,B-IO,1,0,0,0,0,0,1
20131030-M-Paris_Masters-R32-David_Ferrer-Lukas_Rosol,1,S-XC,1,0,0,0,0,0,1
20131030-M-Paris_Masters-R32-David_Ferrer-Lukas_Rosol,1,S-DTM,1,0,0,0,0,0,1
20131030-M-Paris_Masters-R32-David_Ferrer-Lukas_Rosol,2,F-XC,28,6,1,2,3,13,15
20131030-M-Paris_Masters-R32-David_Ferrer-Lukas_Rosol,2,F-DTM,32,5,0,1,4,9,23
20131030-M-Paris_Masters-R32-David_Ferrer-Lukas_Rosol,2,F-DTL,7,5,2,0,3,4,3
20131030-M-Paris_Masters-R32-David_Ferrer-Lukas_Rosol,2,F-IO,21,8,3,2,3,11,10
20131030-M-Paris_Masters-R32-David_Ferrer-Lukas_Rosol,2,F-II,2,1,0,0,1,0,2
20131030-M-Paris_Masters-R32-David_Ferrer-Lukas_Rosol,2,B-XC,45,8,2,1,5,22,23
20131030-M-Paris_Masters-R32-David_Ferrer-Lukas_Rosol,2,B-DTM,32,7,0,0,7,10,22
20131030-M-Paris_Masters-R32-David_Ferrer-Lukas_Rosol,2,B-DTL,4,4,2,0,2,2,2
20131030-M-Paris_Masters-R32-David_Ferrer-Lukas_Rosol,2,B-IO,1,1,0,1,0,1,0
20131030-M-Paris_Masters-R32-David_Ferrer-Lukas_Rosol,2,S-XC,13,1,0,0,1,5,8
20131030-M-Paris_Masters-R32-David_Ferrer-Lukas_Rosol,2,S-DTM,6,2,0,0,2,2,4
20131030-M-Paris_Masters-R32-David_Ferrer-Lukas_Rosol,2,S-DTL,2,0,0,0,0,1,1
20140609-M-Queens_Club-R32-Blaz_Rola-James_Ward,1,F-XC,42,12,2,1,9,16,26
20140609-M-Queens_Club-R32-Blaz_Rola-James_Ward,1,F-DTM,18,4,0,0,4,5,13
20140609-M-Queens_Club-R32-Blaz_Rola-James_Ward,1,F-DTL,5,4,0,2,2,2,3
20140609-M-Queens_Club-R32-Blaz_Rola-James_Ward,1,F-IO,9,5,2,0,3,5,4
20140609-M-Queens_Club-R32-Blaz_Rola-James_Ward,1,F-II,1,1,0,0,1,0,1
20140609-M-Queens_Club-R32-Blaz_Rola-James_Ward,1,B-XC,10,5,2,0,3,5,5
20140609-M-Queens_Club-R32-Blaz_Rola-James_Ward,1,B-DTM,18,1,0,0,1,6,12
20140609-M-Queens_Club-R32-Blaz_Rola-James_Ward,1,B-IO,1,1,0,0,1,0,1
20140609-M-Queens_Club-R32-Blaz_Rola-James_Ward,1,S-XC,9,3,0,0,3,1,8
20140609-M-Queens_Club-R32-Blaz_Rola-James_Ward,1,S-DTM,13,1,0,0,1,2,11
20140609-M-Queens_Club-R32-Blaz_Rola-James_Ward,1,S-DTL,3,1,1,0,0,2,1
20140609-M-Queens_Club-R32-Blaz_Rola-James_Ward,1,S-IO,1,0,0,0,0,1,0
20140609-M-Queens_Club-R32-Blaz_Rola-James_Ward,2,F-XC,32,6,1,0,5,20,12
20140609-M-Queens_Club-R32-Blaz_Rola-James_Ward,2,F-DTM,22,5,0,1,4,10,12
20140609-M-Queens_Club-R32-Blaz_Rola-James_Ward,2,F-IO,9,5,3,1,1,5,4
20140609-M-Queens_Club-R32-Blaz_Rola-James_Ward,2,F-II,1,0,0,0,0,0,1
20140609-M-Queens_Club-R32-Blaz_Rola-James_Ward,2,B-XC,19,4,0,2,2,11,8
20140609-M-Queens_Club-R32-Blaz_Rola-James_Ward,2,B-DTM,27,3,0,0,3,16,11
20140609-M-Queens_Club-R32-Blaz_Rola-James_Ward,2,B-DTL,3,0,0,0,0,2,1
20140609-M-Queens_Club-R32-Blaz_Rola-James_Ward,2,B-IO,2,2,1,1,0,2,0
20140609-M-Queens_Club-R32-Blaz_Rola-James_Ward,2,S-XC,2,0,0,0,0,2,0
20140609-M-Queens_Club-R32-Blaz_Rola-James_Ward,2,S-DTM,9,1,0,0,1,7,2
20140609-M-Queens_Club-R32-Blaz_Rola-James_Ward,2,S-DTL,2,1,0,1,0,2,0
20140609-M-Queens_Club-R32-Blaz_Rola-James_Ward,2,S-IO,2,0,0,0,0,1,1
20140116-M-Australian_Open-R64-Thanasi_Kokkinakis-Rafael_Nadal,1,F-XC,28,7,1,2,4,11,17
20140116-M-Australian_Open-R64-Thanasi_Kokkinakis-Rafael_Nadal,1,F-DTM,26,3,0,0,3,7,19
20140116-M-Australian_Open-R64-Thanasi_Kokkinakis-Rafael_Nadal,1,F-DTL,13,6,4,1,1,8,5
20140116-M-Australian_Open-R64-Thanasi_Kokkinakis-Rafael_Nadal,1,F-IO,21,7,2,2,3,12,9
20140116-M-Australian_Open-R64-Thanasi_Kokkinakis-Rafael_Nadal,1,F-II,6,0,0,0,0,4,2
20140116-M-Australian_Open-R64-Thanasi_Kokkinakis-Rafael_Nadal,1,B-XC,18,3,1,0,2,6,12
20140116-M-Australian_Open-R64-Thanasi_Kokkinakis-Rafael_Nadal,1,B-DTM,17,2,0,0,2,5,12
20140116-M-Australian_Open-R64-Thanasi_Kokkinakis-Rafael_Nadal,1,B-DTL,6,3,0,0,3,2,4
20140116-M-Australian_Open-R64-Thanasi_Kokkinakis-Rafael_Nadal,1,B-IO,7,2,1,1,0,5,2
20140116-M-Australian_Open-R64-Thanasi_Kokkinakis-Rafael_Nadal,1,S-XC,1,0,0,0,0,0,1
20140116-M-Australian_Open-R64-Thanasi_Kokkinakis-Rafael_Nadal,1,S-DTM,1,0,0,0,0,0,1
20140116-M-Australian_Open-R64-Thanasi_Kokkinakis-Rafael_Nadal,2,F-XC,38,9,2,0,7,22,16
20140116-M-Australian_Open-R64-Thanasi_Kokkinakis-Rafael_Nadal,2,F-DTM,29,4,1,0,3,17,12
20140116-M-Australian_Open-R64-Thanasi_Kokkinakis-Rafael_Nadal,2,F-DTL,15,11,6,2,3,11,4
20140116-M-Australian_Open-R64-Thanasi_Kokkinakis-Rafael_Nadal,2,F-IO,19,11,9,1,1,16,3
20140116-M-Australian_Open-R64-Thanasi_Kokkinakis-Rafael_Nadal,2,F-II,3,0,0,0,0,3,0
20140116-M-Australian_Open-R64-Thanasi_Kokkinakis-Rafael_Nadal,2,B-XC,15,4,0,2,2,8,7
20140116-M-Australian_Open-R64-Thanasi_Kokkinakis-Rafael_Nadal,2,B-DTM,8,1,0,0,1,2,6
20140116-M-Australian_Open-R64-Thanasi_Kokkinakis-Rafael_Nadal,2,B-DTL,7,3,3,0,0,5,2
20140116-M-Australian_Open-R64-Thanasi_Kokkinakis-Rafael_Nadal,2,B-IO,2,0,0,0,0,1,1
20140116-M-Australian_Open-R64-Thanasi_Kokkinakis-Rafael_Nadal,2,S-XC,5,0,0,0,0,3,2
20140116-M-Australian_Open-R64-Thanasi_Kokkinakis-Rafael_Nadal,2,S-DTM,6,0,0,0,0,3,3
20140116-M-Australian_Open-R64-Thanasi_Kokkinakis-Rafael_Nadal,2,S-DTL,2,0,0,0,0,1,1
20140417-M-Monte_Carlo_Masters-R16-Andreas_Seppi-Rafael_Nadal,1,F-XC,41,4,0,0,4,16,25
20140417-M-Monte_Carlo_Masters-R16-Andreas_Seppi-Rafael_Nadal,1,F-DTM,21,2,0,0,2,7,14
20140417-M-Monte_Carlo_Masters-R16-Andreas_Seppi-Rafael_Nadal,1,F-DTL,8,4,1,0,3,3,5
20140417-M-Monte_Carlo_Masters-R16-Andreas_Seppi-Rafael_Nadal,1,F-IO,13,4,0,3,1,7,6
20140417-M-Monte_Carlo_Masters-R16-Andreas_Seppi-Rafael_Nadal,1,F-II,3,2,1,0,1,1,2
20140417-M-Monte_Carlo_Masters-R16-Andreas_Seppi-Rafael_Nadal,1,B-XC,31,5,1,0,4,13,18
20140417-M-Monte_Carlo_Masters-R16-Andreas_Seppi-Rafael_Nadal,1,B-DTM,21,1,0,0,1,7,14
20140417-M-Monte_Carlo_Masters-R16-Andreas_Seppi-Rafael_Nadal,1,B-DTL,8,0,0,0,0,2,6
20140417-M-Monte_Carlo_Masters-R16-Andreas_Seppi-Rafael_Nadal,1,B-IO,2,1,0,0,1,1,1
20140417-M-Monte_Carlo_Masters-R16-Andreas_Seppi-Rafael_Nadal,1,S-XC,5,2,0,0,2,0,5
20140417-M-Monte_Carlo_Masters-R16-Andreas_Seppi-Rafael_Nadal,1,S-DTM,5,0,0,0,0,2,3
20140417-M-Monte_Carlo_Masters-R16-Andreas_Seppi-Rafael_Nadal,2,F-XC,60,12,5,3,4,39,21
20140417-M-Monte_Carlo_Masters-R16-Andreas_Seppi-Rafael_Nadal,2,F-DTM,10,1,0,0,1,4,6
20140417-M-Monte_Carlo_Masters-R16-Andreas_Seppi-Rafael_Nadal,2,F-DTL,18,10,4,3,3,14,4
20140417-M-Monte_Carlo_Masters-R16-Andreas_Seppi-Rafael_Nadal,2,F-IO,23,9,4,4,1,22,1
20140417-M-Monte_Carlo_Masters-R16-Andreas_Seppi-Rafael_Nadal,2,F-II,6,2,1,1,0,6,0
20140417-M-Monte_Carlo_Masters-R16-Andreas_Seppi-Rafael_Nadal,2,B-XC,18,2,0,1,1,10,8
20140417-M-Monte_Carlo_Masters-R16-Andreas_Seppi-Rafael_Nadal,2,B-DTM,15,1,0,0,1,5,10
20140417-M-Monte_Carlo_Masters-R16-Andreas_Seppi-Rafael_Nadal,2,B-DTL,9,1,0,0,1,5,4
20140417-M-Monte_Carlo_Masters-R16-Andreas_Seppi-Rafael_Nadal,2,B-IO,6,4,0,0,4,1,5
20140417-M-Monte_Carlo_Masters-R16-Andreas_Seppi-Rafael_Nadal,2,S-XC,2,0,0,0,0,1,1
20140417-M-Monte_Carlo_Masters-R16-Andreas_Seppi-Rafael_Nadal,2,S-DTM,2,0,0,0,0,0,2
20140417-M-Monte_Carlo_Masters-R16-Andreas_Seppi-Rafael_Nadal,2,S-DTL,3,1,0,0,1,1,2
20140528-M-Roland_Garros-R64-Roger_Federer-Diego_Sebastian_Schwartzman,1,F-XC,29,7,1,1,5,17,12
20140528-M-Roland_Garros-R64-Roger_Federer-Diego_Sebastian_Schwartzman,1,F-DTM,30,5,1,0,4,15,15
20140528-M-Roland_Garros-R64-Roger_Federer-Diego_Sebastian_Schwartzman,1,F-DTL,12,6,3,2,1,8,4
20140528-M-Roland_Garros-R64-Roger_Federer-Diego_Sebastian_Schwartzman,1,F-IO,20,5,1,0,4,11,9
20140528-M-Roland_Garros-R64-Roger_Federer-Diego_Sebastian_Schwartzman,1,F-II,3,1,0,1,0,3,0
20140528-M-Roland_Garros-R64-Roger_Federer-Diego_Sebastian_Schwartzman,1,B-XC,47,7,3,0,4,25,22
20140528-M-Roland_Garros-R64-Roger_Federer-Diego_Sebastian_Schwartzman,1,B-DTM,52,8,1,0,7,20,32
20140528-M-Roland_Garros-R64-Roger_Federer-Diego_Sebastian_Schwartzman,1,B-DTL,7,5,1,1,3,3,4
20140528-M-Roland_Garros-R64-Roger_Federer-Diego_Sebastian_Schwartzman,1,B-IO,4,1,0,0,1,2,2
20140528-M-Roland_Garros-R64-Roger_Federer-Diego_Sebastian_Schwartzman,1,S-XC,13,0,0,0,0,5,8
20140528-M-Roland_Garros-R64-Roger_Federer-Diego_Sebastian_Schwartzman,1,S-DTM,8,1,0,0,1,0,8
20140528-M-Roland_Garros-R64-Roger_Federer-Diego_Sebastian_Schwartzman,1,S-DTL,1,0,0,0,0,0,1
20140528-M-Roland_Garros-R64-Roger_Federer-Diego_Sebastian_Schwartzman,2,F-XC,30,5,1,0,4,11,19
20140528-M-Roland_Garros-R64-Roger_Federer-Diego_Sebastian_Schwartzman,2,F-DTM,45,6,0,0,6,20,25
20140528-M-Roland_Garros-R64-Roger_Federer-Diego_Sebastian_Schwartzman,2,F-DTL,10,6,1,1,4,3,7
20140528-M-Roland_Garros-R64-Roger_Federer-Diego_Sebastian_Schwartzman,2,F-IO,48,8,1,1,6,23,25
20140528-M-Roland_Garros-R64-Roger_Federer-Diego_Sebastian_Schwartzman,2,F-II,1,0,0,0,0,1,0
20140528-M-Roland_Garros-R64-Roger_Federer-Diego_Sebastian_Schwartzman,2,B-XC,58,10,4,1,5,36,22
20140528-M-Roland_Garros-R64-Roger_Federer-Diego_Sebastian_Schwartzman,2,B-DTM,37,9,0,1,8,15,22
20140528-M-Roland_Garros-R64-Roger_Federer-Diego_Sebastian_Schwartzman,2,B-DTL,6,5,4,0,1,5,1
20140528-M-Roland_Garros-R64-Roger_Federer-Diego_Sebastian_Schwartzman,2,B-IO,4,2,0,1,1,3,1
20140528-M-Roland_Garros-R64-Roger_Federer-Diego_Sebastian_Schwartzman,2,S-XC,4,2,0,1,1,1,3
20130607-M-French_Open-SF-Novak_Djokovic-Rafael_Nadal,1,F-XC,122,24,4,8,12,57,65
20130607-M-French_Open-SF-Novak_Djokovic-Rafael_Nadal,1,F-DTM,98,13,0,2,11,50,48
20130607-M-French_Open-SF-Novak_Djokovic-Rafael_Nadal,1,F-DTL,11,5,2,1,2,6,5
20130607-M-French_Open-SF-Novak_Djokovic-Rafael_Nadal,1,F-IO,77,22,13,3,6,41,36
20130607-M-French_Open-SF-Novak_Djokovic-Rafael_Nadal,1,F-II,4,1,1,0,0,4,0
20130607-M-French_Open-SF-Novak_Djokovic-Rafael_Nadal,1,B-XC,80,19,4,6,9,37,43
20130607-M-French_Open-SF-Novak_Djokovic-Rafael_Nadal,1,B-DTM,114,13,0,2,11,49,65
20130607-M-French_Open-SF-Novak_Djokovic-Rafael_Nadal,1,B-DTL,35,6,3,0,3,16,19
20130607-M-French_Open-SF-Novak_Djokovic-Rafael_Nadal,1,B-IO,22,10,1,1,8,8,14
20130607-M-French_Open-SF-Novak_Djokovic-Rafael_Nadal,1,S-DTM,1,0,0,0,0,1,0
20130607-M-French_Open-SF-Novak_Djokovic-Rafael_Nadal,1,S-DTL,5,0,0,0,0,3,2
20130607-M-French_Open-SF-Novak_Djokovic-Rafael_Nadal,1,S-IO,1,1,0,0,1,0,1
20130607-M-French_Open-SF-Novak_Djokovic-Rafael_Nadal,2,F-XC,122,18,5,5,8,74,48
20130607-M-French_Open-SF-Novak_Djokovic-Rafael_Nadal,2,F-DTM,103,8,0,1,7,50,53
20130607-M-French_Open-SF-Novak_Djokovic-Rafael_Nadal,2,F-DTL,20,13,11,0,2,16,4
20130607-M-French_Open-SF-Novak_Djokovic-Rafael_Nadal,2,F-IO,62,24,17,3,4,43,19
20130607-M-French_Open-SF-Novak_Djokovic-Rafael_Nadal,2,F-II,6,3,0,1,2,2,4
20130607-M-French_Open-SF-Novak_Djokovic-Rafael_Nadal,2,B-XC,56,16,7,4,5,34,22
20130607-M-French_Open-SF-Novak_Djokovic-Rafael_Nadal,2,B-DTM,93,4,0,0,4,48,45
20130607-M-French_Open-SF-Novak_Djokovic-Rafael_Nadal,2,B-DTL,35,6,3,3,0,21,14
20130607-M-French_Open-SF-Novak_Djokovic-Rafael_Nadal,2,B-IO,24,4,1,1,2,11,13
20130607-M-French_Open-SF-Novak_Djokovic-Rafael_Nadal,2,B-II,2,1,1,0,0,2,0
20130607-M-French_Open-SF-Novak_Djokovic-Rafael_Nadal,2,S-XC,1,0,0,0,0,0,1
20130607-M-French_Open-SF-Novak_Djokovic-Rafael_Nadal,2,S-DTM,27,2,0,0,2,10,17
20130607-M-French_Open-SF-Novak_Djokovic-Rafael_Nadal,2,S-DTL,10,0,0,0,0,5,5
20140604-M-Roland_Garros-QF-David_Ferrer-Rafael_Nadal,1,F-XC,123,17,3,3,11,55,68
20140604-M-Roland_Garros-QF-David_Ferrer-Rafael_Nadal,1,F-DTM,38,4,0,0,4,14,24
20140604-M-Roland_Garros-QF-David_Ferrer-Rafael_Nadal,1,F-DTL,10,4,0,2,2,6,4
20140604-M-Roland_Garros-QF-David_Ferrer-Rafael_Nadal,1,F-IO,39,26,10,4,12,20,19
20140604-M-Roland_Garros-QF-David_Ferrer-Rafael_Nadal,1,F-II,18,6,2,0,4,10,8
20140604-M-Roland_Garros-QF-David_Ferrer-Rafael_Nadal,1,B-XC,29,3,0,1,2,14,15
20140604-M-Roland_Garros-QF-David_Ferrer-Rafael_Nadal,1,B-DTM,43,3,0,0,3,17,26
20140604-M-Roland_Garros-QF-David_Ferrer-Rafael_Nadal,1,B-DTL,36,10,1,1,8,16,20
20140604-M-Roland_Garros-QF-David_Ferrer-Rafael_Nadal,1,B-IO,8,2,0,1,1,5,3
20140604-M-Roland_Garros-QF-David_Ferrer-Rafael_Nadal,1,S-DTM,2,0,0,0,0,0,2
20140604-M-Roland_Garros-QF-David_Ferrer-Rafael_Nadal,2,F-XC,73,7,2,4,1,47,26
20140604-M-Roland_Garros-QF-David_Ferrer-Rafael_Nadal,2,F-DTM,36,2,0,0,2,15,21
20140604-M-Roland_Garros-QF-David_Ferrer-Rafael_Nadal,2,F-DTL,10,3,1,1,1,4,6
20140604-M-Roland_Garros-QF-David_Ferrer-Rafael_Nadal,2,F-IO,41,18,7,8,3,27,14
20140604-M-Roland_Garros-QF-David_Ferrer-Rafael_Nadal,2,F-II,18,3,2,0,1,8,10
20140604-M-Roland_Garros-QF-David_Ferrer-Rafael_Nadal,2,B-XC,56,13,2,3,8,26,30
20140604-M-Roland_Garros-QF-David_Ferrer-Rafael_Nadal,2,B-DTM,52,5,0,2,3,29,23
20140604-M-Roland_Garros-QF-David_Ferrer-Rafael_Nadal,2,B-DTL,35,6,2,1,3,19,16
20140604-M-Roland_Garros-QF-David_Ferrer-Rafael_Nadal,2,B-IO,3,1,0,0,1,1,2
20140604-M-Roland_Garros-QF-David_Ferrer-Rafael_Nadal,2,S-XC,4,0,0,0,0,2,2
20140604-M-Roland_Garros-QF-David_Ferrer-Rafael_Nadal,2,S-DTM,3,0,0,0,0,1,2
20140604-M-Roland_Garros-QF-David_Ferrer-Rafael_Nadal,2,S-DTL,6,0,0,0,0,2,4
20140601-M-Roland_Garros-R16-Rafael_Nadal-Dusan_Lajovic,1,F-XC,57,9,1,7,1,50,7
20140601-M-Roland_Garros-R16-Rafael_Nadal-Dusan_Lajovic,1,F-DTM,24,2,1,1,0,19,5
20140601-M-Roland_Garros-R16-Rafael_Nadal-Dusan_Lajovic,1,F-DTL,9,5,2,3,0,8,1
20140601-M-Roland_Garros-R16-Rafael_Nadal-Dusan_Lajovic,1,F-IO,24,10,6,2,2,19,5
20140601-M-Roland_Garros-R16-Rafael_Nadal-Dusan_Lajovic,1,F-II,8,1,0,1,0,6,2
20140601-M-Roland_Garros-R16-Rafael_Nadal-Dusan_Lajovic,1,B-XC,35,8,1,2,5,27,8
20140601-M-Roland_Garros-R16-Rafael_Nadal-Dusan_Lajovic,1,B-DTM,30,2,0,0,2,21,9
20140601-M-Roland_Garros-R16-Rafael_Nadal-Dusan_Lajovic,1,B-DTL,15,2,0,2,0,14,1
20140601-M-Roland_Garros-R16-Rafael_Nadal-Dusan_Lajovic,1,B-IO,6,2,0,1,1,3,3
20140601-M-Roland_Garros-R16-Rafael_Nadal-Dusan_Lajovic,1,S-DTM,3,0,0,0,0,1,2
20140601-M-Roland_Garros-R16-Rafael_Nadal-Dusan_Lajovic,1,S-DTL,2,0,0,0,0,1,1
20140601-M-Roland_Garros-R16-Rafael_Nadal-Dusan_Lajovic,1,S-IO,1,1,0,0,1,0,1
20140601-M-Roland_Garros-R16-Rafael_Nadal-Dusan_Lajovic,2,F-XC,63,7,1,1,5,14,49
20140601-M-Roland_Garros-R16-Rafael_Nadal-Dusan_Lajovic,2,F-DTM,22,0,0,0,0,2,20
20140601-M-Roland_Garros-R16-Rafael_Nadal-Dusan_Lajovic,2,F-DTL,5,2,0,1,1,1,4
20140601-M-Roland_Garros-R16-Rafael_Nadal-Dusan_Lajovic,2,F-IO,11,2,0,0,2,2,9
20140601-M-Roland_Garros-R16-Rafael_Nadal-Dusan_Lajovic,2,F-II,4,2,0,0,2,1,3
20140601-M-Roland_Garros-R16-Rafael_Nadal-Dusan_Lajovic,2,B-XC,24,6,1,2,3,7,17
20140601-M-Roland_Garros-R16-Rafael_Nadal-Dusan_Lajovic,2,B-DTM,45,6,0,0,6,7,38
20140601-M-Roland_Garros-R16-Rafael_Nadal-Dusan_Lajovic,2,B-DTL,20,5,1,0,4,2,18
20140601-M-Roland_Garros-R16-Rafael_Nadal-Dusan_Lajovic,2,B-IO,8,1,0,0,1,2,6
20140601-M-Roland_Garros-R16-Rafael_Nadal-Dusan_Lajovic,2,B-II,1,0,0,0,0,1,0
20140601-M-Roland_Garros-R16-Rafael_Nadal-Dusan_Lajovic,2,S-XC,2,0,0,0,0,0,2
20140601-M-Roland_Garros-R16-Rafael_Nadal-Dusan_Lajovic,2,S-DTM,2,0,0,0,0,0,2
20140601-M-Roland_Garros-R16-Rafael_Nadal-Dusan_Lajovic,2,S-DTL,1,0,0,0,0,0,1
20140601-M-Roland_Garros-R16-Rafael_Nadal-Dusan_Lajovic,2,S-IO,1,0,0,0,0,0,1
20140531-M-Roland_Garros-R32-Leonardo_Mayer-Rafael_Nadal,1,F-XC,72,13,4,4,5,31,41
20140531-M-Roland_Garros-R32-Leonardo_Mayer-Rafael_Nadal,1,F-DTM,23,0,0,0,0,7,16
20140531-M-Roland_Garros-R32-Leonardo_Mayer-Rafael_Nadal,1,F-DTL,7,3,0,0,3,0,7
20140531-M-Roland_Garros-R32-Leonardo_Mayer-Rafael_Nadal,1,F-IO,25,14,3,3,8,9,16
20140531-M-Roland_Garros-R32-Leonardo_Mayer-Rafael_Nadal,1,F-II,11,4,2,1,1,5,6
20140531-M-Roland_Garros-R32-Leonardo_Mayer-Rafael_Nadal,1,B-XC,33,14,1,6,7,11,22
20140531-M-Roland_Garros-R32-Leonardo_Mayer-Rafael_Nadal,1,B-DTM,27,3,0,0,3,6,21
20140531-M-Roland_Garros-R32-Leonardo_Mayer-Rafael_Nadal,1,B-DTL,7,4,1,2,1,5,2
20140531-M-Roland_Garros-R32-Leonardo_Mayer-Rafael_Nadal,1,B-IO,7,3,2,0,1,3,4
20140531-M-Roland_Garros-R32-Leonardo_Mayer-Rafael_Nadal,1,S-DTM,4,1,0,0,1,0,4
20140531-M-Roland_Garros-R32-Leonardo_Mayer-Rafael_Nadal,1,S-DTL,4,0,0,0,0,1,3
20140531-M-Roland_Garros-R32-Leonardo_Mayer-Rafael_Nadal,2,F-XC,64,10,3,7,0,52,12
20140531-M-Roland_Garros-R32-Leonardo_Mayer-Rafael_Nadal,2,F-DTM,16,1,0,0,1,11,5
20140531-M-Roland_Garros-R32-Leonardo_Mayer-Rafael_Nadal,2,F-DTL,16,8,6,0,2,9,7
20140531-M-Roland_Garros-R32-Leonardo_Mayer-Rafael_Nadal,2,F-IO,27,12,5,5,2,22,5
20140531-M-Roland_Garros-R32-Leonardo_Mayer-Rafael_Nadal,2,F-II,5,1,1,0,0,4,1
20140531-M-Roland_Garros-R32-Leonardo_Mayer-Rafael_Nadal,2,B-XC,39,11,5,4,2,25,14
20140531-M-Roland_Garros-R32-Leonardo_Mayer-Rafael_Nadal,2,B-DTM,28,1,0,1,0,18,10
20140531-M-Roland_Garros-R32-Leonardo_Mayer-Rafael_Nadal,2,B-DTL,9,2,0,1,1,4,5
20140531-M-Roland_Garros-R32-Leonardo_Mayer-Rafael_Nadal,2,B-IO,5,1,1,0,0,2,3
20140531-M-Roland_Garros-R32-Leonardo_Mayer-Rafael_Nadal,2,S-XC,2,0,0,0,0,0,2
20140531-M-Roland_Garros-R32-Leonardo_Mayer-Rafael_Nadal,2,S-DTM,5,1,0,0,1,3,2
20140531-M-Roland_Garros-R32-Leonardo_Mayer-Rafael_Nadal,2,S-DTL,6,2,0,1,1,2,4
20140606-M-Roland_Garros-SF-Rafael_Nadal-Andy_Murray,1,F-XC,39,6,2,4,0,27,12
20140606-M-Roland_Garros-SF-Rafael_Nadal-Andy_Murray,1,F-DTM,16,2,0,0,2,6,10
20140606-M-Roland_Garros-SF-Rafael_Nadal-Andy_Murray,1,F-DTL,11,5,3,2,0,8,3
20140606-M-Roland_Garros-SF-Rafael_Nadal-Andy_Murray,1,F-IO,39,21,12,6,3,31,8
20140606-M-Roland_Garros-SF-Rafael_Nadal-Andy_Murray,1,F-II,9,2,0,2,0,7,2
20140606-M-Roland_Garros-SF-Rafael_Nadal-Andy_Murray,1,B-XC,23,0,0,0,0,14,9
20140606-M-Roland_Garros-SF-Rafael_Nadal-Andy_Murray,1,B-DTM,23,3,0,0,3,9,14
20140606-M-Roland_Garros-SF-Rafael_Nadal-Andy_Murray,1,B-DTL,9,1,0,0,1,5,4
20140606-M-Roland_Garros-SF-Rafael_Nadal-Andy_Murray,1,B-IO,1,0,0,0,0,1,0
20140606-M-Roland_Garros-SF-Rafael_Nadal-Andy_Murray,1,S-XC,2,0,0,0,0,1,1
20140606-M-Roland_Garros-SF-Rafael_Nadal-Andy_Murray,1,S-DTM,1,0,0,0,0,0,1
20140606-M-Roland_Garros-SF-Rafael_Nadal-Andy_Murray,1,S-DTL,4,1,1,0,0,2,2
20140606-M-Roland_Garros-SF-Rafael_Nadal-Andy_Murray,1,S-IO,1,1,0,1,0,1,0
20140606-M-Roland_Garros-SF-Rafael_Nadal-Andy_Murray,2,F-XC,59,7,1,2,4,31,28
20140606-M-Roland_Garros-SF-Rafael_Nadal-Andy_Murray,2,F-DTM,19,2,0,1,1,6,13
20140606-M-Roland_Garros-SF-Rafael_Nadal-Andy_Murray,2,F-DTL,11,7,2,0,5,5,6
20140606-M-Roland_Garros-SF-Rafael_Nadal-Andy_Murray,2,F-IO,16,7,3,1,3,9,7
20140606-M-Roland_Garros-SF-Rafael_Nadal-Andy_Murray,2,F-II,1,1,0,1,0,1,0
20140606-M-Roland_Garros-SF-Rafael_Nadal-Andy_Murray,2,B-XC,16,6,0,3,3,6,10
20140606-M-Roland_Garros-SF-Rafael_Nadal-Andy_Murray,2,B-DTM,29,1,0,0,1,9,20
20140606-M-Roland_Garros-SF-Rafael_Nadal-Andy_Murray,2,B-DTL,14,4,1,0,3,5,9
20140606-M-Roland_Garros-SF-Rafael_Nadal-Andy_Murray,2,B-IO,7,1,0,0,1,2,5
20140606-M-Roland_Garros-SF-Rafael_Nadal-Andy_Murray,2,B-II,1,0,0,0,0,0,1
20140606-M-Roland_Garros-SF-Rafael_Nadal-Andy_Murray,2,S-XC,2,0,0,0,0,1,1
20140606-M-Roland_Garros-SF-Rafael_Nadal-Andy_Murray,2,S-DTM,2,0,0,0,0,1,1
20140606-M-Roland_Garros-SF-Rafael_Nadal-Andy_Murray,2,S-DTL,1,0,0,0,0,1,0
20140608-M-Roland_Garros-F-Novak_Djokovic-Rafael_Nadal,1,F-XC,80,11,5,3,3,45,35
20140608-M-Roland_Garros-F-Novak_Djokovic-Rafael_Nadal,1,F-DTM,27,1,0,0,1,12,15
20140608-M-Roland_Garros-F-Novak_Djokovic-Rafael_Nadal,1,F-DTL,17,10,5,2,3,10,7
20140608-M-Roland_Garros-F-Novak_Djokovic-Rafael_Nadal,1,F-IO,59,16,6,4,6,37,22
20140608-M-Roland_Garros-F-Novak_Djokovic-Rafael_Nadal,1,F-II,3,1,0,0,1,0,3
20140608-M-Roland_Garros-F-Novak_Djokovic-Rafael_Nadal,1,B-XC,69,19,5,4,10,34,35
20140608-M-Roland_Garros-F-Novak_Djokovic-Rafael_Nadal,1,B-DTM,43,3,0,1,2,25,18
20140608-M-Roland_Garros-F-Novak_Djokovic-Rafael_Nadal,1,B-DTL,45,11,2,1,8,18,27
20140608-M-Roland_Garros-F-Novak_Djokovic-Rafael_Nadal,1,B-IO,12,2,0,1,1,7,5
20140608-M-Roland_Garros-F-Novak_Djokovic-Rafael_Nadal,1,S-XC,1,0,0,0,0,0,1
20140608-M-Roland_Garros-F-Novak_Djokovic-Rafael_Nadal,1,S-DTM,1,0,0,0,0,1,0
20140608-M-Roland_Garros-F-Novak_Djokovic-Rafael_Nadal,2,F-XC,108,14,3,8,3,54,54
20140608-M-Roland_Garros-F-Novak_Djokovic-Rafael_Nadal,2,F-DTM,27,1,0,0,1,11,16
20140608-M-Roland_Garros-F-Novak_Djokovic-Rafael_Nadal,2,F-DTL,34,17,10,3,4,24,10
20140608-M-Roland_Garros-F-Novak_Djokovic-Rafael_Nadal,2,F-IO,44,21,12,1,8,26,18
20140608-M-Roland_Garros-F-Novak_Djokovic-Rafael_Nadal,2,F-II,8,3,1,1,1,4,4
20140608-M-Roland_Garros-F-Novak_Djokovic-Rafael_Nadal,2,B-XC,58,15,3,5,7,30,28
20140608-M-Roland_Garros-F-Novak_Djokovic-Rafael_Nadal,2,B-DTM,35,2,0,0,2,10,25
20140608-M-Roland_Garros-F-Novak_Djokovic-Rafael_Nadal,2,B-DTL,23,6,2,1,3,12,11
20140608-M-Roland_Garros-F-Novak_Djokovic-Rafael_Nadal,2,B-IO,6,4,1,1,2,4,2
20140608-M-Roland_Garros-F-Novak_Djokovic-Rafael_Nadal,2,S-XC,3,0,0,0,0,2,1
20140608-M-Roland_Garros-F-Novak_Djokovic-Rafael_Nadal,2,S-DTM,5,0,0,0,0,3,2
20140608-M-Roland_Garros-F-Novak_Djokovic-Rafael_Nadal,2,S-DTL,11,1,0,1,0,7,4
20140608-M-Roland_Garros-F-Novak_Djokovic-Rafael_Nadal,2,S-II,1,0,0,0,0,0,1
20140526-M-Roland_Garros-R128-Robby_Ginepri-Rafael_Nadal,1,F-XC,60,8,1,1,6,25,35
20140526-M-Roland_Garros-R128-Robby_Ginepri-Rafael_Nadal,1,F-DTM,29,1,0,1,0,10,19
20140526-M-Roland_Garros-R128-Robby_Ginepri-Rafael_Nadal,1,F-DTL,22,11,2,3,6,11,11
20140526-M-Roland_Garros-R128-Robby_Ginepri-Rafael_Nadal,1,F-IO,28,13,3,2,8,12,16
20140526-M-Roland_Garros-R128-Robby_Ginepri-Rafael_Nadal,1,F-II,13,4,2,0,2,6,7
20140526-M-Roland_Garros-R128-Robby_Ginepri-Rafael_Nadal,1,B-XC,32,4,0,1,3,16,16
20140526-M-Roland_Garros-R128-Robby_Ginepri-Rafael_Nadal,1,B-DTM,35,3,0,0,3,14,21
20140526-M-Roland_Garros-R128-Robby_Ginepri-Rafael_Nadal,1,B-DTL,20,4,1,0,3,5,15
20140526-M-Roland_Garros-R128-Robby_Ginepri-Rafael_Nadal,1,B-IO,8,3,1,1,1,7,1
20140526-M-Roland_Garros-R128-Robby_Ginepri-Rafael_Nadal,1,S-XC,1,0,0,0,0,0,1
20140526-M-Roland_Garros-R128-Robby_Ginepri-Rafael_Nadal,1,S-DTM,3,0,0,0,0,1,2
20140526-M-Roland_Garros-R128-Robby_Ginepri-Rafael_Nadal,1,S-DTL,4,1,0,0,1,0,4
20140526-M-Roland_Garros-R128-Robby_Ginepri-Rafael_Nadal,1,S-IO,1,0,0,0,0,0,1
20140526-M-Roland_Garros-R128-Robby_Ginepri-Rafael_Nadal,2,F-XC,67,11,4,4,3,43,24
20140526-M-Roland_Garros-R128-Robby_Ginepri-Rafael_Nadal,2,F-DTM,16,1,0,0,1,7,9
20140526-M-Roland_Garros-R128-Robby_Ginepri-Rafael_Nadal,2,F-DTL,18,9,3,3,3,11,7
20140526-M-Roland_Garros-R128-Robby_Ginepri-Rafael_Nadal,2,F-IO,27,9,5,1,3,17,10
20140526-M-Roland_Garros-R128-Robby_Ginepri-Rafael_Nadal,2,F-II,12,3,2,1,0,8,4
20140526-M-Roland_Garros-R128-Robby_Ginepri-Rafael_Nadal,2,B-XC,40,6,2,3,1,22,18
20140526-M-Roland_Garros-R128-Robby_Ginepri-Rafael_Nadal,2,B-DTM,25,3,0,0,3,13,12
20140526-M-Roland_Garros-R128-Robby_Ginepri-Rafael_Nadal,2,B-DTL,9,2,1,1,0,6,3
20140526-M-Roland_Garros-R128-Robby_Ginepri-Rafael_Nadal,2,B-IO,1,0,0,0,0,1,0
20140526-M-Roland_Garros-R128-Robby_Ginepri-Rafael_Nadal,2,S-XC,3,0,0,0,0,3,0
20140526-M-Roland_Garros-R128-Robby_Ginepri-Rafael_Nadal,2,S-DTM,11,0,0,0,0,6,5
20140526-M-Roland_Garros-R128-Robby_Ginepri-Rafael_Nadal,2,S-DTL,3,0,0,0,0,2,1
20140526-M-Roland_Garros-R128-Robby_Ginepri-Rafael_Nadal,2,S-IO,1,0,0,0,0,1,0
20140529-M-French_Open-R64-Rafael_Nadal-Dominic_Thiem,1,F-XC,85,9,1,4,4,57,28
20140529-M-French_Open-R64-Rafael_Nadal-Dominic_Thiem,1,F-DTM,30,3,0,0,3,8,22
20140529-M-French_Open-R64-Rafael_Nadal-Dominic_Thiem,1,F-DTL,22,10,3,5,2,17,5
20140529-M-French_Open-R64-Rafael_Nadal-Dominic_Thiem,1,F-IO,31,8,1,4,3,17,14
20140529-M-French_Open-R64-Rafael_Nadal-Dominic_Thiem,1,F-II,11,1,1,0,0,8,3
20140529-M-French_Open-R64-Rafael_Nadal-Dominic_Thiem,1,B-XC,49,5,1,3,1,34,15
20140529-M-French_Open-R64-Rafael_Nadal-Dominic_Thiem,1,B-DTM,33,1,1,0,0,19,14
20140529-M-French_Open-R64-Rafael_Nadal-Dominic_Thiem,1,B-DTL,24,3,0,1,2,14,10
20140529-M-French_Open-R64-Rafael_Nadal-Dominic_Thiem,1,B-IO,3,0,0,0,0,1,2
20140529-M-French_Open-R64-Rafael_Nadal-Dominic_Thiem,1,S-DTM,4,1,0,1,0,1,3
20140529-M-French_Open-R64-Rafael_Nadal-Dominic_Thiem,1,S-DTL,5,0,0,0,0,3,2
20140529-M-French_Open-R64-Rafael_Nadal-Dominic_Thiem,1,S-IO,1,1,0,1,0,1,0
20140529-M-French_Open-R64-Rafael_Nadal-Dominic_Thiem,2,F-XC,81,6,2,1,3,38,43
20140529-M-French_Open-R64-Rafael_Nadal-Dominic_Thiem,2,F-DTM,30,4,0,2,2,14,16
20140529-M-French_Open-R64-Rafael_Nadal-Dominic_Thiem,2,F-DTL,18,8,3,0,5,9,9
20140529-M-French_Open-R64-Rafael_Nadal-Dominic_Thiem,2,F-IO,37,13,8,2,3,21,16
20140529-M-French_Open-R64-Rafael_Nadal-Dominic_Thiem,2,F-II,9,1,1,0,0,3,6
20140529-M-French_Open-R64-Rafael_Nadal-Dominic_Thiem,2,B-XC,48,14,4,2,8,19,29
20140529-M-French_Open-R64-Rafael_Nadal-Dominic_Thiem,2,B-DTM,41,3,0,0,3,10,31
20140529-M-French_Open-R64-Rafael_Nadal-Dominic_Thiem,2,B-DTL,20,9,1,1,7,5,15
20140529-M-French_Open-R64-Rafael_Nadal-Dominic_Thiem,2,B-IO,2,0,0,0,0,1,1
20140529-M-French_Open-R64-Rafael_Nadal-Dominic_Thiem,2,S-XC,2,0,0,0,0,0,2
20140529-M-French_Open-R64-Rafael_Nadal-Dominic_Thiem,2,S-DTM,4,0,0,0,0,3,1
20130907-M-US_Open-SF-Richard_Gasquet-Rafael_Nadal,1,F-XC,68,3,0,0,3,21,47
20130907-M-US_Open-SF-Richard_Gasquet-Rafael_Nadal,1,F-DTM,24,2,0,0,2,5,19
20130907-M-US_Open-SF-Richard_Gasquet-Rafael_Nadal,1,F-DTL,10,3,0,0,3,2,8
20130907-M-US_Open-SF-Richard_Gasquet-Rafael_Nadal,1,F-IO,3,0,0,0,0,2,1
20130907-M-US_Open-SF-Richard_Gasquet-Rafael_Nadal,1,B-XC,49,12,2,3,7,23,26
20130907-M-US_Open-SF-Richard_Gasquet-Rafael_Nadal,1,B-DTM,25,5,0,1,4,9,16
20130907-M-US_Open-SF-Richard_Gasquet-Rafael_Nadal,1,B-DTL,8,3,1,1,1,4,4
20130907-M-US_Open-SF-Richard_Gasquet-Rafael_Nadal,1,B-IO,7,0,0,0,0,3,4
20130907-M-US_Open-SF-Richard_Gasquet-Rafael_Nadal,1,B-II,2,0,0,0,0,0,2
20130907-M-US_Open-SF-Richard_Gasquet-Rafael_Nadal,1,S-XC,9,0,0,0,0,2,7
20130907-M-US_Open-SF-Richard_Gasquet-Rafael_Nadal,1,S-DTM,7,0,0,0,0,2,5
20130907-M-US_Open-SF-Richard_Gasquet-Rafael_Nadal,1,S-DTL,1,0,0,0,0,1,0
20130907-M-US_Open-SF-Richard_Gasquet-Rafael_Nadal,1,S-IO,1,1,0,0,1,0,1
20130907-M-US_Open-SF-Richard_Gasquet-Rafael_Nadal,2,F-XC,43,10,2,0,8,19,24
20130907-M-US_Open-SF-Richard_Gasquet-Rafael_Nadal,2,F-DTM,28,2,0,0,2,18,10
20130907-M-US_Open-SF-Richard_Gasquet-Rafael_Nadal,2,F-DTL,13,7,2,2,3,8,5
20130907-M-US_Open-SF-Richard_Gasquet-Rafael_Nadal,2,F-IO,28,5,1,1,3,17,11
20130907-M-US_Open-SF-Richard_Gasquet-Rafael_Nadal,2,F-II,7,3,1,0,2,4,3
20130907-M-US_Open-SF-Richard_Gasquet-Rafael_Nadal,2,B-XC,40,5,2,1,2,29,11
20130907-M-US_Open-SF-Richard_Gasquet-Rafael_Nadal,2,B-DTM,32,2,0,1,1,23,9
20130907-M-US_Open-SF-Richard_Gasquet-Rafael_Nadal,2,B-DTL,9,4,0,2,2,5,4
20130907-M-US_Open-SF-Richard_Gasquet-Rafael_Nadal,2,B-IO,6,0,0,0,0,5,1
20130907-M-US_Open-SF-Richard_Gasquet-Rafael_Nadal,2,B-II,1,0,0,0,0,1,0
20130907-M-US_Open-SF-Richard_Gasquet-Rafael_Nadal,2,S-XC,1,0,0,0,0,0,1
20130907-M-US_Open-SF-Richard_Gasquet-Rafael_Nadal,2,S-DTM,4,0,0,0,0,2,2
20130907-M-US_Open-SF-Richard_Gasquet-Rafael_Nadal,2,S-DTL,3,1,1,0,0,2,1
20140317-M-Rimouski_CH-R32-Izak_Van_Der_Merwe-Daniel_Cox,1,F-XC,21,5,0,2,3,14,7
20140317-M-Rimouski_CH-R32-Izak_Van_Der_Merwe-Daniel_Cox,1,F-DTM,12,5,0,0,5,5,7
20140317-M-Rimouski_CH-R32-Izak_Van_Der_Merwe-Daniel_Cox,1,F-DTL,5,1,0,0,1,4,1
20140317-M-Rimouski_CH-R32-Izak_Van_Der_Merwe-Daniel_Cox,1,F-IO,10,4,1,2,1,5,5
20140317-M-Rimouski_CH-R32-Izak_Van_Der_Merwe-Daniel_Cox,1,F-II,2,1,0,0,1,1,1
20140317-M-Rimouski_CH-R32-Izak_Van_Der_Merwe-Daniel_Cox,1,B-XC,19,8,0,1,7,6,13
20140317-M-Rimouski_CH-R32-Izak_Van_Der_Merwe-Daniel_Cox,1,B-DTM,9,4,0,0,4,2,7
20140317-M-Rimouski_CH-R32-Izak_Van_Der_Merwe-Daniel_Cox,1,B-DTL,10,6,2,0,4,5,5
20140317-M-Rimouski_CH-R32-Izak_Van_Der_Merwe-Daniel_Cox,1,S-XC,7,1,0,0,1,1,6
20140317-M-Rimouski_CH-R32-Izak_Van_Der_Merwe-Daniel_Cox,1,S-DTM,3,0,0,0,0,0,3
20140317-M-Rimouski_CH-R32-Izak_Van_Der_Merwe-Daniel_Cox,1,S-DTL,2,0,0,0,0,0,2
20140317-M-Rimouski_CH-R32-Izak_Van_Der_Merwe-Daniel_Cox,1,S-IO,1,0,0,0,0,1,0
20140317-M-Rimouski_CH-R32-Izak_Van_Der_Merwe-Daniel_Cox,2,F-XC,25,6,2,2,2,11,14
20140317-M-Rimouski_CH-R32-Izak_Van_Der_Merwe-Daniel_Cox,2,F-DTM,8,0,0,0,0,4,4
20140317-M-Rimouski_CH-R32-Izak_Van_Der_Merwe-Daniel_Cox,2,F-DTL,9,2,0,0,2,3,6
20140317-M-Rimouski_CH-R32-Izak_Van_Der_Merwe-Daniel_Cox,2,F-IO,18,3,2,0,1,13,5
20140317-M-Rimouski_CH-R32-Izak_Van_Der_Merwe-Daniel_Cox,2,F-II,2,1,1,0,0,2,0
20140317-M-Rimouski_CH-R32-Izak_Van_Der_Merwe-Daniel_Cox,2,B-XC,18,4,1,0,3,9,9
20140317-M-Rimouski_CH-R32-Izak_Van_Der_Merwe-Daniel_Cox,2,B-DTM,9,0,0,0,0,5,4
20140317-M-Rimouski_CH-R32-Izak_Van_Der_Merwe-Daniel_Cox,2,B-DTL,2,2,1,0,1,1,1
20140317-M-Rimouski_CH-R32-Izak_Van_Der_Merwe-Daniel_Cox,2,B-IO,1,1,0,0,1,0,1
20140317-M-Rimouski_CH-R32-Izak_Van_Der_Merwe-Daniel_Cox,2,S-XC,3,1,0,1,0,2,1
20140317-M-Rimouski_CH-R32-Izak_Van_Der_Merwe-Daniel_Cox,2,S-DTM,5,0,0,0,0,0,5
20140222-M-Rio_de_Janeiro-SF-Rafael_Nadal-Pablo_Andujar,1,F-XC,65,11,3,2,6,31,34
20140222-M-Rio_de_Janeiro-SF-Rafael_Nadal-Pablo_Andujar,1,F-DTM,22,4,1,2,1,9,13
20140222-M-Rio_de_Janeiro-SF-Rafael_Nadal-Pablo_Andujar,1,F-DTL,16,7,4,1,2,12,4
20140222-M-Rio_de_Janeiro-SF-Rafael_Nadal-Pablo_Andujar,1,F-IO,35,17,7,5,5,21,14
20140222-M-Rio_de_Janeiro-SF-Rafael_Nadal-Pablo_Andujar,1,F-II,11,3,1,2,0,7,4
20140222-M-Rio_de_Janeiro-SF-Rafael_Nadal-Pablo_Andujar,1,B-XC,21,7,2,1,4,11,10
20140222-M-Rio_de_Janeiro-SF-Rafael_Nadal-Pablo_Andujar,1,B-DTM,35,3,0,1,2,15,20
20140222-M-Rio_de_Janeiro-SF-Rafael_Nadal-Pablo_Andujar,1,B-DTL,9,1,1,0,0,2,7
20140222-M-Rio_de_Janeiro-SF-Rafael_Nadal-Pablo_Andujar,1,B-IO,8,2,0,1,1,4,4
20140222-M-Rio_de_Janeiro-SF-Rafael_Nadal-Pablo_Andujar,1,S-XC,4,2,1,0,1,2,2
20140222-M-Rio_de_Janeiro-SF-Rafael_Nadal-Pablo_Andujar,1,S-DTM,7,1,0,0,1,1,6
20140222-M-Rio_de_Janeiro-SF-Rafael_Nadal-Pablo_Andujar,1,S-DTL,1,0,0,0,0,0,1
20140222-M-Rio_de_Janeiro-SF-Rafael_Nadal-Pablo_Andujar,1,S-IO,2,0,0,0,0,0,2
20140222-M-Rio_de_Janeiro-SF-Rafael_Nadal-Pablo_Andujar,2,F-XC,37,11,3,3,5,22,15
20140222-M-Rio_de_Janeiro-SF-Rafael_Nadal-Pablo_Andujar,2,F-DTM,30,0,0,0,0,22,8
20140222-M-Rio_de_Janeiro-SF-Rafael_Nadal-Pablo_Andujar,2,F-DTL,13,5,1,2,2,5,8
20140222-M-Rio_de_Janeiro-SF-Rafael_Nadal-Pablo_Andujar,2,F-IO,46,27,11,6,10,27,19
20140222-M-Rio_de_Janeiro-SF-Rafael_Nadal-Pablo_Andujar,2,F-II,5,3,2,1,0,3,2
20140222-M-Rio_de_Janeiro-SF-Rafael_Nadal-Pablo_Andujar,2,B-XC,30,6,1,2,3,20,10
20140222-M-Rio_de_Janeiro-SF-Rafael_Nadal-Pablo_Andujar,2,B-DTM,37,2,0,0,2,16,21
20140222-M-Rio_de_Janeiro-SF-Rafael_Nadal-Pablo_Andujar,2,B-DTL,24,7,2,1,4,14,10
20140222-M-Rio_de_Janeiro-SF-Rafael_Nadal-Pablo_Andujar,2,B-IO,8,2,2,0,0,4,4
20140222-M-Rio_de_Janeiro-SF-Rafael_Nadal-Pablo_Andujar,2,S-XC,1,1,0,0,1,0,1
20140222-M-Rio_de_Janeiro-SF-Rafael_Nadal-Pablo_Andujar,2,S-DTM,1,0,0,0,0,1,0
20140222-M-Rio_de_Janeiro-SF-Rafael_Nadal-Pablo_Andujar,2,S-DTL,3,0,0,0,0,2,1
20140218-M-Rio_de_Janeiro-R32-Rafael_Nadal-Daniel_Gimeno_Traver,1,F-XC,70,6,1,4,1,50,20
20140218-M-Rio_de_Janeiro-R32-Rafael_Nadal-Daniel_Gimeno_Traver,1,F-DTM,16,1,0,0,1,11,5
20140218-M-Rio_de_Janeiro-R32-Rafael_Nadal-Daniel_Gimeno_Traver,1,F-DTL,3,2,2,0,0,2,1
20140218-M-Rio_de_Janeiro-R32-Rafael_Nadal-Daniel_Gimeno_Traver,1,F-IO,19,6,2,2,2,15,4
20140218-M-Rio_de_Janeiro-R32-Rafael_Nadal-Daniel_Gimeno_Traver,1,F-II,4,1,0,1,0,4,0
20140218-M-Rio_de_Janeiro-R32-Rafael_Nadal-Daniel_Gimeno_Traver,1,B-XC,36,8,3,3,2,24,12
20140218-M-Rio_de_Janeiro-R32-Rafael_Nadal-Daniel_Gimeno_Traver,1,B-DTM,44,1,0,0,1,26,18
20140218-M-Rio_de_Janeiro-R32-Rafael_Nadal-Daniel_Gimeno_Traver,1,B-DTL,14,4,0,2,2,10,4
20140218-M-Rio_de_Janeiro-R32-Rafael_Nadal-Daniel_Gimeno_Traver,1,B-IO,7,0,0,0,0,3,4
20140218-M-Rio_de_Janeiro-R32-Rafael_Nadal-Daniel_Gimeno_Traver,1,S-XC,1,1,0,1,0,1,0
20140218-M-Rio_de_Janeiro-R32-Rafael_Nadal-Daniel_Gimeno_Traver,1,S-DTM,4,0,0,0,0,2,2
20140218-M-Rio_de_Janeiro-R32-Rafael_Nadal-Daniel_Gimeno_Traver,1,S-DTL,1,0,0,0,0,1,0
20140218-M-Rio_de_Janeiro-R32-Rafael_Nadal-Daniel_Gimeno_Traver,2,F-XC,62,13,2,4,7,22,40
20140218-M-Rio_de_Janeiro-R32-Rafael_Nadal-Daniel_Gimeno_Traver,2,F-DTM,41,4,0,1,3,18,23
20140218-M-Rio_de_Janeiro-R32-Rafael_Nadal-Daniel_Gimeno_Traver,2,F-DTL,4,3,1,1,1,3,1
20140218-M-Rio_de_Janeiro-R32-Rafael_Nadal-Daniel_Gimeno_Traver,2,F-IO,25,18,8,3,7,14,11
20140218-M-Rio_de_Janeiro-R32-Rafael_Nadal-Daniel_Gimeno_Traver,2,F-II,7,1,0,0,1,4,3
20140218-M-Rio_de_Janeiro-R32-Rafael_Nadal-Daniel_Gimeno_Traver,2,B-XC,30,11,1,5,5,12,18
20140218-M-Rio_de_Janeiro-R32-Rafael_Nadal-Daniel_Gimeno_Traver,2,B-DTM,36,6,0,0,6,7,29
20140218-M-Rio_de_Janeiro-R32-Rafael_Nadal-Daniel_Gimeno_Traver,2,B-DTL,15,3,1,0,2,5,10
20140218-M-Rio_de_Janeiro-R32-Rafael_Nadal-Daniel_Gimeno_Traver,2,B-IO,2,1,0,0,1,0,2
20140218-M-Rio_de_Janeiro-R32-Rafael_Nadal-Daniel_Gimeno_Traver,2,S-XC,1,0,0,0,0,0,1
20140218-M-Rio_de_Janeiro-R32-Rafael_Nadal-Daniel_Gimeno_Traver,2,S-DTM,8,0,0,0,0,2,6
20140218-M-Rio_de_Janeiro-R32-Rafael_Nadal-Daniel_Gimeno_Traver,2,S-DTL,2,0,0,0,0,0,2
20140223-M-Rio_de_Janeiro-F-Rafael_Nadal-Alexandr_Dolgopolov,1,F-XC,30,7,3,4,0,20,10
20140223-M-Rio_de_Janeiro-F-Rafael_Nadal-Alexandr_Dolgopolov,1,F-DTM,13,0,0,0,0,7,6
20140223-M-Rio_de_Janeiro-F-Rafael_Nadal-Alexandr_Dolgopolov,1,F-DTL,12,3,1,1,1,8,4
20140223-M-Rio_de_Janeiro-F-Rafael_Nadal-Alexandr_Dolgopolov,1,F-IO,18,9,4,4,1,12,6
20140223-M-Rio_de_Janeiro-F-Rafael_Nadal-Alexandr_Dolgopolov,1,F-II,6,2,1,1,0,5,1
20140223-M-Rio_de_Janeiro-F-Rafael_Nadal-Alexandr_Dolgopolov,1,B-XC,18,4,0,3,1,12,6
20140223-M-Rio_de_Janeiro-F-Rafael_Nadal-Alexandr_Dolgopolov,1,B-DTM,5,0,0,0,0,3,2
20140223-M-Rio_de_Janeiro-F-Rafael_Nadal-Alexandr_Dolgopolov,1,B-DTL,15,4,1,3,0,9,6
20140223-M-Rio_de_Janeiro-F-Rafael_Nadal-Alexandr_Dolgopolov,1,B-IO,3,1,0,1,0,2,1
20140223-M-Rio_de_Janeiro-F-Rafael_Nadal-Alexandr_Dolgopolov,1,S-DTM,3,0,0,0,0,1,2
20140223-M-Rio_de_Janeiro-F-Rafael_Nadal-Alexandr_Dolgopolov,1,S-DTL,1,0,0,0,0,0,1
20140223-M-Rio_de_Janeiro-F-Rafael_Nadal-Alexandr_Dolgopolov,2,F-XC,38,9,5,3,1,18,20
20140223-M-Rio_de_Janeiro-F-Rafael_Nadal-Alexandr_Dolgopolov,2,F-DTM,12,1,0,0,1,5,7
20140223-M-Rio_de_Janeiro-F-Rafael_Nadal-Alexandr_Dolgopolov,2,F-DTL,7,7,3,2,2,5,2
20140223-M-Rio_de_Janeiro-F-Rafael_Nadal-Alexandr_Dolgopolov,2,F-IO,9,4,2,2,0,7,2
20140223-M-Rio_de_Janeiro-F-Rafael_Nadal-Alexandr_Dolgopolov,2,F-II,3,0,0,0,0,2,1
20140223-M-Rio_de_Janeiro-F-Rafael_Nadal-Alexandr_Dolgopolov,2,B-XC,26,8,3,4,1,13,13
20140223-M-Rio_de_Janeiro-F-Rafael_Nadal-Alexandr_Dolgopolov,2,B-DTM,10,2,0,0,2,2,8
20140223-M-Rio_de_Janeiro-F-Rafael_Nadal-Alexandr_Dolgopolov,2,B-DTL,12,3,0,1,2,4,8
20140223-M-Rio_de_Janeiro-F-Rafael_Nadal-Alexandr_Dolgopolov,2,B-IO,3,1,0,0,1,0,3
20140223-M-Rio_de_Janeiro-F-Rafael_Nadal-Alexandr_Dolgopolov,2,S-DTM,1,0,0,0,0,0,1
20140220-M-Rio_de_Janeiro-R16-Albert_Montanes-Rafael_Nadal,1,F-XC,37,4,1,2,1,16,21
20140220-M-Rio_de_Janeiro-R16-Albert_Montanes-Rafael_Nadal,1,F-DTM,20,1,0,0,1,9,11
20140220-M-Rio_de_Janeiro-R16-Albert_Montanes-Rafael_Nadal,1,F-DTL,9,5,3,0,2,4,5
20140220-M-Rio_de_Janeiro-R16-Albert_Montanes-Rafael_Nadal,1,F-IO,22,8,3,2,3,12,10
20140220-M-Rio_de_Janeiro-R16-Albert_Montanes-Rafael_Nadal,1,F-II,18,6,2,2,2,8,10
20140220-M-Rio_de_Janeiro-R16-Albert_Montanes-Rafael_Nadal,1,B-XC,12,3,1,1,1,5,7
20140220-M-Rio_de_Janeiro-R16-Albert_Montanes-Rafael_Nadal,1,B-DTM,17,2,0,0,2,2,15
20140220-M-Rio_de_Janeiro-R16-Albert_Montanes-Rafael_Nadal,1,B-DTL,15,2,0,0,2,6,9
20140220-M-Rio_de_Janeiro-R16-Albert_Montanes-Rafael_Nadal,1,B-IO,4,1,0,1,0,3,1
20140220-M-Rio_de_Janeiro-R16-Albert_Montanes-Rafael_Nadal,1,S-DTM,1,0,0,0,0,0,1
20140220-M-Rio_de_Janeiro-R16-Albert_Montanes-Rafael_Nadal,1,S-DTL,4,1,0,0,1,1,3
20140220-M-Rio_de_Janeiro-R16-Albert_Montanes-Rafael_Nadal,2,F-XC,47,10,3,5,2,32,15
20140220-M-Rio_de_Janeiro-R16-Albert_Montanes-Rafael_Nadal,2,F-DTM,10,0,0,0,0,2,8
20140220-M-Rio_de_Janeiro-R16-Albert_Montanes-Rafael_Nadal,2,F-DTL,4,2,1,1,0,4,0
20140220-M-Rio_de_Janeiro-R16-Albert_Montanes-Rafael_Nadal,2,F-IO,19,13,8,2,3,14,5
20140220-M-Rio_de_Janeiro-R16-Albert_Montanes-Rafael_Nadal,2,F-II,6,3,0,2,1,3,3
20140220-M-Rio_de_Janeiro-R16-Albert_Montanes-Rafael_Nadal,2,B-XC,22,3,1,0,2,10,12
20140220-M-Rio_de_Janeiro-R16-Albert_Montanes-Rafael_Nadal,2,B-DTM,19,0,0,0,0,9,10
20140220-M-Rio_de_Janeiro-R16-Albert_Montanes-Rafael_Nadal,2,B-DTL,17,6,1,4,1,12,5
20140220-M-Rio_de_Janeiro-R16-Albert_Montanes-Rafael_Nadal,2,B-IO,4,0,0,0,0,3,1
20140220-M-Rio_de_Janeiro-R16-Albert_Montanes-Rafael_Nadal,2,S-XC,3,0,0,0,0,3,0
20140220-M-Rio_de_Janeiro-R16-Albert_Montanes-Rafael_Nadal,2,S-DTM,3,0,0,0,0,2,1
20140220-M-Rio_de_Janeiro-R16-Albert_Montanes-Rafael_Nadal,2,S-DTL,6,0,0,0,0,3,3
20140220-M-Rio_de_Janeiro-R16-Albert_Montanes-Rafael_Nadal,2,S-IO,2,0,0,0,0,0,2
20140221-M-Rio_de_Janeiro-QF-Rafael_Nadal-Joao_Sousa,1,F-XC,49,4,1,2,1,31,18
20140221-M-Rio_de_Janeiro-QF-Rafael_Nadal-Joao_Sousa,1,F-DTM,7,1,1,0,0,3,4
20140221-M-Rio_de_Janeiro-QF-Rafael_Nadal-Joao_Sousa,1,F-DTL,8,5,3,2,0,8,0
20140221-M-Rio_de_Janeiro-QF-Rafael_Nadal-Joao_Sousa,1,F-IO,20,13,7,3,3,16,4
20140221-M-Rio_de_Janeiro-QF-Rafael_Nadal-Joao_Sousa,1,F-II,4,0,0,0,0,4,0
20140221-M-Rio_de_Janeiro-QF-Rafael_Nadal-Joao_Sousa,1,B-XC,11,4,0,1,3,6,5
20140221-M-Rio_de_Janeiro-QF-Rafael_Nadal-Joao_Sousa,1,B-DTM,5,0,0,0,0,3,2
20140221-M-Rio_de_Janeiro-QF-Rafael_Nadal-Joao_Sousa,1,B-DTL,5,1,0,0,1,3,2
20140221-M-Rio_de_Janeiro-QF-Rafael_Nadal-Joao_Sousa,1,B-IO,2,0,0,0,0,2,0
20140221-M-Rio_de_Janeiro-QF-Rafael_Nadal-Joao_Sousa,1,S-XC,1,0,0,0,0,1,0
20140221-M-Rio_de_Janeiro-QF-Rafael_Nadal-Joao_Sousa,1,S-DTM,1,0,0,0,0,1,0
20140221-M-Rio_de_Janeiro-QF-Rafael_Nadal-Joao_Sousa,1,S-DTL,2,0,0,0,0,0,2
20140221-M-Rio_de_Janeiro-QF-Rafael_Nadal-Joao_Sousa,2,F-XC,19,6,0,4,2,9,10
20140221-M-Rio_de_Janeiro-QF-Rafael_Nadal-Joao_Sousa,2,F-DTM,10,1,0,0,1,3,7
20140221-M-Rio_de_Janeiro-QF-Rafael_Nadal-Joao_Sousa,2,F-DTL,7,3,1,1,1,3,4
20140221-M-Rio_de_Janeiro-QF-Rafael_Nadal-Joao_Sousa,2,F-IO,17,6,2,3,1,9,8
20140221-M-Rio_de_Janeiro-QF-Rafael_Nadal-Joao_Sousa,2,F-II,3,1,0,0,1,1,2
20140221-M-Rio_de_Janeiro-QF-Rafael_Nadal-Joao_Sousa,2,B-XC,19,6,0,0,6,5,14
20140221-M-Rio_de_Janeiro-QF-Rafael_Nadal-Joao_Sousa,2,B-DTM,22,1,0,0,1,5,17
20140221-M-Rio_de_Janeiro-QF-Rafael_Nadal-Joao_Sousa,2,B-DTL,11,6,0,2,4,5,6
20140221-M-Rio_de_Janeiro-QF-Rafael_Nadal-Joao_Sousa,2,B-IO,2,0,0,0,0,0,2
20140221-M-Rio_de_Janeiro-QF-Rafael_Nadal-Joao_Sousa,2,S-DTM,1,0,0,0,0,0,1
20140221-M-Rio_de_Janeiro-QF-Rafael_Nadal-Joao_Sousa,2,S-DTL,4,0,0,0,0,1,3
20130514-M-Rome_Masters-R32-Juan_Martin_Del_Potro-Andrey_Kuznetsov,1,F-XC,28,7,5,1,1,18,10
20130514-M-Rome_Masters-R32-Juan_Martin_Del_Potro-Andrey_Kuznetsov,1,F-DTM,14,1,1,0,0,7,7
20130514-M-Rome_Masters-R32-Juan_Martin_Del_Potro-Andrey_Kuznetsov,1,F-DTL,9,3,1,0,2,4,5
20130514-M-Rome_Masters-R32-Juan_Martin_Del_Potro-Andrey_Kuznetsov,1,F-IO,23,6,3,1,2,15,8
20130514-M-Rome_Masters-R32-Juan_Martin_Del_Potro-Andrey_Kuznetsov,1,F-II,5,1,1,0,0,4,1
20130514-M-Rome_Masters-R32-Juan_Martin_Del_Potro-Andrey_Kuznetsov,1,B-XC,34,2,0,1,1,15,19
20130514-M-Rome_Masters-R32-Juan_Martin_Del_Potro-Andrey_Kuznetsov,1,B-DTM,14,2,0,0,2,7,7
20130514-M-Rome_Masters-R32-Juan_Martin_Del_Potro-Andrey_Kuznetsov,1,B-DTL,5,2,0,0,2,1,4
20130514-M-Rome_Masters-R32-Juan_Martin_Del_Potro-Andrey_Kuznetsov,1,B-IO,5,2,2,0,0,4,1
20130514-M-Rome_Masters-R32-Juan_Martin_Del_Potro-Andrey_Kuznetsov,1,S-XC,4,0,0,0,0,3,1
20130514-M-Rome_Masters-R32-Juan_Martin_Del_Potro-Andrey_Kuznetsov,1,S-DTM,7,1,0,0,1,2,5
20130514-M-Rome_Masters-R32-Juan_Martin_Del_Potro-Andrey_Kuznetsov,2,F-XC,34,7,1,1,5,17,17
20130514-M-Rome_Masters-R32-Juan_Martin_Del_Potro-Andrey_Kuznetsov,2,F-DTM,13,3,0,0,3,4,9
20130514-M-Rome_Masters-R32-Juan_Martin_Del_Potro-Andrey_Kuznetsov,2,F-DTL,11,3,2,0,1,5,6
20130514-M-Rome_Masters-R32-Juan_Martin_Del_Potro-Andrey_Kuznetsov,2,F-IO,21,8,2,2,4,14,7
20130514-M-Rome_Masters-R32-Juan_Martin_Del_Potro-Andrey_Kuznetsov,2,F-II,7,2,0,0,2,3,4
20130514-M-Rome_Masters-R32-Juan_Martin_Del_Potro-Andrey_Kuznetsov,2,B-XC,42,5,2,0,3,19,23
20130514-M-Rome_Masters-R32-Juan_Martin_Del_Potro-Andrey_Kuznetsov,2,B-DTM,11,1,0,0,1,6,5
20130514-M-Rome_Masters-R32-Juan_Martin_Del_Potro-Andrey_Kuznetsov,2,B-DTL,13,7,2,1,4,8,5
20130514-M-Rome_Masters-R32-Juan_Martin_Del_Potro-Andrey_Kuznetsov,2,B-IO,1,0,0,0,0,0,1
20130514-M-Rome_Masters-R32-Juan_Martin_Del_Potro-Andrey_Kuznetsov,2,S-XC,4,0,0,0,0,1,3
20130514-M-Rome_Masters-R32-Juan_Martin_Del_Potro-Andrey_Kuznetsov,2,S-DTM,4,1,0,0,1,0,4
20130516-M-Rome_Masters-QF-Roger_Federer-Jerzy_Janowicz,1,F-XC,31,15,5,6,4,20,11
20130516-M-Rome_Masters-QF-Roger_Federer-Jerzy_Janowicz,1,F-DTM,19,5,0,1,4,11,8
20130516-M-Rome_Masters-QF-Roger_Federer-Jerzy_Janowicz,1,F-DTL,7,3,2,0,1,5,2
20130516-M-Rome_Masters-QF-Roger_Federer-Jerzy_Janowicz,1,F-IO,16,4,1,1,2,9,7
20130516-M-Rome_Masters-QF-Roger_Federer-Jerzy_Janowicz,1,F-II,7,2,1,0,1,5,2
20130516-M-Rome_Masters-QF-Roger_Federer-Jerzy_Janowicz,1,B-XC,9,1,0,1,0,6,3
20130516-M-Rome_Masters-QF-Roger_Federer-Jerzy_Janowicz,1,B-DTM,12,0,0,0,0,6,6
20130516-M-Rome_Masters-QF-Roger_Federer-Jerzy_Janowicz,1,B-DTL,2,0,0,0,0,1,1
20130516-M-Rome_Masters-QF-Roger_Federer-Jerzy_Janowicz,1,B-IO,1,0,0,0,0,1,0
20130516-M-Rome_Masters-QF-Roger_Federer-Jerzy_Janowicz,1,S-XC,6,0,0,0,0,4,2
20130516-M-Rome_Masters-QF-Roger_Federer-Jerzy_Janowicz,1,S-DTM,6,1,0,0,1,5,1
20130516-M-Rome_Masters-QF-Roger_Federer-Jerzy_Janowicz,1,S-DTL,2,0,0,0,0,1,1
20130516-M-Rome_Masters-QF-Roger_Federer-Jerzy_Janowicz,2,F-XC,30,9,1,4,4,15,15
20130516-M-Rome_Masters-QF-Roger_Federer-Jerzy_Janowicz,2,F-DTM,12,1,0,0,1,4,8
20130516-M-Rome_Masters-QF-Roger_Federer-Jerzy_Janowicz,2,F-DTL,4,1,0,0,1,0,4
20130516-M-Rome_Masters-QF-Roger_Federer-Jerzy_Janowicz,2,F-IO,20,6,4,0,2,7,13
20130516-M-Rome_Masters-QF-Roger_Federer-Jerzy_Janowicz,2,F-II,3,2,0,0,2,1,2
20130516-M-Rome_Masters-QF-Roger_Federer-Jerzy_Janowicz,2,B-XC,12,6,1,2,3,4,8
20130516-M-Rome_Masters-QF-Roger_Federer-Jerzy_Janowicz,2,B-DTM,11,3,0,0,3,3,8
20130516-M-Rome_Masters-QF-Roger_Federer-Jerzy_Janowicz,2,B-DTL,5,5,1,2,2,3,2
20130516-M-Rome_Masters-QF-Roger_Federer-Jerzy_Janowicz,2,B-IO,2,1,0,0,1,0,2
20130516-M-Rome_Masters-QF-Roger_Federer-Jerzy_Janowicz,2,S-XC,6,0,0,0,0,3,3
20130516-M-Rome_Masters-QF-Roger_Federer-Jerzy_Janowicz,2,S-DTM,3,0,0,0,0,0,3
20130516-M-Rome_Masters-QF-Roger_Federer-Jerzy_Janowicz,2,S-DTL,1,1,1,0,0,1,0
20140512-M-Rome_Masters-R64-Pere_Riba-Paolo_Lorenzi,1,F-XC,37,7,2,1,4,18,19
20140512-M-Rome_Masters-R64-Pere_Riba-Paolo_Lorenzi,1,F-DTM,18,4,0,0,4,8,10
20140512-M-Rome_Masters-R64-Pere_Riba-Paolo_Lorenzi,1,F-DTL,6,2,1,0,1,3,3
20140512-M-Rome_Masters-R64-Pere_Riba-Paolo_Lorenzi,1,F-IO,49,12,4,2,6,23,26
20140512-M-Rome_Masters-R64-Pere_Riba-Paolo_Lorenzi,1,F-II,7,2,0,2,0,4,3
20140512-M-Rome_Masters-R64-Pere_Riba-Paolo_Lorenzi,1,B-XC,34,4,1,0,3,15,19
20140512-M-Rome_Masters-R64-Pere_Riba-Paolo_Lorenzi,1,B-DTM,15,1,0,0,1,5,10
20140512-M-Rome_Masters-R64-Pere_Riba-Paolo_Lorenzi,1,B-DTL,7,5,2,0,3,3,4
20140512-M-Rome_Masters-R64-Pere_Riba-Paolo_Lorenzi,1,B-IO,1,1,1,0,0,1,0
20140512-M-Rome_Masters-R64-Pere_Riba-Paolo_Lorenzi,1,S-XC,6,1,1,0,0,2,4
20140512-M-Rome_Masters-R64-Pere_Riba-Paolo_Lorenzi,1,S-DTM,1,0,0,0,0,1,0
20140512-M-Rome_Masters-R64-Pere_Riba-Paolo_Lorenzi,1,S-DTL,1,1,0,1,0,1,0
20140512-M-Rome_Masters-R64-Pere_Riba-Paolo_Lorenzi,2,F-XC,20,4,2,1,1,12,8
20140512-M-Rome_Masters-R64-Pere_Riba-Paolo_Lorenzi,2,F-DTM,34,1,0,0,1,19,15
20140512-M-Rome_Masters-R64-Pere_Riba-Paolo_Lorenzi,2,F-DTL,9,3,0,0,3,2,7
20140512-M-Rome_Masters-R64-Pere_Riba-Paolo_Lorenzi,2,F-IO,21,2,1,0,1,9,12
20140512-M-Rome_Masters-R64-Pere_Riba-Paolo_Lorenzi,2,F-II,3,2,0,0,2,0,3
20140512-M-Rome_Masters-R64-Pere_Riba-Paolo_Lorenzi,2,B-XC,35,0,0,0,0,26,9
20140512-M-Rome_Masters-R64-Pere_Riba-Paolo_Lorenzi,2,B-DTM,18,0,0,0,0,8,10
20140512-M-Rome_Masters-R64-Pere_Riba-Paolo_Lorenzi,2,B-DTL,13,5,1,1,3,7,6
20140512-M-Rome_Masters-R64-Pere_Riba-Paolo_Lorenzi,2,B-IO,2,2,1,0,1,1,1
20140512-M-Rome_Masters-R64-Pere_Riba-Paolo_Lorenzi,2,S-XC,10,0,0,0,0,6,4
20140512-M-Rome_Masters-R64-Pere_Riba-Paolo_Lorenzi,2,S-DTM,4,0,0,0,0,2,2
20140512-M-Rome_Masters-R64-Pere_Riba-Paolo_Lorenzi,2,S-DTL,1,0,0,0,0,1,0
20140517-M-Rome_Masters-SF-Grigor_Dimitrov-Rafael_Nadal,1,F-XC,58,7,3,2,2,22,36
20140517-M-Rome_Masters-SF-Grigor_Dimitrov-Rafael_Nadal,1,F-DTM,20,3,0,0,3,8,12
20140517-M-Rome_Masters-SF-Grigor_Dimitrov-Rafael_Nadal,1,F-DTL,4,2,0,0,2,1,3
20140517-M-Rome_Masters-SF-Grigor_Dimitrov-Rafael_Nadal,1,F-IO,28,11,5,1,5,11,17
20140517-M-Rome_Masters-SF-Grigor_Dimitrov-Rafael_Nadal,1,F-II,6,1,0,0,1,2,4
20140517-M-Rome_Masters-SF-Grigor_Dimitrov-Rafael_Nadal,1,B-XC,21,3,0,2,1,9,12
20140517-M-Rome_Masters-SF-Grigor_Dimitrov-Rafael_Nadal,1,B-DTM,33,7,0,1,6,11,22
20140517-M-Rome_Masters-SF-Grigor_Dimitrov-Rafael_Nadal,1,B-DTL,11,1,1,0,0,2,9
20140517-M-Rome_Masters-SF-Grigor_Dimitrov-Rafael_Nadal,1,B-IO,2,0,0,0,0,1,1
20140517-M-Rome_Masters-SF-Grigor_Dimitrov-Rafael_Nadal,1,S-XC,8,3,0,0,3,1,7
20140517-M-Rome_Masters-SF-Grigor_Dimitrov-Rafael_Nadal,1,S-DTM,3,0,0,0,0,1,2
20140517-M-Rome_Masters-SF-Grigor_Dimitrov-Rafael_Nadal,1,S-DTL,2,1,0,0,1,0,2
20140517-M-Rome_Masters-SF-Grigor_Dimitrov-Rafael_Nadal,2,F-XC,66,6,1,1,4,39,27
20140517-M-Rome_Masters-SF-Grigor_Dimitrov-Rafael_Nadal,2,F-DTM,17,0,0,0,0,11,6
20140517-M-Rome_Masters-SF-Grigor_Dimitrov-Rafael_Nadal,2,F-DTL,10,4,1,2,1,7,3
20140517-M-Rome_Masters-SF-Grigor_Dimitrov-Rafael_Nadal,2,F-IO,18,7,3,3,1,14,4
20140517-M-Rome_Masters-SF-Grigor_Dimitrov-Rafael_Nadal,2,F-II,5,1,0,1,0,4,1
20140517-M-Rome_Masters-SF-Grigor_Dimitrov-Rafael_Nadal,2,B-XC,31,6,1,1,4,19,12
20140517-M-Rome_Masters-SF-Grigor_Dimitrov-Rafael_Nadal,2,B-DTM,21,0,0,0,0,14,7
20140517-M-Rome_Masters-SF-Grigor_Dimitrov-Rafael_Nadal,2,B-DTL,21,3,0,1,2,16,5
20140517-M-Rome_Masters-SF-Grigor_Dimitrov-Rafael_Nadal,2,B-IO,6,0,0,0,0,5,1
20140517-M-Rome_Masters-SF-Grigor_Dimitrov-Rafael_Nadal,2,S-XC,1,0,0,0,0,1,0
20140517-M-Rome_Masters-SF-Grigor_Dimitrov-Rafael_Nadal,2,S-DTM,1,1,0,0,1,0,1
20140514-M-Rome_Masters-R32-Gilles_Simon-Rafael_Nadal,1,F-XC,135,20,5,3,12,61,74
20140514-M-Rome_Masters-R32-Gilles_Simon-Rafael_Nadal,1,F-DTM,66,5,0,2,3,30,36
20140514-M-Rome_Masters-R32-Gilles_Simon-Rafael_Nadal,1,F-DTL,42,22,9,3,10,21,21
20140514-M-Rome_Masters-R32-Gilles_Simon-Rafael_Nadal,1,F-IO,61,17,12,3,2,39,22
20140514-M-Rome_Masters-R32-Gilles_Simon-Rafael_Nadal,1,F-II,8,1,1,0,0,7,1
20140514-M-Rome_Masters-R32-Gilles_Simon-Rafael_Nadal,1,B-XC,102,24,6,8,10,48,54
20140514-M-Rome_Masters-R32-Gilles_Simon-Rafael_Nadal,1,B-DTM,106,6,0,0,6,46,60
20140514-M-Rome_Masters-R32-Gilles_Simon-Rafael_Nadal,1,B-DTL,54,10,2,2,6,21,33
20140514-M-Rome_Masters-R32-Gilles_Simon-Rafael_Nadal,1,B-IO,13,5,1,0,4,5,8
20140514-M-Rome_Masters-R32-Gilles_Simon-Rafael_Nadal,1,B-II,1,1,0,1,0,1,0
20140514-M-Rome_Masters-R32-Gilles_Simon-Rafael_Nadal,1,S-DTL,2,0,0,0,0,1,1
20140514-M-Rome_Masters-R32-Gilles_Simon-Rafael_Nadal,1,S-IO,1,0,0,0,0,0,1
20140514-M-Rome_Masters-R32-Gilles_Simon-Rafael_Nadal,2,F-XC,174,11,4,4,3,103,71
20140514-M-Rome_Masters-R32-Gilles_Simon-Rafael_Nadal,2,F-DTM,56,4,0,1,3,18,38
20140514-M-Rome_Masters-R32-Gilles_Simon-Rafael_Nadal,2,F-DTL,37,13,4,5,4,21,16
20140514-M-Rome_Masters-R32-Gilles_Simon-Rafael_Nadal,2,F-IO,90,20,12,3,5,55,35
20140514-M-Rome_Masters-R32-Gilles_Simon-Rafael_Nadal,2,F-II,20,3,0,2,1,11,9
20140514-M-Rome_Masters-R32-Gilles_Simon-Rafael_Nadal,2,B-XC,82,7,1,2,4,45,37
20140514-M-Rome_Masters-R32-Gilles_Simon-Rafael_Nadal,2,B-DTM,45,4,0,2,2,27,18
20140514-M-Rome_Masters-R32-Gilles_Simon-Rafael_Nadal,2,B-DTL,25,4,1,1,2,12,13
20140514-M-Rome_Masters-R32-Gilles_Simon-Rafael_Nadal,2,B-IO,9,0,0,0,0,4,5
20140514-M-Rome_Masters-R32-Gilles_Simon-Rafael_Nadal,2,S-XC,2,0,0,0,0,2,0
20140514-M-Rome_Masters-R32-Gilles_Simon-Rafael_Nadal,2,S-DTM,10,0,0,0,0,7,3
20140514-M-Rome_Masters-R32-Gilles_Simon-Rafael_Nadal,2,S-DTL,12,0,0,0,0,6,6
20140514-M-Rome_Masters-R32-Gilles_Simon-Rafael_Nadal,2,S-IO,4,0,0,0,0,2,2
20140516-M-Rome_Masters-QF-Andy_Murray-Rafael_Nadal,1,F-XC,159,13,3,3,7,73,86
20140516-M-Rome_Masters-QF-Andy_Murray-Rafael_Nadal,1,F-DTM,40,2,0,1,1,15,25
20140516-M-Rome_Masters-QF-Andy_Murray-Rafael_Nadal,1,F-DTL,24,8,4,0,4,13,11
20140516-M-Rome_Masters-QF-Andy_Murray-Rafael_Nadal,1,F-IO,34,12,5,4,3,20,14
20140516-M-Rome_Masters-QF-Andy_Murray-Rafael_Nadal,1,F-II,6,2,1,0,1,3,3
20140516-M-Rome_Masters-QF-Andy_Murray-Rafael_Nadal,1,B-XC,48,13,2,4,7,24,24
20140516-M-Rome_Masters-QF-Andy_Murray-Rafael_Nadal,1,B-DTM,52,4,0,0,4,26,26
20140516-M-Rome_Masters-QF-Andy_Murray-Rafael_Nadal,1,B-DTL,28,10,4,1,5,14,14
20140516-M-Rome_Masters-QF-Andy_Murray-Rafael_Nadal,1,B-IO,4,2,1,0,1,2,2
20140516-M-Rome_Masters-QF-Andy_Murray-Rafael_Nadal,1,S-XC,5,0,0,0,0,4,1
20140516-M-Rome_Masters-QF-Andy_Murray-Rafael_Nadal,1,S-DTM,4,0,0,0,0,0,4
20140516-M-Rome_Masters-QF-Andy_Murray-Rafael_Nadal,1,S-DTL,7,0,0,0,0,2,5
20140516-M-Rome_Masters-QF-Andy_Murray-Rafael_Nadal,1,S-IO,3,0,0,0,0,2,1
20140516-M-Rome_Masters-QF-Andy_Murray-Rafael_Nadal,2,F-XC,89,7,1,2,4,46,43
20140516-M-Rome_Masters-QF-Andy_Murray-Rafael_Nadal,2,F-DTM,19,3,0,1,2,9,10
20140516-M-Rome_Masters-QF-Andy_Murray-Rafael_Nadal,2,F-DTL,32,8,1,3,4,14,18
20140516-M-Rome_Masters-QF-Andy_Murray-Rafael_Nadal,2,F-IO,65,10,1,5,4,38,27
20140516-M-Rome_Masters-QF-Andy_Murray-Rafael_Nadal,2,F-II,9,4,0,2,2,4,5
20140516-M-Rome_Masters-QF-Andy_Murray-Rafael_Nadal,2,B-XC,80,5,2,1,2,45,35
20140516-M-Rome_Masters-QF-Andy_Murray-Rafael_Nadal,2,B-DTM,48,3,0,0,3,26,22
20140516-M-Rome_Masters-QF-Andy_Murray-Rafael_Nadal,2,B-DTL,30,6,1,1,4,18,12
20140516-M-Rome_Masters-QF-Andy_Murray-Rafael_Nadal,2,B-IO,9,3,0,1,2,6,3
20140516-M-Rome_Masters-QF-Andy_Murray-Rafael_Nadal,2,S-XC,3,0,0,0,0,0,3
20140516-M-Rome_Masters-QF-Andy_Murray-Rafael_Nadal,2,S-DTM,11,0,0,0,0,4,7
20140516-M-Rome_Masters-QF-Andy_Murray-Rafael_Nadal,2,S-DTL,6,1,0,1,0,1,5
20140516-M-Rome_Masters-QF-Andy_Murray-Rafael_Nadal,2,S-IO,3,0,0,0,0,1,2
20140518-M-Rome_Masters-F-Novak_Djokovic-Rafael_Nadal,1,F-XC,77,12,5,4,3,45,32
20140518-M-Rome_Masters-F-Novak_Djokovic-Rafael_Nadal,1,F-DTM,27,3,0,0,3,11,16
20140518-M-Rome_Masters-F-Novak_Djokovic-Rafael_Nadal,1,F-DTL,17,4,3,0,1,9,8
20140518-M-Rome_Masters-F-Novak_Djokovic-Rafael_Nadal,1,F-IO,42,16,8,4,4,25,17
20140518-M-Rome_Masters-F-Novak_Djokovic-Rafael_Nadal,1,F-II,3,1,1,0,0,2,1
20140518-M-Rome_Masters-F-Novak_Djokovic-Rafael_Nadal,1,B-XC,50,14,4,3,7,21,29
20140518-M-Rome_Masters-F-Novak_Djokovic-Rafael_Nadal,1,B-DTM,46,3,0,0,3,22,24
20140518-M-Rome_Masters-F-Novak_Djokovic-Rafael_Nadal,1,B-DTL,26,6,4,1,1,17,9
20140518-M-Rome_Masters-F-Novak_Djokovic-Rafael_Nadal,1,B-IO,10,1,0,0,1,6,4
20140518-M-Rome_Masters-F-Novak_Djokovic-Rafael_Nadal,1,S-XC,1,0,0,0,0,0,1
20140518-M-Rome_Masters-F-Novak_Djokovic-Rafael_Nadal,1,S-DTL,1,0,0,0,0,1,0
20140518-M-Rome_Masters-F-Novak_Djokovic-Rafael_Nadal,2,F-XC,82,8,2,4,2,43,39
20140518-M-Rome_Masters-F-Novak_Djokovic-Rafael_Nadal,2,F-DTM,40,1,0,0,1,17,23
20140518-M-Rome_Masters-F-Novak_Djokovic-Rafael_Nadal,2,F-DTL,16,5,1,3,1,11,5
20140518-M-Rome_Masters-F-Novak_Djokovic-Rafael_Nadal,2,F-IO,39,10,2,4,4,25,14
20140518-M-Rome_Masters-F-Novak_Djokovic-Rafael_Nadal,2,F-II,5,1,0,1,0,5,0
20140518-M-Rome_Masters-F-Novak_Djokovic-Rafael_Nadal,2,B-XC,37,8,2,2,4,16,21
20140518-M-Rome_Masters-F-Novak_Djokovic-Rafael_Nadal,2,B-DTM,43,3,0,0,3,14,29
20140518-M-Rome_Masters-F-Novak_Djokovic-Rafael_Nadal,2,B-DTL,22,1,0,0,1,10,12
20140518-M-Rome_Masters-F-Novak_Djokovic-Rafael_Nadal,2,B-IO,5,0,0,0,0,0,5
20140518-M-Rome_Masters-F-Novak_Djokovic-Rafael_Nadal,2,S-XC,2,1,1,0,0,2,0
20140518-M-Rome_Masters-F-Novak_Djokovic-Rafael_Nadal,2,S-DTM,5,0,0,0,0,3,2
20140518-M-Rome_Masters-F-Novak_Djokovic-Rafael_Nadal,2,S-DTL,11,3,0,1,2,5,6
20140515-M-Rome_Masters-R16-Mikhail_Youzhny-Rafael_Nadal,1,F-XC,55,9,2,2,5,27,28
20140515-M-Rome_Masters-R16-Mikhail_Youzhny-Rafael_Nadal,1,F-DTM,37,2,0,1,1,11,26
20140515-M-Rome_Masters-R16-Mikhail_Youzhny-Rafael_Nadal,1,F-DTL,15,9,2,4,3,8,7
20140515-M-Rome_Masters-R16-Mikhail_Youzhny-Rafael_Nadal,1,F-IO,38,11,3,5,3,25,13
20140515-M-Rome_Masters-R16-Mikhail_Youzhny-Rafael_Nadal,1,F-II,4,2,0,2,0,3,1
20140515-M-Rome_Masters-R16-Mikhail_Youzhny-Rafael_Nadal,1,B-XC,56,14,2,3,9,22,34
20140515-M-Rome_Masters-R16-Mikhail_Youzhny-Rafael_Nadal,1,B-DTM,49,7,0,1,6,18,31
20140515-M-Rome_Masters-R16-Mikhail_Youzhny-Rafael_Nadal,1,B-DTL,35,12,1,3,8,18,17
20140515-M-Rome_Masters-R16-Mikhail_Youzhny-Rafael_Nadal,1,B-IO,7,1,0,1,0,4,3
20140515-M-Rome_Masters-R16-Mikhail_Youzhny-Rafael_Nadal,1,S-XC,3,0,0,0,0,0,3
20140515-M-Rome_Masters-R16-Mikhail_Youzhny-Rafael_Nadal,1,S-DTM,8,0,0,0,0,3,5
20140515-M-Rome_Masters-R16-Mikhail_Youzhny-Rafael_Nadal,1,S-DTL,13,1,0,0,1,3,10
20140515-M-Rome_Masters-R16-Mikhail_Youzhny-Rafael_Nadal,1,S-IO,6,0,0,0,0,1,5
20140515-M-Rome_Masters-R16-Mikhail_Youzhny-Rafael_Nadal,2,F-XC,112,14,2,5,7,63,49
20140515-M-Rome_Masters-R16-Mikhail_Youzhny-Rafael_Nadal,2,F-DTM,24,0,0,0,0,13,11
20140515-M-Rome_Masters-R16-Mikhail_Youzhny-Rafael_Nadal,2,F-DTL,22,10,4,1,5,10,12
20140515-M-Rome_Masters-R16-Mikhail_Youzhny-Rafael_Nadal,2,F-IO,45,20,7,9,4,33,12
20140515-M-Rome_Masters-R16-Mikhail_Youzhny-Rafael_Nadal,2,F-II,15,3,2,0,1,10,5
20140515-M-Rome_Masters-R16-Mikhail_Youzhny-Rafael_Nadal,2,B-XC,22,3,0,0,3,10,12
20140515-M-Rome_Masters-R16-Mikhail_Youzhny-Rafael_Nadal,2,B-DTM,24,0,0,0,0,12,12
20140515-M-Rome_Masters-R16-Mikhail_Youzhny-Rafael_Nadal,2,B-DTL,8,2,1,0,1,5,3
20140515-M-Rome_Masters-R16-Mikhail_Youzhny-Rafael_Nadal,2,B-IO,6,1,0,1,0,5,1
20140515-M-Rome_Masters-R16-Mikhail_Youzhny-Rafael_Nadal,2,B-II,1,0,0,0,0,0,1
20140515-M-Rome_Masters-R16-Mikhail_Youzhny-Rafael_Nadal,2,S-XC,6,0,0,0,0,4,2
20140515-M-Rome_Masters-R16-Mikhail_Youzhny-Rafael_Nadal,2,S-DTM,23,1,0,1,0,13,10
20140515-M-Rome_Masters-R16-Mikhail_Youzhny-Rafael_Nadal,2,S-DTL,8,0,0,0,0,4,4
20140515-M-Rome_Masters-R16-Mikhail_Youzhny-Rafael_Nadal,2,S-IO,4,0,0,0,0,4,0
20140514-M-Rome_Masters-R32-Ernests_Gulbis-Stephane_Robert,1,F-XC,25,7,2,1,4,14,11
20140514-M-Rome_Masters-R32-Ernests_Gulbis-Stephane_Robert,1,F-DTM,21,4,1,0,3,8,13
20140514-M-Rome_Masters-R32-Ernests_Gulbis-Stephane_Robert,1,F-DTL,6,2,1,0,1,2,4
20140514-M-Rome_Masters-R32-Ernests_Gulbis-Stephane_Robert,1,F-IO,16,9,3,3,3,8,8
20140514-M-Rome_Masters-R32-Ernests_Gulbis-Stephane_Robert,1,B-XC,40,11,5,2,4,24,16
20140514-M-Rome_Masters-R32-Ernests_Gulbis-Stephane_Robert,1,B-DTM,20,1,0,1,0,5,15
20140514-M-Rome_Masters-R32-Ernests_Gulbis-Stephane_Robert,1,B-DTL,5,3,1,0,2,2,3
20140514-M-Rome_Masters-R32-Ernests_Gulbis-Stephane_Robert,1,B-IO,13,4,1,0,3,7,6
20140514-M-Rome_Masters-R32-Ernests_Gulbis-Stephane_Robert,1,S-XC,3,1,0,0,1,0,3
20140514-M-Rome_Masters-R32-Ernests_Gulbis-Stephane_Robert,1,S-DTM,2,0,0,0,0,0,2
20140514-M-Rome_Masters-R32-Ernests_Gulbis-Stephane_Robert,2,F-XC,29,6,5,1,0,17,12
20140514-M-Rome_Masters-R32-Ernests_Gulbis-Stephane_Robert,2,F-DTM,27,4,0,1,3,10,17
20140514-M-Rome_Masters-R32-Ernests_Gulbis-Stephane_Robert,2,F-DTL,11,11,2,3,6,5,6
20140514-M-Rome_Masters-R32-Ernests_Gulbis-Stephane_Robert,2,F-IO,17,8,5,2,1,14,3
20140514-M-Rome_Masters-R32-Ernests_Gulbis-Stephane_Robert,2,B-XC,32,8,0,2,6,17,15
20140514-M-Rome_Masters-R32-Ernests_Gulbis-Stephane_Robert,2,B-DTM,31,1,0,0,1,19,12
20140514-M-Rome_Masters-R32-Ernests_Gulbis-Stephane_Robert,2,B-DTL,18,9,2,1,6,8,10
20140514-M-Rome_Masters-R32-Ernests_Gulbis-Stephane_Robert,2,B-IO,11,5,2,2,1,10,1
20140514-M-Rome_Masters-R32-Ernests_Gulbis-Stephane_Robert,2,S-XC,2,0,0,0,0,0,2
20140514-M-Rome_Masters-R32-Ernests_Gulbis-Stephane_Robert,2,S-DTL,1,0,0,0,0,0,1
20140409-M-Itajai-R32-Mohamed_Safwat-Eduardo_Russi,1,F-XC,12,5,2,2,1,7,5
20140409-M-Itajai-R32-Mohamed_Safwat-Eduardo_Russi,1,F-DTM,7,1,0,0,1,2,5
20140409-M-Itajai-R32-Mohamed_Safwat-Eduardo_Russi,1,F-DTL,2,2,0,1,1,1,1
20140409-M-Itajai-R32-Mohamed_Safwat-Eduardo_Russi,1,F-IO,14,4,2,0,2,8,6
20140409-M-Itajai-R32-Mohamed_Safwat-Eduardo_Russi,1,F-II,2,2,2,0,0,2,0
20140409-M-Itajai-R32-Mohamed_Safwat-Eduardo_Russi,1,B-XC,5,2,1,0,1,3,2
20140409-M-Itajai-R32-Mohamed_Safwat-Eduardo_Russi,1,B-DTM,3,0,0,0,0,1,2
20140409-M-Itajai-R32-Mohamed_Safwat-Eduardo_Russi,1,B-DTL,1,1,0,0,1,0,1
20140409-M-Itajai-R32-Mohamed_Safwat-Eduardo_Russi,1,S-XC,4,0,0,0,0,2,2
20140409-M-Itajai-R32-Mohamed_Safwat-Eduardo_Russi,2,F-XC,3,1,0,1,0,3,0
20140409-M-Itajai-R32-Mohamed_Safwat-Eduardo_Russi,2,F-DTM,5,2,0,0,2,2,3
20140409-M-Itajai-R32-Mohamed_Safwat-Eduardo_Russi,2,F-DTL,1,0,0,0,0,1,0
20140409-M-Itajai-R32-Mohamed_Safwat-Eduardo_Russi,2,F-IO,3,1,0,0,1,1,2
20140409-M-Itajai-R32-Mohamed_Safwat-Eduardo_Russi,2,F-II,2,2,0,0,2,0,2
20140409-M-Itajai-R32-Mohamed_Safwat-Eduardo_Russi,2,B-XC,7,2,0,0,2,3,4
20140409-M-Itajai-R32-Mohamed_Safwat-Eduardo_Russi,2,B-DTM,8,3,0,0,3,3,5
20140409-M-Itajai-R32-Mohamed_Safwat-Eduardo_Russi,2,B-DTL,1,1,1,0,0,1,0
20140409-M-Itajai-R32-Mohamed_Safwat-Eduardo_Russi,2,B-IO,3,2,2,0,0,3,0
20140409-M-Itajai-R32-Mohamed_Safwat-Eduardo_Russi,2,S-XC,2,0,0,0,0,1,1
20140409-M-Itajai-R32-Mohamed_Safwat-Eduardo_Russi,2,S-DTM,3,0,0,0,0,1,2
20140409-M-Itajai-R32-Mohamed_Safwat-Eduardo_Russi,2,S-DTL,1,1,0,0,1,0,1
20140105-M-Sao_Paulo_CH-F-Alejandro_Gonzalez-Joao_Souza,1,F-XC,29,9,3,2,4,19,10
20140105-M-Sao_Paulo_CH-F-Alejandro_Gonzalez-Joao_Souza,1,F-DTM,25,9,0,1,8,7,18
20140105-M-Sao_Paulo_CH-F-Alejandro_Gonzalez-Joao_Souza,1,F-DTL,4,1,0,1,0,2,2
20140105-M-Sao_Paulo_CH-F-Alejandro_Gonzalez-Joao_Souza,1,F-IO,15,5,0,2,3,9,6
20140105-M-Sao_Paulo_CH-F-Alejandro_Gonzalez-Joao_Souza,1,F-II,3,1,1,0,0,1,2
20140105-M-Sao_Paulo_CH-F-Alejandro_Gonzalez-Joao_Souza,1,B-XC,19,2,0,0,2,8,11
20140105-M-Sao_Paulo_CH-F-Alejandro_Gonzalez-Joao_Souza,1,B-DTM,27,2,0,0,2,12,15
20140105-M-Sao_Paulo_CH-F-Alejandro_Gonzalez-Joao_Souza,1,B-DTL,5,2,0,0,2,1,4
20140105-M-Sao_Paulo_CH-F-Alejandro_Gonzalez-Joao_Souza,1,B-IO,7,2,1,0,1,2,5
20140105-M-Sao_Paulo_CH-F-Alejandro_Gonzalez-Joao_Souza,1,B-II,1,0,0,0,0,1,0
20140105-M-Sao_Paulo_CH-F-Alejandro_Gonzalez-Joao_Souza,1,S-XC,1,0,0,0,0,1,0
20140105-M-Sao_Paulo_CH-F-Alejandro_Gonzalez-Joao_Souza,2,F-XC,25,9,4,0,5,15,10
20140105-M-Sao_Paulo_CH-F-Alejandro_Gonzalez-Joao_Souza,2,F-DTM,31,2,0,0,2,14,17
20140105-M-Sao_Paulo_CH-F-Alejandro_Gonzalez-Joao_Souza,2,F-DTL,9,0,0,0,0,6,3
20140105-M-Sao_Paulo_CH-F-Alejandro_Gonzalez-Joao_Souza,2,F-IO,17,9,5,1,3,13,4
20140105-M-Sao_Paulo_CH-F-Alejandro_Gonzalez-Joao_Souza,2,F-II,2,1,0,1,0,1,1
20140105-M-Sao_Paulo_CH-F-Alejandro_Gonzalez-Joao_Souza,2,B-XC,15,3,0,0,3,6,9
20140105-M-Sao_Paulo_CH-F-Alejandro_Gonzalez-Joao_Souza,2,B-DTM,20,1,0,0,1,8,12
20140105-M-Sao_Paulo_CH-F-Alejandro_Gonzalez-Joao_Souza,2,B-DTL,7,1,1,0,0,6,1
20140105-M-Sao_Paulo_CH-F-Alejandro_Gonzalez-Joao_Souza,2,B-IO,3,1,0,0,1,0,3
20140105-M-Sao_Paulo_CH-F-Alejandro_Gonzalez-Joao_Souza,2,B-II,1,0,0,0,0,1,0
20140105-M-Sao_Paulo_CH-F-Alejandro_Gonzalez-Joao_Souza,2,S-XC,1,0,0,0,0,1,0
20140105-M-Sao_Paulo_CH-F-Alejandro_Gonzalez-Joao_Souza,2,S-DTM,2,0,0,0,0,1,1
20140103-M-Sao_Paulo_CH-QF-Gastao_Elias-Facundo_Arguello,1,F-XC,3,1,1,0,0,3,0
20140103-M-Sao_Paulo_CH-QF-Gastao_Elias-Facundo_Arguello,1,F-DTM,2,0,0,0,0,2,0
20140103-M-Sao_Paulo_CH-QF-Gastao_Elias-Facundo_Arguello,1,F-IO,5,2,2,0,0,5,0
20140103-M-Sao_Paulo_CH-QF-Gastao_Elias-Facundo_Arguello,1,F-II,1,1,1,0,0,1,0
20140103-M-Sao_Paulo_CH-QF-Gastao_Elias-Facundo_Arguello,1,B-DTM,1,0,0,0,0,1,0
20140103-M-Sao_Paulo_CH-QF-Gastao_Elias-Facundo_Arguello,1,B-DTL,1,1,0,0,1,0,1
20140103-M-Sao_Paulo_CH-QF-Gastao_Elias-Facundo_Arguello,2,F-XC,2,0,0,0,0,0,2
20140103-M-Sao_Paulo_CH-QF-Gastao_Elias-Facundo_Arguello,2,F-DTM,2,1,0,0,1,0,2
20140103-M-Sao_Paulo_CH-QF-Gastao_Elias-Facundo_Arguello,2,F-DTL,1,0,0,0,0,0,1
20140103-M-Sao_Paulo_CH-QF-Gastao_Elias-Facundo_Arguello,2,F-IO,2,2,2,0,0,2,0
20140103-M-Sao_Paulo_CH-QF-Gastao_Elias-Facundo_Arguello,2,B-DTM,1,0,0,0,0,0,1
20140103-M-Sao_Paulo_CH-QF-Gastao_Elias-Facundo_Arguello,2,S-XC,2,0,0,0,0,0,2
20140103-M-Sao_Paulo_CH-QF-Gastao_Elias-Facundo_Arguello,2,S-DTM,1,1,0,0,1,0,1
20131011-M-Shanghai_Masters-QF-Nicolas_Almagro-Juan_Martin_Del_Potro,1,F-XC,25,9,3,2,4,11,14
20131011-M-Shanghai_Masters-QF-Nicolas_Almagro-Juan_Martin_Del_Potro,1,F-DTM,7,2,0,0,2,1,6
20131011-M-Shanghai_Masters-QF-Nicolas_Almagro-Juan_Martin_Del_Potro,1,F-DTL,8,5,1,1,3,3,5
20131011-M-Shanghai_Masters-QF-Nicolas_Almagro-Juan_Martin_Del_Potro,1,F-IO,19,7,3,2,2,14,5
20131011-M-Shanghai_Masters-QF-Nicolas_Almagro-Juan_Martin_Del_Potro,1,F-II,2,1,1,0,0,1,1
20131011-M-Shanghai_Masters-QF-Nicolas_Almagro-Juan_Martin_Del_Potro,1,B-XC,23,4,1,1,2,11,12
20131011-M-Shanghai_Masters-QF-Nicolas_Almagro-Juan_Martin_Del_Potro,1,B-DTM,18,3,0,0,3,9,9
20131011-M-Shanghai_Masters-QF-Nicolas_Almagro-Juan_Martin_Del_Potro,1,B-DTL,4,2,1,0,1,1,3
20131011-M-Shanghai_Masters-QF-Nicolas_Almagro-Juan_Martin_Del_Potro,1,S-XC,3,1,0,0,1,1,2
20131011-M-Shanghai_Masters-QF-Nicolas_Almagro-Juan_Martin_Del_Potro,1,S-DTM,4,2,0,0,2,0,4
20131011-M-Shanghai_Masters-QF-Nicolas_Almagro-Juan_Martin_Del_Potro,1,S-IO,1,0,0,0,0,1,0
20131011-M-Shanghai_Masters-QF-Nicolas_Almagro-Juan_Martin_Del_Potro,2,F-XC,23,9,6,3,0,18,5
20131011-M-Shanghai_Masters-QF-Nicolas_Almagro-Juan_Martin_Del_Potro,2,F-DTM,9,2,0,1,1,3,6
20131011-M-Shanghai_Masters-QF-Nicolas_Almagro-Juan_Martin_Del_Potro,2,F-DTL,6,2,2,0,0,4,2
20131011-M-Shanghai_Masters-QF-Nicolas_Almagro-Juan_Martin_Del_Potro,2,F-IO,15,3,3,0,0,9,6
20131011-M-Shanghai_Masters-QF-Nicolas_Almagro-Juan_Martin_Del_Potro,2,F-II,1,0,0,0,0,1,0
20131011-M-Shanghai_Masters-QF-Nicolas_Almagro-Juan_Martin_Del_Potro,2,B-XC,14,3,0,1,2,9,5
20131011-M-Shanghai_Masters-QF-Nicolas_Almagro-Juan_Martin_Del_Potro,2,B-DTM,20,1,0,0,1,6,14
20131011-M-Shanghai_Masters-QF-Nicolas_Almagro-Juan_Martin_Del_Potro,2,B-DTL,2,2,1,0,1,1,1
20131011-M-Shanghai_Masters-QF-Nicolas_Almagro-Juan_Martin_Del_Potro,2,B-IO,1,1,1,0,0,1,0
20131011-M-Shanghai_Masters-QF-Nicolas_Almagro-Juan_Martin_Del_Potro,2,B-II,1,0,0,0,0,1,0
20131011-M-Shanghai_Masters-QF-Nicolas_Almagro-Juan_Martin_Del_Potro,2,S-XC,6,0,0,0,0,3,3
20131011-M-Shanghai_Masters-QF-Nicolas_Almagro-Juan_Martin_Del_Potro,2,S-DTM,5,0,0,0,0,4,1
20140514-M-Rome_Masters-R32-Roger_Federer-Jeremy_Chardy,1,F-XC,47,17,7,2,8,26,21
20140514-M-Rome_Masters-R32-Roger_Federer-Jeremy_Chardy,1,F-DTM,25,3,0,0,3,7,18
20140514-M-Rome_Masters-R32-Roger_Federer-Jeremy_Chardy,1,F-DTL,12,3,0,0,3,6,6
20140514-M-Rome_Masters-R32-Roger_Federer-Jeremy_Chardy,1,F-IO,34,10,2,2,6,16,18
20140514-M-Rome_Masters-R32-Roger_Federer-Jeremy_Chardy,1,F-II,5,3,2,0,0,2,3
20140514-M-Rome_Masters-R32-Roger_Federer-Jeremy_Chardy,1,B-XC,32,4,0,1,3,12,20
20140514-M-Rome_Masters-R32-Roger_Federer-Jeremy_Chardy,1,B-DTM,34,2,1,0,0,18,16
20140514-M-Rome_Masters-R32-Roger_Federer-Jeremy_Chardy,1,B-DTL,15,3,0,1,2,10,5
20140514-M-Rome_Masters-R32-Roger_Federer-Jeremy_Chardy,1,B-IO,3,2,1,0,1,1,2
20140514-M-Rome_Masters-R32-Roger_Federer-Jeremy_Chardy,1,B-II,1,1,1,0,0,1,0
20140514-M-Rome_Masters-R32-Roger_Federer-Jeremy_Chardy,1,S-XC,13,2,0,1,1,8,5
20140514-M-Rome_Masters-R32-Roger_Federer-Jeremy_Chardy,1,S-DTM,4,0,0,0,0,3,1
20140514-M-Rome_Masters-R32-Roger_Federer-Jeremy_Chardy,1,S-DTL,2,0,0,0,0,0,2
20140514-M-Rome_Masters-R32-Roger_Federer-Jeremy_Chardy,2,F-XC,37,14,3,5,6,20,17
20140514-M-Rome_Masters-R32-Roger_Federer-Jeremy_Chardy,2,F-DTM,20,5,0,3,2,10,10
20140514-M-Rome_Masters-R32-Roger_Federer-Jeremy_Chardy,2,F-DTL,21,2,0,1,1,7,14
20140514-M-Rome_Masters-R32-Roger_Federer-Jeremy_Chardy,2,F-IO,41,9,0,5,4,26,15
20140514-M-Rome_Masters-R32-Roger_Federer-Jeremy_Chardy,2,F-II,9,4,1,2,0,7,2
20140514-M-Rome_Masters-R32-Roger_Federer-Jeremy_Chardy,2,B-XC,26,2,1,1,0,12,14
20140514-M-Rome_Masters-R32-Roger_Federer-Jeremy_Chardy,2,B-DTM,30,1,0,0,1,12,18
20140514-M-Rome_Masters-R32-Roger_Federer-Jeremy_Chardy,2,B-DTL,8,4,0,2,2,5,3
20140514-M-Rome_Masters-R32-Roger_Federer-Jeremy_Chardy,2,B-IO,5,3,1,1,1,2,3
20140514-M-Rome_Masters-R32-Roger_Federer-Jeremy_Chardy,2,S-XC,18,1,0,0,1,8,10
20140514-M-Rome_Masters-R32-Roger_Federer-Jeremy_Chardy,2,S-DTM,5,0,0,0,0,5,0
20140514-M-Rome_Masters-R32-Roger_Federer-Jeremy_Chardy,2,S-IO,1,1,0,1,0,1,0
20150228-M-Dubai-F-Roger_Federer-Novak_Djokovic,1,F-XC,23,8,1,0,7,9,14
20150228-M-Dubai-F-Roger_Federer-Novak_Djokovic,1,F-DTM,25,5,1,2,2,14,11
20150228-M-Dubai-F-Roger_Federer-Novak_Djokovic,1,F-DTL,4,3,2,0,1,2,2
20150228-M-Dubai-F-Roger_Federer-Novak_Djokovic,1,F-IO,25,6,5,0,1,12,13
20150228-M-Dubai-F-Roger_Federer-Novak_Djokovic,1,F-II,4,3,2,0,1,3,1
20150228-M-Dubai-F-Roger_Federer-Novak_Djokovic,1,B-XC,15,3,0,0,3,7,8
20150228-M-Dubai-F-Roger_Federer-Novak_Djokovic,1,B-DTM,16,2,0,1,1,9,7
20150228-M-Dubai-F-Roger_Federer-Novak_Djokovic,1,B-DTL,9,6,3,0,3,4,5
20150228-M-Dubai-F-Roger_Federer-Novak_Djokovic,1,B-IO,1,1,0,0,1,0,1
20150228-M-Dubai-F-Roger_Federer-Novak_Djokovic,1,S-XC,7,1,0,0,1,4,3
20150228-M-Dubai-F-Roger_Federer-Novak_Djokovic,1,S-DTM,11,1,0,0,1,3,8
20150228-M-Dubai-F-Roger_Federer-Novak_Djokovic,1,S-IO,1,0,0,0,0,1,0
20150228-M-Dubai-F-Roger_Federer-Novak_Djokovic,2,F-XC,30,9,4,0,5,14,16
20150228-M-Dubai-F-Roger_Federer-Novak_Djokovic,2,F-DTM,19,1,1,0,0,12,7
20150228-M-Dubai-F-Roger_Federer-Novak_Djokovic,2,F-DTL,7,0,0,0,0,3,4
20150228-M-Dubai-F-Roger_Federer-Novak_Djokovic,2,F-IO,17,6,2,0,4,8,9
20150228-M-Dubai-F-Roger_Federer-Novak_Djokovic,2,F-II,3,2,2,0,0,3,0
20150228-M-Dubai-F-Roger_Federer-Novak_Djokovic,2,B-XC,32,7,1,3,3,16,16
20150228-M-Dubai-F-Roger_Federer-Novak_Djokovic,2,B-DTM,22,2,0,0,2,11,11
20150228-M-Dubai-F-Roger_Federer-Novak_Djokovic,2,B-DTL,2,1,1,0,0,2,0
20150228-M-Dubai-F-Roger_Federer-Novak_Djokovic,2,B-IO,9,3,2,1,0,6,3
20150228-M-Dubai-F-Roger_Federer-Novak_Djokovic,2,S-XC,4,0,0,0,0,1,3
20150228-M-Dubai-F-Roger_Federer-Novak_Djokovic,2,S-DTM,1,0,0,0,0,1,0
20150228-M-Dubai-F-Roger_Federer-Novak_Djokovic,2,S-DTL,1,0,0,0,0,0,1
20150227-M-Acapulco-SF-Kevin_Anderson-Kei_Nishikori,1,F-XC,39,10,5,3,2,23,16
20150227-M-Acapulco-SF-Kevin_Anderson-Kei_Nishikori,1,F-DTM,18,6,0,0,6,8,10
20150227-M-Acapulco-SF-Kevin_Anderson-Kei_Nishikori,1,F-DTL,4,3,0,2,1,3,1
20150227-M-Acapulco-SF-Kevin_Anderson-Kei_Nishikori,1,F-IO,26,9,6,1,2,12,14
20150227-M-Acapulco-SF-Kevin_Anderson-Kei_Nishikori,1,F-II,7,4,3,0,1,4,3
20150227-M-Acapulco-SF-Kevin_Anderson-Kei_Nishikori,1,B-XC,45,8,1,1,6,15,30
20150227-M-Acapulco-SF-Kevin_Anderson-Kei_Nishikori,1,B-DTM,41,2,0,0,2,23,18
20150227-M-Acapulco-SF-Kevin_Anderson-Kei_Nishikori,1,B-DTL,9,5,1,0,4,2,7
20150227-M-Acapulco-SF-Kevin_Anderson-Kei_Nishikori,1,B-IO,3,1,0,0,1,2,1
20150227-M-Acapulco-SF-Kevin_Anderson-Kei_Nishikori,1,S-XC,9,2,0,0,2,2,7
20150227-M-Acapulco-SF-Kevin_Anderson-Kei_Nishikori,1,S-DTM,4,0,0,0,0,1,3
20150227-M-Acapulco-SF-Kevin_Anderson-Kei_Nishikori,1,S-IO,1,0,0,0,0,0,1
20150227-M-Acapulco-SF-Kevin_Anderson-Kei_Nishikori,2,F-XC,32,9,4,3,2,20,12
20150227-M-Acapulco-SF-Kevin_Anderson-Kei_Nishikori,2,F-DTM,25,3,1,0,2,12,13
20150227-M-Acapulco-SF-Kevin_Anderson-Kei_Nishikori,2,F-DTL,16,5,1,2,2,8,8
20150227-M-Acapulco-SF-Kevin_Anderson-Kei_Nishikori,2,F-IO,12,4,2,0,2,5,7
20150227-M-Acapulco-SF-Kevin_Anderson-Kei_Nishikori,2,F-II,3,3,2,0,1,2,1
20150227-M-Acapulco-SF-Kevin_Anderson-Kei_Nishikori,2,B-XC,59,5,1,0,4,38,21
20150227-M-Acapulco-SF-Kevin_Anderson-Kei_Nishikori,2,B-DTM,31,4,1,1,2,17,14
20150227-M-Acapulco-SF-Kevin_Anderson-Kei_Nishikori,2,B-DTL,7,7,6,1,0,7,0
20150227-M-Acapulco-SF-Kevin_Anderson-Kei_Nishikori,2,B-IO,6,3,2,0,1,3,3
20150227-M-Acapulco-SF-Kevin_Anderson-Kei_Nishikori,2,S-XC,11,1,0,0,1,3,8
20150227-M-Acapulco-SF-Kevin_Anderson-Kei_Nishikori,2,S-DTM,3,0,0,0,0,1,2
20150227-M-Dubai-SF-Roger_Federer-Borna_Coric,1,F-XC,23,5,1,2,2,12,11
20150227-M-Dubai-SF-Roger_Federer-Borna_Coric,1,F-DTM,29,5,0,1,4,17,12
20150227-M-Dubai-SF-Roger_Federer-Borna_Coric,1,F-DTL,1,0,0,0,0,1,0
20150227-M-Dubai-SF-Roger_Federer-Borna_Coric,1,F-IO,16,5,1,0,4,11,5
20150227-M-Dubai-SF-Roger_Federer-Borna_Coric,1,F-II,2,1,0,0,1,0,2
20150227-M-Dubai-SF-Roger_Federer-Borna_Coric,1,B-XC,9,2,0,0,2,3,6
20150227-M-Dubai-SF-Roger_Federer-Borna_Coric,1,B-DTM,15,0,0,0,0,8,7
20150227-M-Dubai-SF-Roger_Federer-Borna_Coric,1,B-DTL,3,1,1,0,0,1,2
20150227-M-Dubai-SF-Roger_Federer-Borna_Coric,1,B-IO,1,1,0,0,1,0,1
20150227-M-Dubai-SF-Roger_Federer-Borna_Coric,1,S-XC,18,1,0,0,1,10,8
20150227-M-Dubai-SF-Roger_Federer-Borna_Coric,1,S-DTM,9,0,0,0,0,5,4
20150227-M-Dubai-SF-Roger_Federer-Borna_Coric,1,S-DTL,1,0,0,0,0,1,0
20150227-M-Dubai-SF-Roger_Federer-Borna_Coric,1,S-IO,2,0,0,0,0,0,2
20150227-M-Dubai-SF-Roger_Federer-Borna_Coric,2,F-XC,26,7,0,1,6,9,17
20150227-M-Dubai-SF-Roger_Federer-Borna_Coric,2,F-DTM,29,2,1,0,1,16,13
20150227-M-Dubai-SF-Roger_Federer-Borna_Coric,2,F-DTL,4,0,0,0,0,3,1
20150227-M-Dubai-SF-Roger_Federer-Borna_Coric,2,F-IO,23,3,0,1,2,11,12
20150227-M-Dubai-SF-Roger_Federer-Borna_Coric,2,F-II,2,1,0,1,0,1,1
20150227-M-Dubai-SF-Roger_Federer-Borna_Coric,2,B-XC,25,1,0,0,1,5,20
20150227-M-Dubai-SF-Roger_Federer-Borna_Coric,2,B-DTM,20,2,0,0,2,6,14
20150227-M-Dubai-SF-Roger_Federer-Borna_Coric,2,B-DTL,3,1,0,0,1,1,2
20150227-M-Dubai-SF-Roger_Federer-Borna_Coric,2,B-IO,2,2,0,0,2,0,2
20150227-M-Dubai-SF-Roger_Federer-Borna_Coric,2,B-II,1,0,0,0,0,1,0
20150227-M-Dubai-SF-Roger_Federer-Borna_Coric,2,S-XC,3,1,0,0,1,1,2
20150226-M-Dubai-QF-Andy_Murray-Borna_Coric,1,F-XC,51,12,2,0,10,19,32
20150226-M-Dubai-QF-Andy_Murray-Borna_Coric,1,F-DTM,31,5,0,0,5,13,18
20150226-M-Dubai-QF-Andy_Murray-Borna_Coric,1,F-DTL,10,2,1,0,1,5,5
20150226-M-Dubai-QF-Andy_Murray-Borna_Coric,1,F-IO,35,7,2,1,4,17,18
20150226-M-Dubai-QF-Andy_Murray-Borna_Coric,1,B-XC,54,15,1,1,13,21,33
20150226-M-Dubai-QF-Andy_Murray-Borna_Coric,1,B-DTM,34,2,0,0,2,11,23
20150226-M-Dubai-QF-Andy_Murray-Borna_Coric,1,B-DTL,5,2,0,0,2,2,3
20150226-M-Dubai-QF-Andy_Murray-Borna_Coric,1,B-IO,5,1,0,0,1,2,3
20150226-M-Dubai-QF-Andy_Murray-Borna_Coric,1,S-XC,12,1,0,0,1,8,4
20150226-M-Dubai-QF-Andy_Murray-Borna_Coric,1,S-DTM,10,1,0,0,1,3,7
20150226-M-Dubai-QF-Andy_Murray-Borna_Coric,1,S-IO,4,1,0,0,1,1,3
20150226-M-Dubai-QF-Andy_Murray-Borna_Coric,2,F-XC,37,2,0,2,0,24,13
20150226-M-Dubai-QF-Andy_Murray-Borna_Coric,2,F-DTM,41,1,0,0,1,23,18
20150226-M-Dubai-QF-Andy_Murray-Borna_Coric,2,F-DTL,8,1,1,0,0,5,3
20150226-M-Dubai-QF-Andy_Murray-Borna_Coric,2,F-IO,14,4,0,0,4,7,7
20150226-M-Dubai-QF-Andy_Murray-Borna_Coric,2,F-II,2,0,0,0,0,1,1
20150226-M-Dubai-QF-Andy_Murray-Borna_Coric,2,B-XC,55,5,2,0,3,34,21
20150226-M-Dubai-QF-Andy_Murray-Borna_Coric,2,B-DTM,42,2,0,0,2,22,20
20150226-M-Dubai-QF-Andy_Murray-Borna_Coric,2,B-IO,4,2,1,0,1,3,1
20150226-M-Dubai-QF-Andy_Murray-Borna_Coric,2,S-XC,13,0,0,0,0,4,9
20150226-M-Dubai-QF-Andy_Murray-Borna_Coric,2,S-DTM,10,0,0,0,0,7,3
20150226-M-Dubai-QF-Andy_Murray-Borna_Coric,2,S-DTL,1,0,0,0,0,1,0
20150226-M-Acapulco-QF-Viktor_Troicki-Kevin_Anderson,1,F-XC,15,3,0,1,2,6,9
20150226-M-Acapulco-QF-Viktor_Troicki-Kevin_Anderson,1,F-DTM,19,3,0,1,2,6,13
20150226-M-Acapulco-QF-Viktor_Troicki-Kevin_Anderson,1,F-DTL,8,5,1,2,2,4,4
20150226-M-Acapulco-QF-Viktor_Troicki-Kevin_Anderson,1,F-IO,9,3,2,1,0,6,3
20150226-M-Acapulco-QF-Viktor_Troicki-Kevin_Anderson,1,B-XC,50,4,0,2,2,20,30
20150226-M-Acapulco-QF-Viktor_Troicki-Kevin_Anderson,1,B-DTM,18,1,0,0,1,4,14
20150226-M-Acapulco-QF-Viktor_Troicki-Kevin_Anderson,1,B-DTL,6,5,2,1,2,3,3
20150226-M-Acapulco-QF-Viktor_Troicki-Kevin_Anderson,1,B-IO,3,1,0,0,1,0,3
20150226-M-Acapulco-QF-Viktor_Troicki-Kevin_Anderson,1,S-XC,2,1,0,0,1,1,1
20150226-M-Acapulco-QF-Viktor_Troicki-Kevin_Anderson,1,S-DTM,9,0,0,0,0,5,4
20150226-M-Acapulco-QF-Viktor_Troicki-Kevin_Anderson,1,S-DTL,3,0,0,0,0,1,2
20150226-M-Acapulco-QF-Viktor_Troicki-Kevin_Anderson,1,S-IO,1,0,0,0,0,0,1
20150226-M-Acapulco-QF-Viktor_Troicki-Kevin_Anderson,2,F-XC,37,14,5,4,5,23,14
20150226-M-Acapulco-QF-Viktor_Troicki-Kevin_Anderson,2,F-DTM,13,0,0,0,0,8,5
20150226-M-Acapulco-QF-Viktor_Troicki-Kevin_Anderson,2,F-DTL,3,1,1,0,0,2,1
20150226-M-Acapulco-QF-Viktor_Troicki-Kevin_Anderson,2,F-IO,34,12,4,5,3,22,12
20150226-M-Acapulco-QF-Viktor_Troicki-Kevin_Anderson,2,F-II,3,1,0,1,0,1,2
20150226-M-Acapulco-QF-Viktor_Troicki-Kevin_Anderson,2,B-XC,38,8,4,2,2,24,14
20150226-M-Acapulco-QF-Viktor_Troicki-Kevin_Anderson,2,B-DTM,14,2,0,0,2,9,5
20150226-M-Acapulco-QF-Viktor_Troicki-Kevin_Anderson,2,B-DTL,2,0,0,0,0,1,1
20150226-M-Acapulco-QF-Viktor_Troicki-Kevin_Anderson,2,B-IO,2,2,2,0,0,2,0
20150226-M-Acapulco-QF-Viktor_Troicki-Kevin_Anderson,2,S-XC,5,1,0,0,1,2,3
20150226-M-Acapulco-QF-Viktor_Troicki-Kevin_Anderson,2,S-DTM,3,0,0,0,0,3,0
20150226-M-Acapulco-QF-Viktor_Troicki-Kevin_Anderson,2,S-DTL,1,0,0,0,0,0,1
20140101-M-Brisbane-R16-Marin_Cilic-Grigor_Dimitrov,1,F-XC,21,8,3,0,5,10,11
20140101-M-Brisbane-R16-Marin_Cilic-Grigor_Dimitrov,1,F-DTM,17,0,0,0,0,6,11
20140101-M-Brisbane-R16-Marin_Cilic-Grigor_Dimitrov,1,F-DTL,8,2,0,1,1,4,4
20140101-M-Brisbane-R16-Marin_Cilic-Grigor_Dimitrov,1,F-IO,38,13,3,5,5,21,17
20140101-M-Brisbane-R16-Marin_Cilic-Grigor_Dimitrov,1,F-II,1,1,0,1,0,1,0
20140101-M-Brisbane-R16-Marin_Cilic-Grigor_Dimitrov,1,B-XC,27,2,0,0,2,8,19
20140101-M-Brisbane-R16-Marin_Cilic-Grigor_Dimitrov,1,B-DTM,18,6,0,0,6,6,12
20140101-M-Brisbane-R16-Marin_Cilic-Grigor_Dimitrov,1,B-DTL,5,5,1,0,4,1,4
20140101-M-Brisbane-R16-Marin_Cilic-Grigor_Dimitrov,1,B-IO,1,1,0,1,0,1,0
20140101-M-Brisbane-R16-Marin_Cilic-Grigor_Dimitrov,1,S-XC,6,0,0,0,0,5,1
20140101-M-Brisbane-R16-Marin_Cilic-Grigor_Dimitrov,1,S-DTM,2,0,0,0,0,0,2
20140101-M-Brisbane-R16-Marin_Cilic-Grigor_Dimitrov,2,F-XC,23,7,5,0,2,17,6
20140101-M-Brisbane-R16-Marin_Cilic-Grigor_Dimitrov,2,F-DTM,23,3,0,0,3,8,15
20140101-M-Brisbane-R16-Marin_Cilic-Grigor_Dimitrov,2,F-DTL,4,2,0,1,1,2,2
20140101-M-Brisbane-R16-Marin_Cilic-Grigor_Dimitrov,2,F-IO,24,4,1,1,2,15,9
20140101-M-Brisbane-R16-Marin_Cilic-Grigor_Dimitrov,2,F-II,3,2,2,0,0,2,1
20140101-M-Brisbane-R16-Marin_Cilic-Grigor_Dimitrov,2,B-XC,18,4,0,2,2,11,7
20140101-M-Brisbane-R16-Marin_Cilic-Grigor_Dimitrov,2,B-DTM,19,2,0,0,2,11,8
20140101-M-Brisbane-R16-Marin_Cilic-Grigor_Dimitrov,2,S-XC,22,6,1,0,5,12,10
20140101-M-Brisbane-R16-Marin_Cilic-Grigor_Dimitrov,2,S-DTM,7,2,0,0,2,2,5
20140101-M-Brisbane-R16-Marin_Cilic-Grigor_Dimitrov,2,S-DTL,4,0,0,0,0,2,2
20140101-M-Brisbane-R16-Marin_Cilic-Grigor_Dimitrov,2,S-IO,1,1,0,0,1,0,1
20150215-M-Sao_Paulo-F-Luca_Vanni-Pablo_Cuevas,1,F-XC,37,19,7,5,7,15,22
20150215-M-Sao_Paulo-F-Luca_Vanni-Pablo_Cuevas,1,F-DTM,25,4,1,0,3,8,17
20150215-M-Sao_Paulo-F-Luca_Vanni-Pablo_Cuevas,1,F-DTL,10,4,0,0,4,1,9
20150215-M-Sao_Paulo-F-Luca_Vanni-Pablo_Cuevas,1,F-IO,43,14,5,4,5,26,17
20150215-M-Sao_Paulo-F-Luca_Vanni-Pablo_Cuevas,1,F-II,2,1,1,0,0,2,0
20150215-M-Sao_Paulo-F-Luca_Vanni-Pablo_Cuevas,1,B-XC,40,6,0,0,6,9,31
20150215-M-Sao_Paulo-F-Luca_Vanni-Pablo_Cuevas,1,B-DTM,26,2,0,0,2,11,15
20150215-M-Sao_Paulo-F-Luca_Vanni-Pablo_Cuevas,1,B-DTL,9,6,1,0,5,2,7
20150215-M-Sao_Paulo-F-Luca_Vanni-Pablo_Cuevas,1,B-IO,10,6,1,0,5,2,8
20150215-M-Sao_Paulo-F-Luca_Vanni-Pablo_Cuevas,1,S-XC,10,0,0,0,0,1,9
20150215-M-Sao_Paulo-F-Luca_Vanni-Pablo_Cuevas,1,S-DTM,1,0,0,0,0,1,0
20150215-M-Sao_Paulo-F-Luca_Vanni-Pablo_Cuevas,1,S-DTL,2,1,1,0,0,1,1
20150215-M-Sao_Paulo-F-Luca_Vanni-Pablo_Cuevas,2,F-XC,43,14,5,4,5,29,14
20150215-M-Sao_Paulo-F-Luca_Vanni-Pablo_Cuevas,2,F-DTM,26,2,0,1,1,17,9
20150215-M-Sao_Paulo-F-Luca_Vanni-Pablo_Cuevas,2,F-DTL,4,1,0,1,0,3,1
20150215-M-Sao_Paulo-F-Luca_Vanni-Pablo_Cuevas,2,F-IO,28,8,2,4,2,20,8
20150215-M-Sao_Paulo-F-Luca_Vanni-Pablo_Cuevas,2,F-II,7,2,1,1,0,6,1
20150215-M-Sao_Paulo-F-Luca_Vanni-Pablo_Cuevas,2,B-XC,56,9,1,2,6,38,18
20150215-M-Sao_Paulo-F-Luca_Vanni-Pablo_Cuevas,2,B-DTM,18,2,0,0,2,12,6
20150215-M-Sao_Paulo-F-Luca_Vanni-Pablo_Cuevas,2,B-DTL,1,0,0,0,0,1,0
20150215-M-Sao_Paulo-F-Luca_Vanni-Pablo_Cuevas,2,B-IO,3,3,1,0,2,1,2
20150215-M-Sao_Paulo-F-Luca_Vanni-Pablo_Cuevas,2,S-XC,14,2,0,0,2,4,10
20150215-M-Sao_Paulo-F-Luca_Vanni-Pablo_Cuevas,2,S-DTM,6,0,0,0,0,3,3
20150215-M-Sao_Paulo-F-Luca_Vanni-Pablo_Cuevas,2,S-DTL,1,0,0,0,0,0,1
20150214-M-Sao_Paulo-SF-Santiago_Giraldo-Pablo_Cuevas,1,F-XC,30,10,1,5,4,16,14
20150214-M-Sao_Paulo-SF-Santiago_Giraldo-Pablo_Cuevas,1,F-DTM,22,1,0,0,1,8,14
20150214-M-Sao_Paulo-SF-Santiago_Giraldo-Pablo_Cuevas,1,F-DTL,7,1,1,0,0,2,5
20150214-M-Sao_Paulo-SF-Santiago_Giraldo-Pablo_Cuevas,1,F-IO,21,5,0,2,3,9,12
20150214-M-Sao_Paulo-SF-Santiago_Giraldo-Pablo_Cuevas,1,F-II,5,3,1,1,1,4,1
20150214-M-Sao_Paulo-SF-Santiago_Giraldo-Pablo_Cuevas,1,B-XC,37,7,3,0,4,19,18
20150214-M-Sao_Paulo-SF-Santiago_Giraldo-Pablo_Cuevas,1,B-DTM,17,4,0,0,4,6,11
20150214-M-Sao_Paulo-SF-Santiago_Giraldo-Pablo_Cuevas,1,B-DTL,8,6,3,1,2,5,3
20150214-M-Sao_Paulo-SF-Santiago_Giraldo-Pablo_Cuevas,1,S-XC,1,0,0,0,0,1,0
20150214-M-Sao_Paulo-SF-Santiago_Giraldo-Pablo_Cuevas,1,S-DTM,1,0,0,0,0,1,0
20150214-M-Sao_Paulo-SF-Santiago_Giraldo-Pablo_Cuevas,2,F-XC,34,9,4,2,3,20,14
20150214-M-Sao_Paulo-SF-Santiago_Giraldo-Pablo_Cuevas,2,F-DTM,15,1,0,0,1,10,5
20150214-M-Sao_Paulo-SF-Santiago_Giraldo-Pablo_Cuevas,2,F-DTL,1,0,0,0,0,0,1
20150214-M-Sao_Paulo-SF-Santiago_Giraldo-Pablo_Cuevas,2,F-IO,16,6,1,1,4,5,11
20150214-M-Sao_Paulo-SF-Santiago_Giraldo-Pablo_Cuevas,2,F-II,4,1,0,1,0,2,2
20150214-M-Sao_Paulo-SF-Santiago_Giraldo-Pablo_Cuevas,2,B-XC,42,2,0,0,2,24,18
20150214-M-Sao_Paulo-SF-Santiago_Giraldo-Pablo_Cuevas,2,B-DTM,10,1,0,0,1,4,6
20150214-M-Sao_Paulo-SF-Santiago_Giraldo-Pablo_Cuevas,2,B-DTL,3,1,1,0,0,1,2
20150214-M-Sao_Paulo-SF-Santiago_Giraldo-Pablo_Cuevas,2,B-IO,1,1,0,0,1,0,1
20150214-M-Sao_Paulo-SF-Santiago_Giraldo-Pablo_Cuevas,2,S-XC,4,1,1,0,0,2,2
20150214-M-Sao_Paulo-SF-Santiago_Giraldo-Pablo_Cuevas,2,S-DTM,4,0,0,0,0,1,3
20150312-M-Indian_Wells_Masters-R128-Tim_Smyczek-Benjamin_Becker,1,F-XC,29,7,2,1,4,19,10
20150312-M-Indian_Wells_Masters-R128-Tim_Smyczek-Benjamin_Becker,1,F-DTM,34,2,0,0,2,20,14
20150312-M-Indian_Wells_Masters-R128-Tim_Smyczek-Benjamin_Becker,1,F-DTL,9,4,1,1,2,6,3
20150312-M-Indian_Wells_Masters-R128-Tim_Smyczek-Benjamin_Becker,1,F-IO,34,13,7,2,4,26,8
20150312-M-Indian_Wells_Masters-R128-Tim_Smyczek-Benjamin_Becker,1,F-II,1,0,0,0,0,1,0
20150312-M-Indian_Wells_Masters-R128-Tim_Smyczek-Benjamin_Becker,1,B-XC,26,3,0,1,2,14,12
20150312-M-Indian_Wells_Masters-R128-Tim_Smyczek-Benjamin_Becker,1,B-DTM,21,4,0,0,4,12,9
20150312-M-Indian_Wells_Masters-R128-Tim_Smyczek-Benjamin_Becker,1,B-DTL,6,4,4,0,0,5,1
20150312-M-Indian_Wells_Masters-R128-Tim_Smyczek-Benjamin_Becker,1,B-IO,2,1,0,0,1,0,2
20150312-M-Indian_Wells_Masters-R128-Tim_Smyczek-Benjamin_Becker,1,S-XC,4,1,0,1,0,2,2
20150312-M-Indian_Wells_Masters-R128-Tim_Smyczek-Benjamin_Becker,1,S-DTM,3,0,0,0,0,2,1
20150312-M-Indian_Wells_Masters-R128-Tim_Smyczek-Benjamin_Becker,2,F-XC,37,12,1,3,8,14,23
20150312-M-Indian_Wells_Masters-R128-Tim_Smyczek-Benjamin_Becker,2,F-DTM,30,1,0,0,1,12,18
20150312-M-Indian_Wells_Masters-R128-Tim_Smyczek-Benjamin_Becker,2,F-DTL,3,1,0,0,1,0,3
20150312-M-Indian_Wells_Masters-R128-Tim_Smyczek-Benjamin_Becker,2,F-IO,39,10,1,5,4,21,18
20150312-M-Indian_Wells_Masters-R128-Tim_Smyczek-Benjamin_Becker,2,F-II,2,2,1,0,1,1,1
20150312-M-Indian_Wells_Masters-R128-Tim_Smyczek-Benjamin_Becker,2,B-XC,17,2,0,2,0,5,12
20150312-M-Indian_Wells_Masters-R128-Tim_Smyczek-Benjamin_Becker,2,B-DTM,26,3,0,0,3,7,19
20150312-M-Indian_Wells_Masters-R128-Tim_Smyczek-Benjamin_Becker,2,B-DTL,3,2,0,0,2,0,3
20150312-M-Indian_Wells_Masters-R128-Tim_Smyczek-Benjamin_Becker,2,B-IO,1,0,0,0,0,0,1
20150312-M-Indian_Wells_Masters-R128-Tim_Smyczek-Benjamin_Becker,2,S-XC,9,1,0,0,1,2,7
20150312-M-Indian_Wells_Masters-R128-Tim_Smyczek-Benjamin_Becker,2,S-DTM,8,5,0,0,5,1,7
20150312-M-Indian_Wells_Masters-R128-Tim_Smyczek-Benjamin_Becker,2,S-IO,1,0,0,0,0,0,1
20150313-M-Indian_Wells_Masters-R128-Sam_Querrey-Sergiy_Stakhovsky,1,F-XC,1,0,0,0,0,0,1
20150313-M-Indian_Wells_Masters-R128-Sam_Querrey-Sergiy_Stakhovsky,1,F-DTM,3,1,0,0,1,0,3
20150313-M-Indian_Wells_Masters-R128-Sam_Querrey-Sergiy_Stakhovsky,1,F-IO,1,0,0,0,0,0,1
20150313-M-Indian_Wells_Masters-R128-Sam_Querrey-Sergiy_Stakhovsky,1,B-DTM,2,1,0,0,1,0,2
20150313-M-Indian_Wells_Masters-R128-Sam_Querrey-Sergiy_Stakhovsky,2,F-XC,3,1,1,0,0,3,0
20150313-M-Indian_Wells_Masters-R128-Sam_Querrey-Sergiy_Stakhovsky,2,F-DTM,1,0,0,0,0,1,0
20150313-M-Indian_Wells_Masters-R128-Sam_Querrey-Sergiy_Stakhovsky,2,F-IO,1,0,0,0,0,1,0
20150313-M-Indian_Wells_Masters-R128-Sam_Querrey-Sergiy_Stakhovsky,2,B-XC,2,2,1,0,1,1,1
20150313-M-Indian_Wells_Masters-R128-Sam_Querrey-Sergiy_Stakhovsky,2,B-DTL,1,0,0,0,0,1,0
20150313-M-Indian_Wells_Masters-R128-Sam_Querrey-Sergiy_Stakhovsky,2,B-IO,1,0,0,0,0,1,0
20150313-M-Indian_Wells_Masters-R128-Sam_Querrey-Sergiy_Stakhovsky,2,S-XC,1,0,0,0,0,1,0
20150313-M-Indian_Wells_Masters-R128-Sam_Querrey-Sergiy_Stakhovsky,2,S-DTM,1,0,0,0,0,1,0
20150313-M-Indian_Wells_Masters-R128-Denis_Kudla-Nick_Kyrgios,1,F-XC,25,11,8,0,3,17,8
20150313-M-Indian_Wells_Masters-R128-Denis_Kudla-Nick_Kyrgios,1,F-DTM,20,1,0,1,0,10,10
20150313-M-Indian_Wells_Masters-R128-Denis_Kudla-Nick_Kyrgios,1,F-DTL,10,1,1,0,0,6,4
20150313-M-Indian_Wells_Masters-R128-Denis_Kudla-Nick_Kyrgios,1,F-IO,13,4,1,2,1,8,5
20150313-M-Indian_Wells_Masters-R128-Denis_Kudla-Nick_Kyrgios,1,F-II,4,1,0,0,1,1,3
20150313-M-Indian_Wells_Masters-R128-Denis_Kudla-Nick_Kyrgios,1,B-XC,18,3,0,0,3,7,11
20150313-M-Indian_Wells_Masters-R128-Denis_Kudla-Nick_Kyrgios,1,B-DTM,20,4,0,0,4,9,11
20150313-M-Indian_Wells_Masters-R128-Denis_Kudla-Nick_Kyrgios,1,B-DTL,10,7,1,0,6,3,7
20150313-M-Indian_Wells_Masters-R128-Denis_Kudla-Nick_Kyrgios,1,B-IO,6,3,2,1,0,5,1
20150313-M-Indian_Wells_Masters-R128-Denis_Kudla-Nick_Kyrgios,1,S-XC,3,0,0,0,0,2,1
20150313-M-Indian_Wells_Masters-R128-Denis_Kudla-Nick_Kyrgios,1,S-DTM,4,2,0,0,2,0,4
20150313-M-Indian_Wells_Masters-R128-Denis_Kudla-Nick_Kyrgios,1,S-DTL,1,0,0,0,0,1,0
20150313-M-Indian_Wells_Masters-R128-Denis_Kudla-Nick_Kyrgios,1,S-IO,1,0,0,0,0,1,0
20150313-M-Indian_Wells_Masters-R128-Denis_Kudla-Nick_Kyrgios,2,F-XC,29,7,2,2,3,15,14
20150313-M-Indian_Wells_Masters-R128-Denis_Kudla-Nick_Kyrgios,2,F-DTM,17,2,0,0,2,7,10
20150313-M-Indian_Wells_Masters-R128-Denis_Kudla-Nick_Kyrgios,2,F-DTL,4,2,1,0,1,2,2
20150313-M-Indian_Wells_Masters-R128-Denis_Kudla-Nick_Kyrgios,2,F-IO,12,4,3,0,1,7,5
20150313-M-Indian_Wells_Masters-R128-Denis_Kudla-Nick_Kyrgios,2,B-XC,29,8,0,2,6,16,13
20150313-M-Indian_Wells_Masters-R128-Denis_Kudla-Nick_Kyrgios,2,B-DTM,18,2,0,0,2,7,11
20150313-M-Indian_Wells_Masters-R128-Denis_Kudla-Nick_Kyrgios,2,B-DTL,2,2,0,0,2,0,2
20150313-M-Indian_Wells_Masters-R128-Denis_Kudla-Nick_Kyrgios,2,B-IO,2,0,0,0,0,0,2
20150313-M-Indian_Wells_Masters-R128-Denis_Kudla-Nick_Kyrgios,2,S-XC,4,0,0,0,0,4,0
20150313-M-Indian_Wells_Masters-R128-Denis_Kudla-Nick_Kyrgios,2,S-DTM,4,0,0,0,0,1,3
20150313-M-Indian_Wells_Masters-R128-Denis_Kudla-Nick_Kyrgios,2,S-IO,1,0,0,0,0,1,0
20150315-M-Indian_Wells_Masters-R64-Diego_Sebastian_Schwartzman-Roger_Federer,1,F-XC,10,2,1,0,1,7,3
20150315-M-Indian_Wells_Masters-R64-Diego_Sebastian_Schwartzman-Roger_Federer,1,F-DTM,13,1,0,0,1,2,11
20150315-M-Indian_Wells_Masters-R64-Diego_Sebastian_Schwartzman-Roger_Federer,1,F-DTL,5,1,1,0,0,2,3
20150315-M-Indian_Wells_Masters-R64-Diego_Sebastian_Schwartzman-Roger_Federer,1,F-IO,23,8,1,3,4,11,12
20150315-M-Indian_Wells_Masters-R64-Diego_Sebastian_Schwartzman-Roger_Federer,1,F-II,2,0,0,0,0,1,1
20150315-M-Indian_Wells_Masters-R64-Diego_Sebastian_Schwartzman-Roger_Federer,1,B-XC,32,6,0,0,6,20,12
20150315-M-Indian_Wells_Masters-R64-Diego_Sebastian_Schwartzman-Roger_Federer,1,B-DTM,15,1,0,0,1,6,9
20150315-M-Indian_Wells_Masters-R64-Diego_Sebastian_Schwartzman-Roger_Federer,1,B-DTL,1,1,1,0,0,1,0
20150315-M-Indian_Wells_Masters-R64-Diego_Sebastian_Schwartzman-Roger_Federer,1,B-IO,1,0,0,0,0,1,0
20150315-M-Indian_Wells_Masters-R64-Diego_Sebastian_Schwartzman-Roger_Federer,1,S-XC,2,0,0,0,0,2,0
20150315-M-Indian_Wells_Masters-R64-Diego_Sebastian_Schwartzman-Roger_Federer,2,F-XC,12,5,1,2,2,10,2
20150315-M-Indian_Wells_Masters-R64-Diego_Sebastian_Schwartzman-Roger_Federer,2,F-DTM,13,1,0,0,1,5,8
20150315-M-Indian_Wells_Masters-R64-Diego_Sebastian_Schwartzman-Roger_Federer,2,F-DTL,5,2,1,0,1,3,2
20150315-M-Indian_Wells_Masters-R64-Diego_Sebastian_Schwartzman-Roger_Federer,2,F-IO,13,5,0,3,2,8,5
20150315-M-Indian_Wells_Masters-R64-Diego_Sebastian_Schwartzman-Roger_Federer,2,F-II,3,1,0,0,1,0,3
20150315-M-Indian_Wells_Masters-R64-Diego_Sebastian_Schwartzman-Roger_Federer,2,B-XC,15,4,2,0,2,6,9
20150315-M-Indian_Wells_Masters-R64-Diego_Sebastian_Schwartzman-Roger_Federer,2,B-DTM,17,4,0,0,4,6,11
20150315-M-Indian_Wells_Masters-R64-Diego_Sebastian_Schwartzman-Roger_Federer,2,B-DTL,7,4,1,1,2,5,2
20150315-M-Indian_Wells_Masters-R64-Diego_Sebastian_Schwartzman-Roger_Federer,2,S-XC,9,0,0,0,0,5,4
20150315-M-Indian_Wells_Masters-R64-Diego_Sebastian_Schwartzman-Roger_Federer,2,S-DTL,1,1,0,0,1,0,1
20150213-M-Sao_Paulo-QF-Santiago_Giraldo-Fabio_Fognini,1,F-XC,31,9,4,2,3,17,14
20150213-M-Sao_Paulo-QF-Santiago_Giraldo-Fabio_Fognini,1,F-DTM,39,7,0,0,7,20,19
20150213-M-Sao_Paulo-QF-Santiago_Giraldo-Fabio_Fognini,1,F-DTL,10,1,0,1,0,9,1
20150213-M-Sao_Paulo-QF-Santiago_Giraldo-Fabio_Fognini,1,F-IO,59,11,3,4,4,35,24
20150213-M-Sao_Paulo-QF-Santiago_Giraldo-Fabio_Fognini,1,F-II,7,4,0,3,1,5,2
20150213-M-Sao_Paulo-QF-Santiago_Giraldo-Fabio_Fognini,1,B-XC,77,10,0,4,6,49,28
20150213-M-Sao_Paulo-QF-Santiago_Giraldo-Fabio_Fognini,1,B-DTM,34,2,0,0,2,21,13
20150213-M-Sao_Paulo-QF-Santiago_Giraldo-Fabio_Fognini,1,B-DTL,11,7,3,0,4,7,4
20150213-M-Sao_Paulo-QF-Santiago_Giraldo-Fabio_Fognini,1,B-IO,3,1,0,0,1,2,1
20150213-M-Sao_Paulo-QF-Santiago_Giraldo-Fabio_Fognini,1,S-XC,1,1,1,0,0,1,0
20150213-M-Sao_Paulo-QF-Santiago_Giraldo-Fabio_Fognini,1,S-DTM,3,0,0,0,0,0,3
20150213-M-Sao_Paulo-QF-Santiago_Giraldo-Fabio_Fognini,2,F-XC,42,15,3,3,9,14,28
20150213-M-Sao_Paulo-QF-Santiago_Giraldo-Fabio_Fognini,2,F-DTM,23,2,0,0,2,12,11
20150213-M-Sao_Paulo-QF-Santiago_Giraldo-Fabio_Fognini,2,F-DTL,8,4,3,1,0,6,2
20150213-M-Sao_Paulo-QF-Santiago_Giraldo-Fabio_Fognini,2,F-IO,41,13,3,5,5,20,21
20150213-M-Sao_Paulo-QF-Santiago_Giraldo-Fabio_Fognini,2,F-II,3,1,0,1,0,3,0
20150213-M-Sao_Paulo-QF-Santiago_Giraldo-Fabio_Fognini,2,B-XC,94,9,1,0,8,34,60
20150213-M-Sao_Paulo-QF-Santiago_Giraldo-Fabio_Fognini,2,B-DTM,26,2,0,0,2,10,16
20150213-M-Sao_Paulo-QF-Santiago_Giraldo-Fabio_Fognini,2,B-DTL,13,3,1,0,2,4,9
20150213-M-Sao_Paulo-QF-Santiago_Giraldo-Fabio_Fognini,2,B-IO,3,1,0,0,1,1,2
20150213-M-Sao_Paulo-QF-Santiago_Giraldo-Fabio_Fognini,2,S-XC,9,1,0,0,1,1,8
20150213-M-Sao_Paulo-QF-Santiago_Giraldo-Fabio_Fognini,2,S-DTM,6,1,0,0,1,1,5
20150213-M-Sao_Paulo-QF-Santiago_Giraldo-Fabio_Fognini,2,S-DTL,1,0,0,0,0,0,1
20150221-M-Marseille-SF-Roberto_Bautista_Agut-Gael_Monfils,1,F-XC,32,8,3,4,1,18,14
20150221-M-Marseille-SF-Roberto_Bautista_Agut-Gael_Monfils,1,F-DTM,7,0,0,0,0,2,5
20150221-M-Marseille-SF-Roberto_Bautista_Agut-Gael_Monfils,1,F-DTL,10,0,0,0,0,5,5
20150221-M-Marseille-SF-Roberto_Bautista_Agut-Gael_Monfils,1,F-IO,33,6,1,1,4,14,19
20150221-M-Marseille-SF-Roberto_Bautista_Agut-Gael_Monfils,1,F-II,6,3,0,2,1,2,4
20150221-M-Marseille-SF-Roberto_Bautista_Agut-Gael_Monfils,1,B-XC,23,5,0,1,4,3,20
20150221-M-Marseille-SF-Roberto_Bautista_Agut-Gael_Monfils,1,B-DTM,22,1,0,0,1,5,17
20150221-M-Marseille-SF-Roberto_Bautista_Agut-Gael_Monfils,1,B-DTL,6,0,0,0,0,1,5
20150221-M-Marseille-SF-Roberto_Bautista_Agut-Gael_Monfils,1,S-XC,5,1,0,0,1,2,3
20150221-M-Marseille-SF-Roberto_Bautista_Agut-Gael_Monfils,1,S-DTM,3,0,0,0,0,0,3
20150221-M-Marseille-SF-Roberto_Bautista_Agut-Gael_Monfils,1,S-DTL,3,0,0,0,0,1,2
20150221-M-Marseille-SF-Roberto_Bautista_Agut-Gael_Monfils,2,F-XC,23,6,5,0,1,18,5
20150221-M-Marseille-SF-Roberto_Bautista_Agut-Gael_Monfils,2,F-DTM,20,1,0,0,1,12,8
20150221-M-Marseille-SF-Roberto_Bautista_Agut-Gael_Monfils,2,F-DTL,5,1,0,0,1,2,3
20150221-M-Marseille-SF-Roberto_Bautista_Agut-Gael_Monfils,2,F-IO,12,3,1,1,1,11,1
20150221-M-Marseille-SF-Roberto_Bautista_Agut-Gael_Monfils,2,B-XC,40,3,0,1,2,29,11
20150221-M-Marseille-SF-Roberto_Bautista_Agut-Gael_Monfils,2,B-DTM,22,2,0,0,2,10,12
20150221-M-Marseille-SF-Roberto_Bautista_Agut-Gael_Monfils,2,B-DTL,4,1,0,1,0,4,0
20150221-M-Marseille-SF-Roberto_Bautista_Agut-Gael_Monfils,2,B-IO,1,0,0,0,0,0,1
20150221-M-Marseille-SF-Roberto_Bautista_Agut-Gael_Monfils,2,S-XC,2,0,0,0,0,1,1
20150221-M-Marseille-SF-Roberto_Bautista_Agut-Gael_Monfils,2,S-DTM,6,0,0,0,0,1,5
20150221-M-Marseille-SF-Roberto_Bautista_Agut-Gael_Monfils,2,S-DTL,1,0,0,0,0,0,1
20150217-M-Marseille-R32-Alexander_Zverev-Gael_Monfils,1,F-XC,37,5,1,1,3,19,18
20150217-M-Marseille-R32-Alexander_Zverev-Gael_Monfils,1,F-DTM,25,2,0,0,2,11,14
20150217-M-Marseille-R32-Alexander_Zverev-Gael_Monfils,1,F-DTL,10,1,1,0,0,5,5
20150217-M-Marseille-R32-Alexander_Zverev-Gael_Monfils,1,F-IO,15,5,1,1,3,7,8
20150217-M-Marseille-R32-Alexander_Zverev-Gael_Monfils,1,F-II,3,2,1,0,1,1,2
20150217-M-Marseille-R32-Alexander_Zverev-Gael_Monfils,1,B-XC,44,10,2,2,6,23,21
20150217-M-Marseille-R32-Alexander_Zverev-Gael_Monfils,1,B-DTM,30,1,0,0,1,11,19
20150217-M-Marseille-R32-Alexander_Zverev-Gael_Monfils,1,B-DTL,7,4,1,1,2,5,2
20150217-M-Marseille-R32-Alexander_Zverev-Gael_Monfils,1,B-IO,7,1,0,0,1,3,4
20150217-M-Marseille-R32-Alexander_Zverev-Gael_Monfils,1,S-XC,5,1,0,1,0,2,3
20150217-M-Marseille-R32-Alexander_Zverev-Gael_Monfils,1,S-DTM,2,0,0,0,0,2,0
20150217-M-Marseille-R32-Alexander_Zverev-Gael_Monfils,1,S-DTL,1,1,1,0,0,1,0
20150217-M-Marseille-R32-Alexander_Zverev-Gael_Monfils,1,S-IO,1,1,0,1,0,1,0
20150217-M-Marseille-R32-Alexander_Zverev-Gael_Monfils,2,F-XC,37,7,1,2,4,20,17
20150217-M-Marseille-R32-Alexander_Zverev-Gael_Monfils,2,F-DTM,24,2,0,1,1,11,13
20150217-M-Marseille-R32-Alexander_Zverev-Gael_Monfils,2,F-DTL,4,0,0,0,0,3,1
20150217-M-Marseille-R32-Alexander_Zverev-Gael_Monfils,2,F-IO,23,9,3,2,4,13,10
20150217-M-Marseille-R32-Alexander_Zverev-Gael_Monfils,2,F-II,2,0,0,0,0,1,1
20150217-M-Marseille-R32-Alexander_Zverev-Gael_Monfils,2,B-XC,39,9,0,2,7,20,19
20150217-M-Marseille-R32-Alexander_Zverev-Gael_Monfils,2,B-DTM,20,1,0,0,1,9,11
20150217-M-Marseille-R32-Alexander_Zverev-Gael_Monfils,2,B-DTL,11,6,1,2,3,3,8
20150217-M-Marseille-R32-Alexander_Zverev-Gael_Monfils,2,B-IO,6,0,0,0,0,5,1
20150217-M-Marseille-R32-Alexander_Zverev-Gael_Monfils,2,S-XC,4,0,0,0,0,1,3
20150217-M-Marseille-R32-Alexander_Zverev-Gael_Monfils,2,S-DTM,3,0,0,0,0,1,2
20150217-M-Marseille-R32-Alexander_Zverev-Gael_Monfils,2,S-DTL,1,1,1,0,0,1,0
20150312-M-Indian_Wells_Masters-R128-Andreas_Haider_Maurer-Borna_Coric,1,F-XC,32,7,0,0,7,9,23
20150312-M-Indian_Wells_Masters-R128-Andreas_Haider_Maurer-Borna_Coric,1,F-DTM,33,4,1,0,3,11,22
20150312-M-Indian_Wells_Masters-R128-Andreas_Haider_Maurer-Borna_Coric,1,F-DTL,10,5,1,1,3,3,7
20150312-M-Indian_Wells_Masters-R128-Andreas_Haider_Maurer-Borna_Coric,1,F-IO,26,5,1,2,2,10,16
20150312-M-Indian_Wells_Masters-R128-Andreas_Haider_Maurer-Borna_Coric,1,F-II,1,0,0,0,0,0,1
20150312-M-Indian_Wells_Masters-R128-Andreas_Haider_Maurer-Borna_Coric,1,B-XC,29,3,0,1,2,8,21
20150312-M-Indian_Wells_Masters-R128-Andreas_Haider_Maurer-Borna_Coric,1,B-DTM,31,3,0,0,3,12,19
20150312-M-Indian_Wells_Masters-R128-Andreas_Haider_Maurer-Borna_Coric,1,B-DTL,4,2,1,0,1,2,2
20150312-M-Indian_Wells_Masters-R128-Andreas_Haider_Maurer-Borna_Coric,1,B-IO,3,0,0,0,0,2,1
20150312-M-Indian_Wells_Masters-R128-Andreas_Haider_Maurer-Borna_Coric,1,S-XC,12,1,0,0,1,2,10
20150312-M-Indian_Wells_Masters-R128-Andreas_Haider_Maurer-Borna_Coric,1,S-DTM,6,1,0,0,1,0,6
20150312-M-Indian_Wells_Masters-R128-Andreas_Haider_Maurer-Borna_Coric,1,S-DTL,1,0,0,0,0,0,1
20150312-M-Indian_Wells_Masters-R128-Andreas_Haider_Maurer-Borna_Coric,1,S-IO,1,0,0,0,0,0,1
20150312-M-Indian_Wells_Masters-R128-Andreas_Haider_Maurer-Borna_Coric,2,F-XC,41,8,2,0,6,27,14
20150312-M-Indian_Wells_Masters-R128-Andreas_Haider_Maurer-Borna_Coric,2,F-DTM,32,1,0,0,1,21,11
20150312-M-Indian_Wells_Masters-R128-Andreas_Haider_Maurer-Borna_Coric,2,F-DTL,4,2,1,0,1,3,1
20150312-M-Indian_Wells_Masters-R128-Andreas_Haider_Maurer-Borna_Coric,2,F-IO,29,5,1,2,2,22,7
20150312-M-Indian_Wells_Masters-R128-Andreas_Haider_Maurer-Borna_Coric,2,F-II,3,0,0,0,0,3,0
20150312-M-Indian_Wells_Masters-R128-Andreas_Haider_Maurer-Borna_Coric,2,B-XC,34,5,1,1,3,21,13
20150312-M-Indian_Wells_Masters-R128-Andreas_Haider_Maurer-Borna_Coric,2,B-DTM,20,2,0,0,2,16,4
20150312-M-Indian_Wells_Masters-R128-Andreas_Haider_Maurer-Borna_Coric,2,B-DTL,6,2,0,2,0,4,2
20150312-M-Indian_Wells_Masters-R128-Andreas_Haider_Maurer-Borna_Coric,2,B-IO,2,0,0,0,0,1,1
20150312-M-Indian_Wells_Masters-R128-Andreas_Haider_Maurer-Borna_Coric,2,S-XC,8,1,0,1,0,6,2
20150312-M-Indian_Wells_Masters-R128-Andreas_Haider_Maurer-Borna_Coric,2,S-DTM,4,1,0,0,1,2,2
20150312-M-Indian_Wells_Masters-R128-Andreas_Haider_Maurer-Borna_Coric,2,S-DTL,2,0,0,0,0,2,0
20150312-M-Indian_Wells_Masters-R128-Andreas_Haider_Maurer-Borna_Coric,2,S-IO,1,0,0,0,0,0,1
20150313-M-Indian_Wells_Masters-R128-Diego_Sebastian_Schwartzman-Jerzy_Janowicz,1,F-XC,23,6,2,1,3,13,10
20150313-M-Indian_Wells_Masters-R128-Diego_Sebastian_Schwartzman-Jerzy_Janowicz,1,F-DTM,50,7,0,1,6,22,28
20150313-M-Indian_Wells_Masters-R128-Diego_Sebastian_Schwartzman-Jerzy_Janowicz,1,F-DTL,8,4,2,1,1,4,4
20150313-M-Indian_Wells_Masters-R128-Diego_Sebastian_Schwartzman-Jerzy_Janowicz,1,F-IO,29,11,3,5,3,20,9
20150313-M-Indian_Wells_Masters-R128-Diego_Sebastian_Schwartzman-Jerzy_Janowicz,1,F-II,2,1,1,0,0,2,0
20150313-M-Indian_Wells_Masters-R128-Diego_Sebastian_Schwartzman-Jerzy_Janowicz,1,B-XC,39,10,2,3,5,28,11
20150313-M-Indian_Wells_Masters-R128-Diego_Sebastian_Schwartzman-Jerzy_Janowicz,1,B-DTM,33,2,0,1,1,20,13
20150313-M-Indian_Wells_Masters-R128-Diego_Sebastian_Schwartzman-Jerzy_Janowicz,1,B-DTL,5,3,1,1,1,3,2
20150313-M-Indian_Wells_Masters-R128-Diego_Sebastian_Schwartzman-Jerzy_Janowicz,1,B-IO,4,2,1,0,1,2,2
20150313-M-Indian_Wells_Masters-R128-Diego_Sebastian_Schwartzman-Jerzy_Janowicz,1,S-XC,7,1,0,1,0,4,3
20150313-M-Indian_Wells_Masters-R128-Diego_Sebastian_Schwartzman-Jerzy_Janowicz,1,S-DTM,2,0,0,0,0,0,2
20150313-M-Indian_Wells_Masters-R128-Diego_Sebastian_Schwartzman-Jerzy_Janowicz,1,S-DTL,1,0,0,0,0,0,1
20150313-M-Indian_Wells_Masters-R128-Diego_Sebastian_Schwartzman-Jerzy_Janowicz,2,F-XC,55,23,3,11,9,28,27
20150313-M-Indian_Wells_Masters-R128-Diego_Sebastian_Schwartzman-Jerzy_Janowicz,2,F-DTM,17,3,0,0,3,5,12
20150313-M-Indian_Wells_Masters-R128-Diego_Sebastian_Schwartzman-Jerzy_Janowicz,2,F-DTL,5,3,1,0,2,2,3
20150313-M-Indian_Wells_Masters-R128-Diego_Sebastian_Schwartzman-Jerzy_Janowicz,2,F-IO,37,11,7,1,3,19,18
20150313-M-Indian_Wells_Masters-R128-Diego_Sebastian_Schwartzman-Jerzy_Janowicz,2,F-II,2,2,1,0,1,1,1
20150313-M-Indian_Wells_Masters-R128-Diego_Sebastian_Schwartzman-Jerzy_Janowicz,2,B-XC,27,7,0,1,6,8,19
20150313-M-Indian_Wells_Masters-R128-Diego_Sebastian_Schwartzman-Jerzy_Janowicz,2,B-DTM,28,3,0,0,3,11,17
20150313-M-Indian_Wells_Masters-R128-Diego_Sebastian_Schwartzman-Jerzy_Janowicz,2,B-DTL,6,1,1,0,0,2,4
20150313-M-Indian_Wells_Masters-R128-Diego_Sebastian_Schwartzman-Jerzy_Janowicz,2,B-IO,6,3,1,0,2,4,2
20150313-M-Indian_Wells_Masters-R128-Diego_Sebastian_Schwartzman-Jerzy_Janowicz,2,S-XC,7,0,0,0,0,1,6
20150313-M-Indian_Wells_Masters-R128-Diego_Sebastian_Schwartzman-Jerzy_Janowicz,2,S-DTM,6,0,0,0,0,2,4
20150313-M-Indian_Wells_Masters-R128-Diego_Sebastian_Schwartzman-Jerzy_Janowicz,2,S-DTL,4,2,0,1,1,1,3
20150313-M-Indian_Wells_Masters-R128-Diego_Sebastian_Schwartzman-Jerzy_Janowicz,2,S-IO,2,0,0,0,0,2,0
20150316-M-Indian_Wells_Masters-R32-Feliciano_Lopez-Pablo_Cuevas,1,F-XC,64,7,0,2,5,37,27
20150316-M-Indian_Wells_Masters-R32-Feliciano_Lopez-Pablo_Cuevas,1,F-DTM,33,2,0,0,2,16,17
20150316-M-Indian_Wells_Masters-R32-Feliciano_Lopez-Pablo_Cuevas,1,F-DTL,7,5,1,2,2,4,3
20150316-M-Indian_Wells_Masters-R32-Feliciano_Lopez-Pablo_Cuevas,1,F-IO,21,4,2,1,1,9,12
20150316-M-Indian_Wells_Masters-R32-Feliciano_Lopez-Pablo_Cuevas,1,F-II,6,1,0,1,0,4,2
20150316-M-Indian_Wells_Masters-R32-Feliciano_Lopez-Pablo_Cuevas,1,B-XC,9,1,0,0,1,7,2
20150316-M-Indian_Wells_Masters-R32-Feliciano_Lopez-Pablo_Cuevas,1,B-DTM,11,0,0,0,0,8,3
20150316-M-Indian_Wells_Masters-R32-Feliciano_Lopez-Pablo_Cuevas,1,B-DTL,1,0,0,0,0,1,0
20150316-M-Indian_Wells_Masters-R32-Feliciano_Lopez-Pablo_Cuevas,1,B-IO,6,0,0,0,0,1,5
20150316-M-Indian_Wells_Masters-R32-Feliciano_Lopez-Pablo_Cuevas,1,S-XC,21,5,0,2,3,12,9
20150316-M-Indian_Wells_Masters-R32-Feliciano_Lopez-Pablo_Cuevas,1,S-DTM,13,1,0,0,1,8,5
20150316-M-Indian_Wells_Masters-R32-Feliciano_Lopez-Pablo_Cuevas,1,S-DTL,12,2,0,1,1,10,2
20150316-M-Indian_Wells_Masters-R32-Feliciano_Lopez-Pablo_Cuevas,1,S-IO,6,1,0,1,0,4,2
20150316-M-Indian_Wells_Masters-R32-Feliciano_Lopez-Pablo_Cuevas,2,F-XC,52,10,3,3,4,22,30
20150316-M-Indian_Wells_Masters-R32-Feliciano_Lopez-Pablo_Cuevas,2,F-DTM,34,1,0,0,1,12,22
20150316-M-Indian_Wells_Masters-R32-Feliciano_Lopez-Pablo_Cuevas,2,F-DTL,7,3,2,1,0,5,2
20150316-M-Indian_Wells_Masters-R32-Feliciano_Lopez-Pablo_Cuevas,2,F-IO,29,12,6,1,5,15,14
20150316-M-Indian_Wells_Masters-R32-Feliciano_Lopez-Pablo_Cuevas,2,F-II,6,1,1,0,0,2,4
20150316-M-Indian_Wells_Masters-R32-Feliciano_Lopez-Pablo_Cuevas,2,B-XC,41,9,2,1,6,18,23
20150316-M-Indian_Wells_Masters-R32-Feliciano_Lopez-Pablo_Cuevas,2,B-DTM,28,4,0,0,4,13,15
20150316-M-Indian_Wells_Masters-R32-Feliciano_Lopez-Pablo_Cuevas,2,B-DTL,5,1,0,0,1,0,5
20150316-M-Indian_Wells_Masters-R32-Feliciano_Lopez-Pablo_Cuevas,2,B-IO,2,0,0,0,0,0,2
20150316-M-Indian_Wells_Masters-R32-Feliciano_Lopez-Pablo_Cuevas,2,S-XC,7,2,1,1,0,4,3
20150316-M-Indian_Wells_Masters-R32-Feliciano_Lopez-Pablo_Cuevas,2,S-DTM,13,0,0,0,0,8,5
20150316-M-Indian_Wells_Masters-R32-Feliciano_Lopez-Pablo_Cuevas,2,S-DTL,6,3,0,0,3,1,5
20150316-M-Indian_Wells_Masters-R32-Feliciano_Lopez-Pablo_Cuevas,2,S-IO,2,1,1,0,0,2,0
20150318-M-Indian_Wells_Masters-R16-Feliciano_Lopez-Kei_Nishikori,1,F-XC,51,13,1,4,8,20,31
20150318-M-Indian_Wells_Masters-R16-Feliciano_Lopez-Kei_Nishikori,1,F-DTM,15,1,0,0,1,7,8
20150318-M-Indian_Wells_Masters-R16-Feliciano_Lopez-Kei_Nishikori,1,F-DTL,5,0,0,0,0,5,0
20150318-M-Indian_Wells_Masters-R16-Feliciano_Lopez-Kei_Nishikori,1,F-IO,11,5,2,0,3,4,7
20150318-M-Indian_Wells_Masters-R16-Feliciano_Lopez-Kei_Nishikori,1,F-II,2,0,0,0,0,2,0
20150318-M-Indian_Wells_Masters-R16-Feliciano_Lopez-Kei_Nishikori,1,B-XC,10,3,1,0,2,3,7
20150318-M-Indian_Wells_Masters-R16-Feliciano_Lopez-Kei_Nishikori,1,B-DTM,16,1,0,0,1,6,10
20150318-M-Indian_Wells_Masters-R16-Feliciano_Lopez-Kei_Nishikori,1,B-IO,1,1,1,0,0,1,0
20150318-M-Indian_Wells_Masters-R16-Feliciano_Lopez-Kei_Nishikori,1,S-XC,18,1,0,0,1,8,10
20150318-M-Indian_Wells_Masters-R16-Feliciano_Lopez-Kei_Nishikori,1,S-DTM,30,1,0,0,1,16,14
20150318-M-Indian_Wells_Masters-R16-Feliciano_Lopez-Kei_Nishikori,1,S-DTL,10,3,0,0,3,3,7
20150318-M-Indian_Wells_Masters-R16-Feliciano_Lopez-Kei_Nishikori,1,S-IO,11,4,0,1,3,6,5
20150318-M-Indian_Wells_Masters-R16-Feliciano_Lopez-Kei_Nishikori,2,F-XC,50,6,3,0,3,29,21
20150318-M-Indian_Wells_Masters-R16-Feliciano_Lopez-Kei_Nishikori,2,F-DTM,21,0,0,0,0,10,11
20150318-M-Indian_Wells_Masters-R16-Feliciano_Lopez-Kei_Nishikori,2,F-DTL,4,1,0,0,1,2,2
20150318-M-Indian_Wells_Masters-R16-Feliciano_Lopez-Kei_Nishikori,2,F-IO,19,7,2,0,5,11,8
20150318-M-Indian_Wells_Masters-R16-Feliciano_Lopez-Kei_Nishikori,2,F-II,3,0,0,0,0,3,0
20150318-M-Indian_Wells_Masters-R16-Feliciano_Lopez-Kei_Nishikori,2,B-XC,42,11,2,3,6,22,20
20150318-M-Indian_Wells_Masters-R16-Feliciano_Lopez-Kei_Nishikori,2,B-DTM,23,2,0,1,1,14,9
20150318-M-Indian_Wells_Masters-R16-Feliciano_Lopez-Kei_Nishikori,2,B-DTL,10,5,0,1,4,2,8
20150318-M-Indian_Wells_Masters-R16-Feliciano_Lopez-Kei_Nishikori,2,B-IO,7,2,1,0,1,4,3
20150318-M-Indian_Wells_Masters-R16-Feliciano_Lopez-Kei_Nishikori,2,S-XC,2,1,0,1,0,1,1
20150318-M-Indian_Wells_Masters-R16-Feliciano_Lopez-Kei_Nishikori,2,S-DTM,3,0,0,0,0,2,1
20150318-M-Indian_Wells_Masters-R16-Feliciano_Lopez-Kei_Nishikori,2,S-DTL,3,0,0,0,0,2,1
20150318-M-Indian_Wells_Masters-R16-Feliciano_Lopez-Kei_Nishikori,2,S-IO,1,0,0,0,0,0,1
20150318-M-Indian_Wells_Masters-QF-Andy_Murray-Feliciano_Lopez,1,F-XC,59,8,3,2,3,43,16
20150318-M-Indian_Wells_Masters-QF-Andy_Murray-Feliciano_Lopez,1,F-DTM,8,0,0,0,0,6,2
20150318-M-Indian_Wells_Masters-QF-Andy_Murray-Feliciano_Lopez,1,F-DTL,7,3,1,0,2,3,4
20150318-M-Indian_Wells_Masters-QF-Andy_Murray-Feliciano_Lopez,1,F-IO,24,8,3,1,4,15,9
20150318-M-Indian_Wells_Masters-QF-Andy_Murray-Feliciano_Lopez,1,F-II,3,1,0,0,1,1,2
20150318-M-Indian_Wells_Masters-QF-Andy_Murray-Feliciano_Lopez,1,B-XC,26,11,3,5,3,19,7
20150318-M-Indian_Wells_Masters-QF-Andy_Murray-Feliciano_Lopez,1,B-DTM,25,0,0,0,0,18,7
20150318-M-Indian_Wells_Masters-QF-Andy_Murray-Feliciano_Lopez,1,B-DTL,10,3,2,0,1,7,3
20150318-M-Indian_Wells_Masters-QF-Andy_Murray-Feliciano_Lopez,1,B-IO,4,0,0,0,0,3,1
20150318-M-Indian_Wells_Masters-QF-Andy_Murray-Feliciano_Lopez,1,S-XC,4,1,0,1,0,3,1
20150318-M-Indian_Wells_Masters-QF-Andy_Murray-Feliciano_Lopez,1,S-DTM,7,0,0,0,0,6,1
20150318-M-Indian_Wells_Masters-QF-Andy_Murray-Feliciano_Lopez,1,S-DTL,6,2,0,0,2,3,3
20150318-M-Indian_Wells_Masters-QF-Andy_Murray-Feliciano_Lopez,1,S-IO,3,0,0,0,0,3,0
20150318-M-Indian_Wells_Masters-QF-Andy_Murray-Feliciano_Lopez,2,F-XC,44,6,0,2,4,15,29
20150318-M-Indian_Wells_Masters-QF-Andy_Murray-Feliciano_Lopez,2,F-DTM,18,3,1,0,2,5,13
20150318-M-Indian_Wells_Masters-QF-Andy_Murray-Feliciano_Lopez,2,F-DTL,7,3,2,0,1,4,3
20150318-M-Indian_Wells_Masters-QF-Andy_Murray-Feliciano_Lopez,2,F-IO,16,6,1,2,3,8,8
20150318-M-Indian_Wells_Masters-QF-Andy_Murray-Feliciano_Lopez,2,F-II,2,1,0,0,1,0,2
20150318-M-Indian_Wells_Masters-QF-Andy_Murray-Feliciano_Lopez,2,B-XC,6,1,0,0,1,2,4
20150318-M-Indian_Wells_Masters-QF-Andy_Murray-Feliciano_Lopez,2,B-DTM,14,1,0,0,1,5,9
20150318-M-Indian_Wells_Masters-QF-Andy_Murray-Feliciano_Lopez,2,B-DTL,3,1,1,0,0,2,1
20150318-M-Indian_Wells_Masters-QF-Andy_Murray-Feliciano_Lopez,2,B-IO,3,2,1,0,1,1,2
20150318-M-Indian_Wells_Masters-QF-Andy_Murray-Feliciano_Lopez,2,S-XC,25,5,0,1,4,7,18
20150318-M-Indian_Wells_Masters-QF-Andy_Murray-Feliciano_Lopez,2,S-DTM,24,1,0,0,1,5,19
20150318-M-Indian_Wells_Masters-QF-Andy_Murray-Feliciano_Lopez,2,S-DTL,18,3,1,1,1,6,12
20150318-M-Indian_Wells_Masters-QF-Andy_Murray-Feliciano_Lopez,2,S-IO,13,2,0,0,2,2,11
20150320-M-Indian_Wells_Masters-QF-Tomas_Berdych-Roger_Federer,1,F-XC,26,7,2,1,4,11,15
20150320-M-Indian_Wells_Masters-QF-Tomas_Berdych-Roger_Federer,1,F-DTM,4,0,0,0,0,0,4
20150320-M-Indian_Wells_Masters-QF-Tomas_Berdych-Roger_Federer,1,F-DTL,4,0,0,0,0,1,3
20150320-M-Indian_Wells_Masters-QF-Tomas_Berdych-Roger_Federer,1,F-IO,34,9,3,2,4,15,19
20150320-M-Indian_Wells_Masters-QF-Tomas_Berdych-Roger_Federer,1,F-II,2,1,1,0,0,1,1
20150320-M-Indian_Wells_Masters-QF-Tomas_Berdych-Roger_Federer,1,B-XC,17,4,0,1,3,4,13
20150320-M-Indian_Wells_Masters-QF-Tomas_Berdych-Roger_Federer,1,B-DTM,9,0,0,0,0,0,9
20150320-M-Indian_Wells_Masters-QF-Tomas_Berdych-Roger_Federer,1,B-DTL,5,2,0,0,2,0,5
20150320-M-Indian_Wells_Masters-QF-Tomas_Berdych-Roger_Federer,1,B-IO,2,1,0,0,1,0,2
20150320-M-Indian_Wells_Masters-QF-Tomas_Berdych-Roger_Federer,1,S-XC,5,0,0,0,0,2,3
20150320-M-Indian_Wells_Masters-QF-Tomas_Berdych-Roger_Federer,2,F-XC,19,10,4,3,3,14,5
20150320-M-Indian_Wells_Masters-QF-Tomas_Berdych-Roger_Federer,2,F-DTM,9,1,0,0,1,6,3
20150320-M-Indian_Wells_Masters-QF-Tomas_Berdych-Roger_Federer,2,F-DTL,7,3,1,0,2,4,3
20150320-M-Indian_Wells_Masters-QF-Tomas_Berdych-Roger_Federer,2,F-IO,17,3,2,1,0,17,0
20150320-M-Indian_Wells_Masters-QF-Tomas_Berdych-Roger_Federer,2,F-II,7,2,2,0,0,3,4
20150320-M-Indian_Wells_Masters-QF-Tomas_Berdych-Roger_Federer,2,B-XC,9,1,0,0,1,7,2
20150320-M-Indian_Wells_Masters-QF-Tomas_Berdych-Roger_Federer,2,B-DTM,14,0,0,0,0,12,2
20150320-M-Indian_Wells_Masters-QF-Tomas_Berdych-Roger_Federer,2,B-DTL,9,5,1,2,2,7,2
20150320-M-Indian_Wells_Masters-QF-Tomas_Berdych-Roger_Federer,2,S-XC,5,1,0,0,1,1,4
20150320-M-Indian_Wells_Masters-QF-Tomas_Berdych-Roger_Federer,2,S-DTM,4,0,0,0,0,2,2
20150320-M-Indian_Wells_Masters-QF-Tomas_Berdych-Roger_Federer,2,S-DTL,1,0,0,0,0,1,0
20150320-M-Indian_Wells_Masters-QF-Tomas_Berdych-Roger_Federer,2,S-IO,1,0,0,0,0,1,0
20150320-M-Indian_Wells_Masters-QF-Tomas_Berdych-Roger_Federer,2,S-II,1,0,0,0,0,1,0
20150316-M-Indian_Wells_Masters-R32-Novak_Djokovic-Albert_Ramos,1,F-XC,47,6,2,0,4,23,24
20150316-M-Indian_Wells_Masters-R32-Novak_Djokovic-Albert_Ramos,1,F-DTM,19,2,0,1,1,10,9
20150316-M-Indian_Wells_Masters-R32-Novak_Djokovic-Albert_Ramos,1,F-DTL,13,5,2,0,3,7,6
20150316-M-Indian_Wells_Masters-R32-Novak_Djokovic-Albert_Ramos,1,F-IO,24,15,4,3,8,12,12
20150316-M-Indian_Wells_Masters-R32-Novak_Djokovic-Albert_Ramos,1,F-II,1,1,1,0,0,1,0
20150316-M-Indian_Wells_Masters-R32-Novak_Djokovic-Albert_Ramos,1,B-XC,19,4,0,0,4,11,8
20150316-M-Indian_Wells_Masters-R32-Novak_Djokovic-Albert_Ramos,1,B-DTM,51,4,0,1,3,31,20
20150316-M-Indian_Wells_Masters-R32-Novak_Djokovic-Albert_Ramos,1,B-DTL,5,2,1,0,1,2,3
20150316-M-Indian_Wells_Masters-R32-Novak_Djokovic-Albert_Ramos,1,B-IO,8,2,0,1,1,5,3
20150316-M-Indian_Wells_Masters-R32-Novak_Djokovic-Albert_Ramos,1,S-DTM,1,0,0,0,0,0,1
20150316-M-Indian_Wells_Masters-R32-Novak_Djokovic-Albert_Ramos,1,S-IO,1,0,0,0,0,1,0
20150316-M-Indian_Wells_Masters-R32-Novak_Djokovic-Albert_Ramos,2,F-XC,42,6,1,2,3,21,21
20150316-M-Indian_Wells_Masters-R32-Novak_Djokovic-Albert_Ramos,2,F-DTM,30,2,1,0,1,10,20
20150316-M-Indian_Wells_Masters-R32-Novak_Djokovic-Albert_Ramos,2,F-DTL,5,3,1,0,2,3,2
20150316-M-Indian_Wells_Masters-R32-Novak_Djokovic-Albert_Ramos,2,F-IO,28,12,1,1,10,12,16
20150316-M-Indian_Wells_Masters-R32-Novak_Djokovic-Albert_Ramos,2,F-II,1,0,0,0,0,0,1
20150316-M-Indian_Wells_Masters-R32-Novak_Djokovic-Albert_Ramos,2,B-XC,20,2,0,0,2,10,10
20150316-M-Indian_Wells_Masters-R32-Novak_Djokovic-Albert_Ramos,2,B-DTM,34,1,0,0,1,14,20
20150316-M-Indian_Wells_Masters-R32-Novak_Djokovic-Albert_Ramos,2,B-DTL,9,1,0,1,0,6,3
20150316-M-Indian_Wells_Masters-R32-Novak_Djokovic-Albert_Ramos,2,B-IO,4,2,0,0,2,0,4
20150316-M-Indian_Wells_Masters-R32-Novak_Djokovic-Albert_Ramos,2,S-XC,4,0,0,0,0,1,3
20150316-M-Indian_Wells_Masters-R32-Novak_Djokovic-Albert_Ramos,2,S-DTM,7,1,0,0,1,2,5
20150316-M-Indian_Wells_Masters-R32-Novak_Djokovic-Albert_Ramos,2,S-IO,1,0,0,0,0,0,1
20150321-M-Irving_CH-SF-Gilles_Muller-Tim_Smyczek,1,F-XC,49,19,3,5,11,22,27
20150321-M-Irving_CH-SF-Gilles_Muller-Tim_Smyczek,1,F-DTM,15,4,0,0,4,4,11
20150321-M-Irving_CH-SF-Gilles_Muller-Tim_Smyczek,1,F-DTL,6,4,0,1,3,2,4
20150321-M-Irving_CH-SF-Gilles_Muller-Tim_Smyczek,1,F-IO,19,10,1,2,7,5,14
20150321-M-Irving_CH-SF-Gilles_Muller-Tim_Smyczek,1,F-II,1,0,0,0,0,1,0
20150321-M-Irving_CH-SF-Gilles_Muller-Tim_Smyczek,1,B-XC,13,6,0,1,5,4,9
20150321-M-Irving_CH-SF-Gilles_Muller-Tim_Smyczek,1,B-DTM,4,2,0,0,2,2,2
20150321-M-Irving_CH-SF-Gilles_Muller-Tim_Smyczek,1,B-DTL,1,0,0,0,0,1,0
20150321-M-Irving_CH-SF-Gilles_Muller-Tim_Smyczek,1,B-IO,1,1,0,1,0,1,0
20150321-M-Irving_CH-SF-Gilles_Muller-Tim_Smyczek,1,B-II,1,1,0,1,0,1,0
20150321-M-Irving_CH-SF-Gilles_Muller-Tim_Smyczek,1,S-XC,7,1,0,0,1,3,4
20150321-M-Irving_CH-SF-Gilles_Muller-Tim_Smyczek,1,S-DTM,5,0,0,0,0,2,3
20150321-M-Irving_CH-SF-Gilles_Muller-Tim_Smyczek,1,S-DTL,3,1,0,1,0,2,1
20150321-M-Irving_CH-SF-Gilles_Muller-Tim_Smyczek,1,S-IO,4,1,0,1,0,2,2
20150321-M-Irving_CH-SF-Gilles_Muller-Tim_Smyczek,2,F-XC,17,4,1,2,1,10,7
20150321-M-Irving_CH-SF-Gilles_Muller-Tim_Smyczek,2,F-DTM,25,2,0,1,1,18,7
20150321-M-Irving_CH-SF-Gilles_Muller-Tim_Smyczek,2,F-DTL,6,1,0,1,0,3,3
20150321-M-Irving_CH-SF-Gilles_Muller-Tim_Smyczek,2,F-IO,13,3,1,2,0,11,2
20150321-M-Irving_CH-SF-Gilles_Muller-Tim_Smyczek,2,B-XC,15,5,1,1,3,6,9
20150321-M-Irving_CH-SF-Gilles_Muller-Tim_Smyczek,2,B-DTM,34,3,0,1,2,20,14
20150321-M-Irving_CH-SF-Gilles_Muller-Tim_Smyczek,2,B-DTL,9,3,1,1,1,6,3
20150321-M-Irving_CH-SF-Gilles_Muller-Tim_Smyczek,2,B-IO,5,4,0,2,2,2,3
20150321-M-Irving_CH-SF-Gilles_Muller-Tim_Smyczek,2,S-DTM,6,0,0,0,0,0,6
20150321-M-Irving_CH-SF-Gilles_Muller-Tim_Smyczek,2,S-DTL,1,0,0,0,0,0,1
20150215-M-Launceston_CH-F-Hyeon_Chung-Bjorn_Fratangelo,1,F-XC,76,15,4,2,9,31,45
20150215-M-Launceston_CH-F-Hyeon_Chung-Bjorn_Fratangelo,1,F-DTM,49,7,1,0,6,12,37
20150215-M-Launceston_CH-F-Hyeon_Chung-Bjorn_Fratangelo,1,F-DTL,5,3,1,1,1,4,1
20150215-M-Launceston_CH-F-Hyeon_Chung-Bjorn_Fratangelo,1,F-IO,21,5,3,1,1,13,8
20150215-M-Launceston_CH-F-Hyeon_Chung-Bjorn_Fratangelo,1,B-XC,43,7,1,1,5,16,27
20150215-M-Launceston_CH-F-Hyeon_Chung-Bjorn_Fratangelo,1,B-DTM,41,1,0,0,1,16,25
20150215-M-Launceston_CH-F-Hyeon_Chung-Bjorn_Fratangelo,1,B-DTL,6,3,1,0,2,3,3
20150215-M-Launceston_CH-F-Hyeon_Chung-Bjorn_Fratangelo,1,B-IO,10,3,1,0,2,5,5
20150215-M-Launceston_CH-F-Hyeon_Chung-Bjorn_Fratangelo,1,S-XC,5,0,0,0,0,2,3
20150215-M-Launceston_CH-F-Hyeon_Chung-Bjorn_Fratangelo,1,S-DTM,4,0,0,0,0,0,4
20150215-M-Launceston_CH-F-Hyeon_Chung-Bjorn_Fratangelo,2,F-XC,66,21,9,4,8,42,24
20150215-M-Launceston_CH-F-Hyeon_Chung-Bjorn_Fratangelo,2,F-DTM,32,2,1,0,1,14,18
20150215-M-Launceston_CH-F-Hyeon_Chung-Bjorn_Fratangelo,2,F-DTL,18,12,6,2,4,11,7
20150215-M-Launceston_CH-F-Hyeon_Chung-Bjorn_Fratangelo,2,F-IO,63,27,12,3,12,42,21
20150215-M-Launceston_CH-F-Hyeon_Chung-Bjorn_Fratangelo,2,F-II,5,2,2,0,0,5,0
20150215-M-Launceston_CH-F-Hyeon_Chung-Bjorn_Fratangelo,2,B-XC,23,9,3,0,6,12,11
20150215-M-Launceston_CH-F-Hyeon_Chung-Bjorn_Fratangelo,2,B-DTM,28,4,0,0,4,18,10
20150215-M-Launceston_CH-F-Hyeon_Chung-Bjorn_Fratangelo,2,B-DTL,5,2,0,0,2,3,2
20150215-M-Launceston_CH-F-Hyeon_Chung-Bjorn_Fratangelo,2,B-IO,4,3,0,1,2,2,2
20150215-M-Launceston_CH-F-Hyeon_Chung-Bjorn_Fratangelo,2,S-XC,4,1,0,0,1,1,3
20150215-M-Launceston_CH-F-Hyeon_Chung-Bjorn_Fratangelo,2,S-DTM,6,1,0,0,1,3,3
20150215-M-Launceston_CH-F-Hyeon_Chung-Bjorn_Fratangelo,2,S-DTL,4,1,1,0,0,3,1
20150215-M-Launceston_CH-F-Hyeon_Chung-Bjorn_Fratangelo,2,S-IO,3,0,0,0,0,3,0
20150207-M-Glasgow_CH-SF-David_Guez-Ruben_Bemelmans,1,F-XC,85,11,1,3,7,38,47
20150207-M-Glasgow_CH-SF-David_Guez-Ruben_Bemelmans,1,F-DTM,40,4,0,0,4,17,23
20150207-M-Glasgow_CH-SF-David_Guez-Ruben_Bemelmans,1,F-DTL,18,8,3,1,4,12,6
20150207-M-Glasgow_CH-SF-David_Guez-Ruben_Bemelmans,1,F-IO,27,7,2,2,3,16,11
20150207-M-Glasgow_CH-SF-David_Guez-Ruben_Bemelmans,1,F-II,2,1,1,0,0,2,0
20150207-M-Glasgow_CH-SF-David_Guez-Ruben_Bemelmans,1,B-XC,43,9,1,4,4,23,20
20150207-M-Glasgow_CH-SF-David_Guez-Ruben_Bemelmans,1,B-DTM,35,5,1,2,2,17,18
20150207-M-Glasgow_CH-SF-David_Guez-Ruben_Bemelmans,1,B-DTL,8,4,1,0,3,4,4
20150207-M-Glasgow_CH-SF-David_Guez-Ruben_Bemelmans,1,B-IO,14,2,0,0,2,8,6
20150207-M-Glasgow_CH-SF-David_Guez-Ruben_Bemelmans,1,S-DTM,2,1,0,0,1,1,1
20150207-M-Glasgow_CH-SF-David_Guez-Ruben_Bemelmans,1,S-DTL,2,0,0,0,0,2,0
20150207-M-Glasgow_CH-SF-David_Guez-Ruben_Bemelmans,2,F-XC,56,10,3,4,3,27,29
20150207-M-Glasgow_CH-SF-David_Guez-Ruben_Bemelmans,2,F-DTM,32,0,0,0,0,16,16
20150207-M-Glasgow_CH-SF-David_Guez-Ruben_Bemelmans,2,F-DTL,17,11,5,1,5,11,6
20150207-M-Glasgow_CH-SF-David_Guez-Ruben_Bemelmans,2,F-IO,30,3,2,1,0,16,14
20150207-M-Glasgow_CH-SF-David_Guez-Ruben_Bemelmans,2,B-XC,42,6,2,1,3,22,20
20150207-M-Glasgow_CH-SF-David_Guez-Ruben_Bemelmans,2,B-DTM,14,1,0,0,1,9,5
20150207-M-Glasgow_CH-SF-David_Guez-Ruben_Bemelmans,2,B-DTL,15,6,3,2,1,7,8
20150207-M-Glasgow_CH-SF-David_Guez-Ruben_Bemelmans,2,B-IO,5,0,0,0,0,2,3
20150207-M-Glasgow_CH-SF-David_Guez-Ruben_Bemelmans,2,B-II,1,0,0,0,0,0,1
20150207-M-Glasgow_CH-SF-David_Guez-Ruben_Bemelmans,2,S-XC,26,2,0,0,2,11,15
20150207-M-Glasgow_CH-SF-David_Guez-Ruben_Bemelmans,2,S-DTM,19,0,0,0,0,12,7
20150207-M-Glasgow_CH-SF-David_Guez-Ruben_Bemelmans,2,S-DTL,6,0,0,0,0,2,4
20150207-M-Glasgow_CH-SF-David_Guez-Ruben_Bemelmans,2,S-IO,3,1,0,0,1,1,2
20141101-M-Geneva_CH-SF-Radu_Albot-Marcos_Baghdatis,1,F-XC,49,14,2,4,8,23,26
20141101-M-Geneva_CH-SF-Radu_Albot-Marcos_Baghdatis,1,F-DTM,46,1,0,0,1,19,27
20141101-M-Geneva_CH-SF-Radu_Albot-Marcos_Baghdatis,1,F-DTL,7,3,0,0,3,2,5
20141101-M-Geneva_CH-SF-Radu_Albot-Marcos_Baghdatis,1,F-IO,34,6,1,2,3,15,19
20141101-M-Geneva_CH-SF-Radu_Albot-Marcos_Baghdatis,1,F-II,4,2,0,0,2,0,4
20141101-M-Geneva_CH-SF-Radu_Albot-Marcos_Baghdatis,1,B-XC,49,6,0,0,6,19,30
20141101-M-Geneva_CH-SF-Radu_Albot-Marcos_Baghdatis,1,B-DTM,38,7,1,2,4,16,22
20141101-M-Geneva_CH-SF-Radu_Albot-Marcos_Baghdatis,1,B-DTL,1,0,0,0,0,1,0
20141101-M-Geneva_CH-SF-Radu_Albot-Marcos_Baghdatis,1,B-IO,3,1,0,0,1,1,2
20141101-M-Geneva_CH-SF-Radu_Albot-Marcos_Baghdatis,1,S-XC,18,1,0,0,1,5,13
20141101-M-Geneva_CH-SF-Radu_Albot-Marcos_Baghdatis,1,S-DTM,13,1,0,0,1,3,10
20141101-M-Geneva_CH-SF-Radu_Albot-Marcos_Baghdatis,1,S-DTL,3,0,0,0,0,1,2
20141101-M-Geneva_CH-SF-Radu_Albot-Marcos_Baghdatis,1,S-IO,1,0,0,0,0,0,1
20141101-M-Geneva_CH-SF-Radu_Albot-Marcos_Baghdatis,2,F-XC,54,8,3,0,5,32,22
20141101-M-Geneva_CH-SF-Radu_Albot-Marcos_Baghdatis,2,F-DTM,24,2,0,1,1,14,10
20141101-M-Geneva_CH-SF-Radu_Albot-Marcos_Baghdatis,2,F-DTL,13,7,1,0,6,7,6
20141101-M-Geneva_CH-SF-Radu_Albot-Marcos_Baghdatis,2,F-IO,20,4,2,1,1,13,7
20141101-M-Geneva_CH-SF-Radu_Albot-Marcos_Baghdatis,2,F-II,2,0,0,0,0,1,1
20141101-M-Geneva_CH-SF-Radu_Albot-Marcos_Baghdatis,2,B-XC,68,4,1,1,2,38,30
20141101-M-Geneva_CH-SF-Radu_Albot-Marcos_Baghdatis,2,B-DTM,34,1,0,0,1,18,16
20141101-M-Geneva_CH-SF-Radu_Albot-Marcos_Baghdatis,2,B-DTL,8,2,1,1,0,4,4
20141101-M-Geneva_CH-SF-Radu_Albot-Marcos_Baghdatis,2,B-IO,2,2,1,0,1,1,1
20141101-M-Geneva_CH-SF-Radu_Albot-Marcos_Baghdatis,2,S-XC,19,2,0,0,2,14,5
20141101-M-Geneva_CH-SF-Radu_Albot-Marcos_Baghdatis,2,S-DTM,7,1,0,0,1,5,2
20141101-M-Geneva_CH-SF-Radu_Albot-Marcos_Baghdatis,2,S-DTL,4,0,0,0,0,3,1
20150203-M-Glasgow_CH-R32-Niels_Desein-Tim_Puetz,1,F-XC,31,7,3,2,2,17,14
20150203-M-Glasgow_CH-R32-Niels_Desein-Tim_Puetz,1,F-DTM,14,2,0,0,2,6,8
20150203-M-Glasgow_CH-R32-Niels_Desein-Tim_Puetz,1,F-DTL,5,4,0,3,1,3,2
20150203-M-Glasgow_CH-R32-Niels_Desein-Tim_Puetz,1,F-IO,9,3,1,1,1,3,6
20150203-M-Glasgow_CH-R32-Niels_Desein-Tim_Puetz,1,F-II,2,0,0,0,0,1,1
20150203-M-Glasgow_CH-R32-Niels_Desein-Tim_Puetz,1,B-XC,29,3,1,1,1,17,12
20150203-M-Glasgow_CH-R32-Niels_Desein-Tim_Puetz,1,B-DTM,21,0,0,0,0,11,10
20150203-M-Glasgow_CH-R32-Niels_Desein-Tim_Puetz,1,B-DTL,3,1,1,0,0,1,2
20150203-M-Glasgow_CH-R32-Niels_Desein-Tim_Puetz,1,S-XC,9,1,0,0,1,5,4
20150203-M-Glasgow_CH-R32-Niels_Desein-Tim_Puetz,1,S-DTM,8,0,0,0,0,2,6
20150203-M-Glasgow_CH-R32-Niels_Desein-Tim_Puetz,2,F-XC,24,4,2,1,1,13,11
20150203-M-Glasgow_CH-R32-Niels_Desein-Tim_Puetz,2,F-DTM,11,1,0,0,1,3,8
20150203-M-Glasgow_CH-R32-Niels_Desein-Tim_Puetz,2,F-DTL,6,2,0,0,2,4,2
20150203-M-Glasgow_CH-R32-Niels_Desein-Tim_Puetz,2,F-IO,13,2,0,0,2,3,10
20150203-M-Glasgow_CH-R32-Niels_Desein-Tim_Puetz,2,F-II,1,1,1,0,0,1,0
20150203-M-Glasgow_CH-R32-Niels_Desein-Tim_Puetz,2,B-XC,32,7,3,2,2,18,14
20150203-M-Glasgow_CH-R32-Niels_Desein-Tim_Puetz,2,B-DTM,14,0,0,0,0,7,7
20150203-M-Glasgow_CH-R32-Niels_Desein-Tim_Puetz,2,B-DTL,3,0,0,0,0,0,3
20150203-M-Glasgow_CH-R32-Niels_Desein-Tim_Puetz,2,B-IO,6,2,2,0,0,4,2
20150203-M-Glasgow_CH-R32-Niels_Desein-Tim_Puetz,2,S-XC,10,2,0,1,1,7,3
20150203-M-Glasgow_CH-R32-Niels_Desein-Tim_Puetz,2,S-DTM,6,0,0,0,0,4,2
20150203-M-Glasgow_CH-R32-Niels_Desein-Tim_Puetz,2,S-DTL,3,1,0,1,0,2,1
20150203-M-Glasgow_CH-R32-Niels_Desein-Tim_Puetz,2,S-IO,2,2,0,0,2,0,2
20140920-M-Meknes_CH-SF-Matteo_Viola-Kimmer_Coppejans,1,F-XC,49,5,2,1,2,25,24
20140920-M-Meknes_CH-SF-Matteo_Viola-Kimmer_Coppejans,1,F-DTM,39,2,0,0,2,17,22
20140920-M-Meknes_CH-SF-Matteo_Viola-Kimmer_Coppejans,1,F-DTL,16,6,2,2,2,10,6
20140920-M-Meknes_CH-SF-Matteo_Viola-Kimmer_Coppejans,1,F-IO,18,2,1,0,1,10,8
20140920-M-Meknes_CH-SF-Matteo_Viola-Kimmer_Coppejans,1,B-XC,59,7,2,1,4,29,30
20140920-M-Meknes_CH-SF-Matteo_Viola-Kimmer_Coppejans,1,B-DTM,35,4,0,0,4,17,18
20140920-M-Meknes_CH-SF-Matteo_Viola-Kimmer_Coppejans,1,B-DTL,15,8,6,1,1,11,4
20140920-M-Meknes_CH-SF-Matteo_Viola-Kimmer_Coppejans,1,B-IO,9,3,0,0,3,5,4
20140920-M-Meknes_CH-SF-Matteo_Viola-Kimmer_Coppejans,1,S-XC,15,0,0,0,0,5,10
20140920-M-Meknes_CH-SF-Matteo_Viola-Kimmer_Coppejans,1,S-DTM,10,1,0,0,1,4,6
20140920-M-Meknes_CH-SF-Matteo_Viola-Kimmer_Coppejans,1,S-DTL,1,0,0,0,0,0,1
20140920-M-Meknes_CH-SF-Matteo_Viola-Kimmer_Coppejans,1,S-IO,2,1,0,0,1,0,2
20140920-M-Meknes_CH-SF-Matteo_Viola-Kimmer_Coppejans,2,F-XC,55,15,1,7,7,33,22
20140920-M-Meknes_CH-SF-Matteo_Viola-Kimmer_Coppejans,2,F-DTM,33,4,0,0,4,9,24
20140920-M-Meknes_CH-SF-Matteo_Viola-Kimmer_Coppejans,2,F-DTL,22,13,6,5,2,15,7
20140920-M-Meknes_CH-SF-Matteo_Viola-Kimmer_Coppejans,2,F-IO,38,9,2,3,4,21,17
20140920-M-Meknes_CH-SF-Matteo_Viola-Kimmer_Coppejans,2,F-II,3,1,1,0,0,2,1
20140920-M-Meknes_CH-SF-Matteo_Viola-Kimmer_Coppejans,2,B-XC,43,10,1,2,7,22,21
20140920-M-Meknes_CH-SF-Matteo_Viola-Kimmer_Coppejans,2,B-DTM,51,9,0,2,7,23,28
20140920-M-Meknes_CH-SF-Matteo_Viola-Kimmer_Coppejans,2,B-DTL,9,3,2,0,1,5,4
20140920-M-Meknes_CH-SF-Matteo_Viola-Kimmer_Coppejans,2,B-IO,6,2,0,0,2,3,3
20140920-M-Meknes_CH-SF-Matteo_Viola-Kimmer_Coppejans,2,S-XC,10,1,0,0,1,3,7
20140920-M-Meknes_CH-SF-Matteo_Viola-Kimmer_Coppejans,2,S-DTM,7,0,0,0,0,5,2
20140920-M-Meknes_CH-SF-Matteo_Viola-Kimmer_Coppejans,2,S-DTL,1,0,0,0,0,0,1
20140920-M-Meknes_CH-SF-Matteo_Viola-Kimmer_Coppejans,2,S-IO,1,0,0,0,0,0,1
20150316-M-Indian_Wells_Masters-R32-David_Ferrer-Bernard_Tomic,1,F-XC,63,11,4,2,5,35,28
20150316-M-Indian_Wells_Masters-R32-David_Ferrer-Bernard_Tomic,1,F-DTM,17,1,0,0,1,7,10
20150316-M-Indian_Wells_Masters-R32-David_Ferrer-Bernard_Tomic,1,F-DTL,22,2,0,0,2,11,11
20150316-M-Indian_Wells_Masters-R32-David_Ferrer-Bernard_Tomic,1,F-IO,75,10,2,3,5,41,34
20150316-M-Indian_Wells_Masters-R32-David_Ferrer-Bernard_Tomic,1,F-II,6,3,1,2,0,4,2
20150316-M-Indian_Wells_Masters-R32-David_Ferrer-Bernard_Tomic,1,B-XC,83,2,0,0,2,38,45
20150316-M-Indian_Wells_Masters-R32-David_Ferrer-Bernard_Tomic,1,B-DTM,21,1,0,0,1,12,9
20150316-M-Indian_Wells_Masters-R32-David_Ferrer-Bernard_Tomic,1,B-DTL,9,6,1,1,4,4,5
20150316-M-Indian_Wells_Masters-R32-David_Ferrer-Bernard_Tomic,1,B-IO,1,1,0,0,1,0,1
20150316-M-Indian_Wells_Masters-R32-David_Ferrer-Bernard_Tomic,1,S-XC,9,2,0,0,2,4,5
20150316-M-Indian_Wells_Masters-R32-David_Ferrer-Bernard_Tomic,1,S-DTM,5,1,0,0,1,3,2
20150316-M-Indian_Wells_Masters-R32-David_Ferrer-Bernard_Tomic,1,S-DTL,2,0,0,0,0,1,1
20150316-M-Indian_Wells_Masters-R32-David_Ferrer-Bernard_Tomic,2,F-XC,47,15,3,2,10,18,29
20150316-M-Indian_Wells_Masters-R32-David_Ferrer-Bernard_Tomic,2,F-DTM,21,4,0,2,2,10,11
20150316-M-Indian_Wells_Masters-R32-David_Ferrer-Bernard_Tomic,2,F-DTL,30,9,1,3,5,15,15
20150316-M-Indian_Wells_Masters-R32-David_Ferrer-Bernard_Tomic,2,F-IO,30,5,2,1,2,18,12
20150316-M-Indian_Wells_Masters-R32-David_Ferrer-Bernard_Tomic,2,F-II,4,2,1,0,1,3,1
20150316-M-Indian_Wells_Masters-R32-David_Ferrer-Bernard_Tomic,2,B-XC,76,4,1,0,3,42,34
20150316-M-Indian_Wells_Masters-R32-David_Ferrer-Bernard_Tomic,2,B-DTM,36,3,0,0,3,15,21
20150316-M-Indian_Wells_Masters-R32-David_Ferrer-Bernard_Tomic,2,B-DTL,27,10,1,3,6,16,11
20150316-M-Indian_Wells_Masters-R32-David_Ferrer-Bernard_Tomic,2,B-IO,2,0,0,0,0,1,1
20150316-M-Indian_Wells_Masters-R32-David_Ferrer-Bernard_Tomic,2,S-XC,28,0,0,0,0,11,17
20150316-M-Indian_Wells_Masters-R32-David_Ferrer-Bernard_Tomic,2,S-DTM,15,1,0,0,1,3,12
20150316-M-Indian_Wells_Masters-R32-David_Ferrer-Bernard_Tomic,2,S-DTL,10,2,0,0,2,5,5
20150316-M-Indian_Wells_Masters-R32-David_Ferrer-Bernard_Tomic,2,S-IO,2,0,0,0,0,0,2
20131012-M-Shanghai_Masters-SF-Rafael_Nadal-Juan_Martin_Del_Potro,1,F-XC,47,4,1,1,2,23,24
20131012-M-Shanghai_Masters-SF-Rafael_Nadal-Juan_Martin_Del_Potro,1,F-DTM,20,2,0,0,2,9,11
20131012-M-Shanghai_Masters-SF-Rafael_Nadal-Juan_Martin_Del_Potro,1,F-DTL,19,7,0,2,5,6,13
20131012-M-Shanghai_Masters-SF-Rafael_Nadal-Juan_Martin_Del_Potro,1,F-IO,25,7,5,1,1,18,7
20131012-M-Shanghai_Masters-SF-Rafael_Nadal-Juan_Martin_Del_Potro,1,F-II,3,1,1,0,0,2,1
20131012-M-Shanghai_Masters-SF-Rafael_Nadal-Juan_Martin_Del_Potro,1,B-XC,32,6,1,1,4,13,19
20131012-M-Shanghai_Masters-SF-Rafael_Nadal-Juan_Martin_Del_Potro,1,B-DTM,37,1,0,0,1,20,17
20131012-M-Shanghai_Masters-SF-Rafael_Nadal-Juan_Martin_Del_Potro,1,B-DTL,10,5,2,0,3,6,4
20131012-M-Shanghai_Masters-SF-Rafael_Nadal-Juan_Martin_Del_Potro,1,B-IO,7,1,0,0,1,3,4
20131012-M-Shanghai_Masters-SF-Rafael_Nadal-Juan_Martin_Del_Potro,1,S-XC,3,0,0,0,0,2,1
20131012-M-Shanghai_Masters-SF-Rafael_Nadal-Juan_Martin_Del_Potro,1,S-DTM,15,2,0,0,2,4,11
20131012-M-Shanghai_Masters-SF-Rafael_Nadal-Juan_Martin_Del_Potro,1,S-DTL,10,0,0,0,0,1,9
20131012-M-Shanghai_Masters-SF-Rafael_Nadal-Juan_Martin_Del_Potro,1,S-IO,1,0,0,0,0,0,1
20131012-M-Shanghai_Masters-SF-Rafael_Nadal-Juan_Martin_Del_Potro,2,F-XC,67,12,4,1,7,34,33
20131012-M-Shanghai_Masters-SF-Rafael_Nadal-Juan_Martin_Del_Potro,2,F-DTM,22,4,1,0,3,8,14
20131012-M-Shanghai_Masters-SF-Rafael_Nadal-Juan_Martin_Del_Potro,2,F-DTL,16,11,4,2,5,9,7
20131012-M-Shanghai_Masters-SF-Rafael_Nadal-Juan_Martin_Del_Potro,2,F-IO,38,12,6,2,4,26,12
20131012-M-Shanghai_Masters-SF-Rafael_Nadal-Juan_Martin_Del_Potro,2,F-II,10,1,0,0,1,6,4
20131012-M-Shanghai_Masters-SF-Rafael_Nadal-Juan_Martin_Del_Potro,2,B-XC,43,9,1,1,7,22,21
20131012-M-Shanghai_Masters-SF-Rafael_Nadal-Juan_Martin_Del_Potro,2,B-DTM,12,2,0,1,1,6,6
20131012-M-Shanghai_Masters-SF-Rafael_Nadal-Juan_Martin_Del_Potro,2,B-DTL,12,2,0,0,2,8,4
20131012-M-Shanghai_Masters-SF-Rafael_Nadal-Juan_Martin_Del_Potro,2,B-IO,12,3,1,0,2,6,6
20131012-M-Shanghai_Masters-SF-Rafael_Nadal-Juan_Martin_Del_Potro,2,S-XC,2,0,0,0,0,0,2
20131012-M-Shanghai_Masters-SF-Rafael_Nadal-Juan_Martin_Del_Potro,2,S-DTM,1,0,0,0,0,0,1
20131012-M-Shanghai_Masters-SF-Rafael_Nadal-Juan_Martin_Del_Potro,2,S-IO,1,0,0,0,0,1,0
20140922-M-Shenzhen-R16-Somdev_Devvarman-Andy_Murray,1,F-XC,40,2,1,1,0,17,23
20140922-M-Shenzhen-R16-Somdev_Devvarman-Andy_Murray,1,F-DTM,24,3,0,0,3,7,17
20140922-M-Shenzhen-R16-Somdev_Devvarman-Andy_Murray,1,F-DTL,19,2,0,0,2,10,9
20140922-M-Shenzhen-R16-Somdev_Devvarman-Andy_Murray,1,F-IO,23,6,0,3,3,12,11
20140922-M-Shenzhen-R16-Somdev_Devvarman-Andy_Murray,1,F-II,1,0,0,0,0,1,0
20140922-M-Shenzhen-R16-Somdev_Devvarman-Andy_Murray,1,B-XC,25,2,1,0,1,16,9
20140922-M-Shenzhen-R16-Somdev_Devvarman-Andy_Murray,1,B-DTM,20,2,0,0,2,5,15
20140922-M-Shenzhen-R16-Somdev_Devvarman-Andy_Murray,1,B-DTL,8,3,0,0,3,3,5
20140922-M-Shenzhen-R16-Somdev_Devvarman-Andy_Murray,1,B-IO,3,0,0,0,0,0,3
20140922-M-Shenzhen-R16-Somdev_Devvarman-Andy_Murray,1,S-XC,14,1,0,0,1,5,9
20140922-M-Shenzhen-R16-Somdev_Devvarman-Andy_Murray,1,S-DTM,10,0,0,0,0,5,5
20140922-M-Shenzhen-R16-Somdev_Devvarman-Andy_Murray,1,S-IO,2,0,0,0,0,1,1
20140922-M-Shenzhen-R16-Somdev_Devvarman-Andy_Murray,2,F-XC,51,10,5,2,3,33,18
20140922-M-Shenzhen-R16-Somdev_Devvarman-Andy_Murray,2,F-DTM,6,1,0,0,1,2,4
20140922-M-Shenzhen-R16-Somdev_Devvarman-Andy_Murray,2,F-DTL,20,3,0,2,1,14,6
20140922-M-Shenzhen-R16-Somdev_Devvarman-Andy_Murray,2,F-IO,34,12,6,1,5,21,13
20140922-M-Shenzhen-R16-Somdev_Devvarman-Andy_Murray,2,F-II,5,2,2,0,0,5,0
20140922-M-Shenzhen-R16-Somdev_Devvarman-Andy_Murray,2,B-XC,27,5,0,0,5,12,15
20140922-M-Shenzhen-R16-Somdev_Devvarman-Andy_Murray,2,B-DTM,17,0,0,0,0,11,6
20140922-M-Shenzhen-R16-Somdev_Devvarman-Andy_Murray,2,B-DTL,15,3,1,1,1,9,6
20140922-M-Shenzhen-R16-Somdev_Devvarman-Andy_Murray,2,B-IO,6,2,1,0,1,3,3
20140922-M-Shenzhen-R16-Somdev_Devvarman-Andy_Murray,2,S-XC,3,1,0,0,1,1,2
20140922-M-Shenzhen-R16-Somdev_Devvarman-Andy_Murray,2,S-DTM,9,0,0,0,0,3,6
20140922-M-Shenzhen-R16-Somdev_Devvarman-Andy_Murray,2,S-DTL,2,1,0,0,1,0,2
20001127-M-Tour_Finals-SF-Marat_Safin-Andre_Agassi,1,F-XC,39,6,3,2,1,17,22
20001127-M-Tour_Finals-SF-Marat_Safin-Andre_Agassi,1,F-DTM,21,4,0,1,3,12,9
20001127-M-Tour_Finals-SF-Marat_Safin-Andre_Agassi,1,F-DTL,10,5,1,0,4,2,8
20001127-M-Tour_Finals-SF-Marat_Safin-Andre_Agassi,1,F-IO,7,3,0,0,3,2,5
20001127-M-Tour_Finals-SF-Marat_Safin-Andre_Agassi,1,F-II,1,0,0,0,0,0,1
20001127-M-Tour_Finals-SF-Marat_Safin-Andre_Agassi,1,B-XC,60,6,1,1,4,26,34
20001127-M-Tour_Finals-SF-Marat_Safin-Andre_Agassi,1,B-DTM,20,2,0,1,1,9,11
20001127-M-Tour_Finals-SF-Marat_Safin-Andre_Agassi,1,B-DTL,23,10,7,0,3,13,10
20001127-M-Tour_Finals-SF-Marat_Safin-Andre_Agassi,1,B-IO,1,0,0,0,0,1,0
20001127-M-Tour_Finals-SF-Marat_Safin-Andre_Agassi,1,S-XC,7,2,0,2,0,3,4
20001127-M-Tour_Finals-SF-Marat_Safin-Andre_Agassi,1,S-DTM,4,0,0,0,0,1,3
20001127-M-Tour_Finals-SF-Marat_Safin-Andre_Agassi,1,S-DTL,1,0,0,0,0,0,1
20001127-M-Tour_Finals-SF-Marat_Safin-Andre_Agassi,2,F-XC,48,10,2,5,3,30,18
20001127-M-Tour_Finals-SF-Marat_Safin-Andre_Agassi,2,F-DTM,19,1,0,0,1,10,9
20001127-M-Tour_Finals-SF-Marat_Safin-Andre_Agassi,2,F-DTL,11,3,1,1,1,7,4
20001127-M-Tour_Finals-SF-Marat_Safin-Andre_Agassi,2,F-IO,11,5,2,3,0,6,5
20001127-M-Tour_Finals-SF-Marat_Safin-Andre_Agassi,2,F-II,1,1,0,0,1,0,1
20001127-M-Tour_Finals-SF-Marat_Safin-Andre_Agassi,2,B-XC,72,8,2,3,3,43,29
20001127-M-Tour_Finals-SF-Marat_Safin-Andre_Agassi,2,B-DTM,15,0,0,0,0,11,4
20001127-M-Tour_Finals-SF-Marat_Safin-Andre_Agassi,2,B-DTL,7,3,3,0,0,6,1
20001127-M-Tour_Finals-SF-Marat_Safin-Andre_Agassi,2,B-IO,3,1,0,0,1,1,2
20001127-M-Tour_Finals-SF-Marat_Safin-Andre_Agassi,2,S-XC,6,1,0,1,0,5,1
20001127-M-Tour_Finals-SF-Marat_Safin-Andre_Agassi,2,S-DTM,1,0,0,0,0,0,1
20001127-M-Tour_Finals-SF-Marat_Safin-Andre_Agassi,2,S-DTL,1,1,0,1,0,1,0
20010611-M-Halle-QF-Patrick_Rafter-Roger_Federer,1,F-XC,3,2,1,1,0,2,1
20010611-M-Halle-QF-Patrick_Rafter-Roger_Federer,1,F-DTL,2,1,1,0,0,1,1
20010611-M-Halle-QF-Patrick_Rafter-Roger_Federer,1,F-IO,5,3,3,0,0,4,1
20010611-M-Halle-QF-Patrick_Rafter-Roger_Federer,1,B-XC,6,3,2,1,0,4,2
20010611-M-Halle-QF-Patrick_Rafter-Roger_Federer,1,B-DTL,3,2,2,0,0,2,1
20010611-M-Halle-QF-Patrick_Rafter-Roger_Federer,1,B-IO,1,1,0,0,1,0,1
20010611-M-Halle-QF-Patrick_Rafter-Roger_Federer,1,S-DTL,1,0,0,0,0,0,1
20010611-M-Halle-QF-Patrick_Rafter-Roger_Federer,2,F-XC,3,2,1,1,0,2,1
20010611-M-Halle-QF-Patrick_Rafter-Roger_Federer,2,F-DTL,2,0,0,0,0,1,1
20010611-M-Halle-QF-Patrick_Rafter-Roger_Federer,2,F-IO,3,2,2,0,0,3,0
20010611-M-Halle-QF-Patrick_Rafter-Roger_Federer,2,F-II,1,0,0,0,0,0,1
20010611-M-Halle-QF-Patrick_Rafter-Roger_Federer,2,B-XC,2,0,0,0,0,0,2
20010611-M-Halle-QF-Patrick_Rafter-Roger_Federer,2,B-DTL,2,1,1,0,0,1,1
20060826-M-US_Open-F-Roger_Federer-Andy_Roddick,1,F-XC,62,19,9,5,5,45,17
20060826-M-US_Open-F-Roger_Federer-Andy_Roddick,1,F-DTM,16,0,0,0,0,12,4
20060826-M-US_Open-F-Roger_Federer-Andy_Roddick,1,F-DTL,26,5,3,1,1,17,9
20060826-M-US_Open-F-Roger_Federer-Andy_Roddick,1,F-IO,39,13,7,4,2,25,14
20060826-M-US_Open-F-Roger_Federer-Andy_Roddick,1,F-II,14,4,2,1,1,7,7
20060826-M-US_Open-F-Roger_Federer-Andy_Roddick,1,B-XC,72,20,6,6,8,39,33
20060826-M-US_Open-F-Roger_Federer-Andy_Roddick,1,B-DTM,24,1,0,0,1,14,10
20060826-M-US_Open-F-Roger_Federer-Andy_Roddick,1,B-DTL,25,8,4,1,3,14,11
20060826-M-US_Open-F-Roger_Federer-Andy_Roddick,1,B-IO,3,0,0,0,0,3,0
20060826-M-US_Open-F-Roger_Federer-Andy_Roddick,1,S-XC,23,5,0,1,4,13,10
20060826-M-US_Open-F-Roger_Federer-Andy_Roddick,1,S-DTM,3,0,0,0,0,2,1
20060826-M-US_Open-F-Roger_Federer-Andy_Roddick,1,S-DTL,5,0,0,0,0,5,0
20060826-M-US_Open-F-Roger_Federer-Andy_Roddick,2,F-XC,52,11,2,4,5,19,33
20060826-M-US_Open-F-Roger_Federer-Andy_Roddick,2,F-DTM,26,1,0,0,1,5,21
20060826-M-US_Open-F-Roger_Federer-Andy_Roddick,2,F-DTL,29,2,0,2,0,11,18
20060826-M-US_Open-F-Roger_Federer-Andy_Roddick,2,F-IO,50,7,1,4,2,26,24
20060826-M-US_Open-F-Roger_Federer-Andy_Roddick,2,F-II,13,7,0,3,4,8,5
20060826-M-US_Open-F-Roger_Federer-Andy_Roddick,2,B-XC,70,10,2,2,6,28,42
20060826-M-US_Open-F-Roger_Federer-Andy_Roddick,2,B-DTM,18,1,0,1,0,10,8
20060826-M-US_Open-F-Roger_Federer-Andy_Roddick,2,B-DTL,14,4,1,2,1,8,6
20060826-M-US_Open-F-Roger_Federer-Andy_Roddick,2,B-IO,2,1,0,0,1,0,2
20060826-M-US_Open-F-Roger_Federer-Andy_Roddick,2,S-XC,15,2,0,0,2,6,9
20060826-M-US_Open-F-Roger_Federer-Andy_Roddick,2,S-DTM,2,0,0,0,0,0,2
20060826-M-US_Open-F-Roger_Federer-Andy_Roddick,2,S-DTL,1,1,0,0,1,0,1
20060709-M-Wimbledon-F-Roger_Federer-Rafael_Nadal,1,F-XC,67,13,5,2,6,36,31
20060709-M-Wimbledon-F-Roger_Federer-Rafael_Nadal,1,F-DTM,21,1,0,1,0,14,7
20060709-M-Wimbledon-F-Roger_Federer-Rafael_Nadal,1,F-DTL,15,9,3,4,2,10,5
20060709-M-Wimbledon-F-Roger_Federer-Rafael_Nadal,1,F-IO,34,16,4,5,7,18,16
20060709-M-Wimbledon-F-Roger_Federer-Rafael_Nadal,1,F-II,12,2,0,0,2,6,6
20060709-M-Wimbledon-F-Roger_Federer-Rafael_Nadal,1,B-XC,29,7,2,3,2,13,16
20060709-M-Wimbledon-F-Roger_Federer-Rafael_Nadal,1,B-DTM,27,2,0,0,2,13,14
20060709-M-Wimbledon-F-Roger_Federer-Rafael_Nadal,1,B-DTL,25,8,1,1,6,9,16
20060709-M-Wimbledon-F-Roger_Federer-Rafael_Nadal,1,B-IO,1,1,0,0,1,0,1
20060709-M-Wimbledon-F-Roger_Federer-Rafael_Nadal,1,S-XC,11,1,0,0,1,5,6
20060709-M-Wimbledon-F-Roger_Federer-Rafael_Nadal,1,S-DTM,16,0,0,0,0,6,10
20060709-M-Wimbledon-F-Roger_Federer-Rafael_Nadal,1,S-DTL,13,1,0,0,1,9,4
20060709-M-Wimbledon-F-Roger_Federer-Rafael_Nadal,1,S-IO,1,0,0,0,0,1,0
20060709-M-Wimbledon-F-Roger_Federer-Rafael_Nadal,2,F-XC,99,14,5,3,6,59,40
20060709-M-Wimbledon-F-Roger_Federer-Rafael_Nadal,2,F-DTM,28,2,0,0,2,11,17
20060709-M-Wimbledon-F-Roger_Federer-Rafael_Nadal,2,F-DTL,16,9,4,1,4,8,8
20060709-M-Wimbledon-F-Roger_Federer-Rafael_Nadal,2,F-IO,22,8,1,3,4,11,11
20060709-M-Wimbledon-F-Roger_Federer-Rafael_Nadal,2,F-II,9,4,3,0,1,5,4
20060709-M-Wimbledon-F-Roger_Federer-Rafael_Nadal,2,B-XC,55,18,7,4,7,30,25
20060709-M-Wimbledon-F-Roger_Federer-Rafael_Nadal,2,B-DTM,23,3,0,0,3,8,15
20060709-M-Wimbledon-F-Roger_Federer-Rafael_Nadal,2,B-DTL,26,6,3,0,3,12,14
20060709-M-Wimbledon-F-Roger_Federer-Rafael_Nadal,2,B-IO,3,1,0,0,1,1,2
20060709-M-Wimbledon-F-Roger_Federer-Rafael_Nadal,2,S-DTM,2,0,0,0,0,1,1
20060709-M-Wimbledon-F-Roger_Federer-Rafael_Nadal,2,S-DTL,7,1,0,0,1,1,6
20060709-M-Wimbledon-F-Roger_Federer-Rafael_Nadal,2,S-IO,3,0,0,0,0,1,2
20071022-M-Basel-R16-Roger_Federer-Juan_Martin_Del_Potro,1,F-XC,29,4,1,1,2,17,12
20071022-M-Basel-R16-Roger_Federer-Juan_Martin_Del_Potro,1,F-DTM,6,1,0,0,1,4,2
20071022-M-Basel-R16-Roger_Federer-Juan_Martin_Del_Potro,1,F-DTL,15,5,1,0,4,9,6
20071022-M-Basel-R16-Roger_Federer-Juan_Martin_Del_Potro,1,F-IO,18,7,4,1,2,14,4
20071022-M-Basel-R16-Roger_Federer-Juan_Martin_Del_Potro,1,F-II,6,1,1,0,0,4,2
20071022-M-Basel-R16-Roger_Federer-Juan_Martin_Del_Potro,1,B-XC,13,6,4,0,2,9,4
20071022-M-Basel-R16-Roger_Federer-Juan_Martin_Del_Potro,1,B-DTM,12,1,0,1,0,10,2
20071022-M-Basel-R16-Roger_Federer-Juan_Martin_Del_Potro,1,B-DTL,10,3,2,0,1,8,2
20071022-M-Basel-R16-Roger_Federer-Juan_Martin_Del_Potro,1,B-IO,1,0,0,0,0,0,1
20071022-M-Basel-R16-Roger_Federer-Juan_Martin_Del_Potro,1,S-XC,14,0,0,0,0,12,2
20071022-M-Basel-R16-Roger_Federer-Juan_Martin_Del_Potro,1,S-DTL,2,0,0,0,0,1,1
20071022-M-Basel-R16-Roger_Federer-Juan_Martin_Del_Potro,2,F-XC,32,13,3,4,6,15,17
20071022-M-Basel-R16-Roger_Federer-Juan_Martin_Del_Potro,2,F-DTM,7,0,0,0,0,3,4
20071022-M-Basel-R16-Roger_Federer-Juan_Martin_Del_Potro,2,F-DTL,10,0,0,0,0,3,7
20071022-M-Basel-R16-Roger_Federer-Juan_Martin_Del_Potro,2,F-IO,11,1,0,0,1,2,9
20071022-M-Basel-R16-Roger_Federer-Juan_Martin_Del_Potro,2,F-II,3,0,0,0,0,1,2
20071022-M-Basel-R16-Roger_Federer-Juan_Martin_Del_Potro,2,B-XC,29,4,0,0,4,5,24
20071022-M-Basel-R16-Roger_Federer-Juan_Martin_Del_Potro,2,B-DTM,9,0,0,0,0,2,7
20071022-M-Basel-R16-Roger_Federer-Juan_Martin_Del_Potro,2,B-DTL,5,2,0,1,1,2,3
20071022-M-Basel-R16-Roger_Federer-Juan_Martin_Del_Potro,2,S-XC,8,1,0,0,1,0,8
20071022-M-Basel-R16-Roger_Federer-Juan_Martin_Del_Potro,2,S-DTM,2,0,0,0,0,0,2
20071022-M-Basel-R16-Roger_Federer-Juan_Martin_Del_Potro,2,S-DTL,2,0,0,0,0,1,1
20070708-M-Wimbledon-F-Roger_Federer-Rafael_Nadal,1,F-XC,73,19,5,7,7,38,35
20070708-M-Wimbledon-F-Roger_Federer-Rafael_Nadal,1,F-DTM,22,2,0,1,1,14,8
20070708-M-Wimbledon-F-Roger_Federer-Rafael_Nadal,1,F-DTL,27,16,5,1,10,11,16
20070708-M-Wimbledon-F-Roger_Federer-Rafael_Nadal,1,F-IO,32,15,5,4,6,17,15
20070708-M-Wimbledon-F-Roger_Federer-Rafael_Nadal,1,F-II,16,3,2,0,1,7,9
20070708-M-Wimbledon-F-Roger_Federer-Rafael_Nadal,1,B-XC,55,19,3,3,13,25,30
20070708-M-Wimbledon-F-Roger_Federer-Rafael_Nadal,1,B-DTM,30,3,0,0,3,11,19
20070708-M-Wimbledon-F-Roger_Federer-Rafael_Nadal,1,B-DTL,51,11,4,1,6,28,23
20070708-M-Wimbledon-F-Roger_Federer-Rafael_Nadal,1,B-IO,3,1,0,1,0,2,1
20070708-M-Wimbledon-F-Roger_Federer-Rafael_Nadal,1,S-XC,17,2,0,1,1,7,10
20070708-M-Wimbledon-F-Roger_Federer-Rafael_Nadal,1,S-DTM,5,0,0,0,0,0,5
20070708-M-Wimbledon-F-Roger_Federer-Rafael_Nadal,1,S-DTL,17,2,0,0,2,5,12
20070708-M-Wimbledon-F-Roger_Federer-Rafael_Nadal,1,S-IO,1,0,0,0,0,0,1
20070708-M-Wimbledon-F-Roger_Federer-Rafael_Nadal,2,F-XC,139,27,11,7,9,86,53
20070708-M-Wimbledon-F-Roger_Federer-Rafael_Nadal,2,F-DTM,15,1,0,0,1,9,6
20070708-M-Wimbledon-F-Roger_Federer-Rafael_Nadal,2,F-DTL,26,12,4,3,5,10,16
20070708-M-Wimbledon-F-Roger_Federer-Rafael_Nadal,2,F-IO,39,17,8,1,8,24,15
20070708-M-Wimbledon-F-Roger_Federer-Rafael_Nadal,2,F-II,9,3,1,1,1,6,3
20070708-M-Wimbledon-F-Roger_Federer-Rafael_Nadal,2,B-XC,57,19,5,4,10,28,29
20070708-M-Wimbledon-F-Roger_Federer-Rafael_Nadal,2,B-DTM,16,0,0,0,0,6,10
20070708-M-Wimbledon-F-Roger_Federer-Rafael_Nadal,2,B-DTL,38,7,4,0,3,21,17
20070708-M-Wimbledon-F-Roger_Federer-Rafael_Nadal,2,B-IO,5,1,1,0,0,2,3
20070708-M-Wimbledon-F-Roger_Federer-Rafael_Nadal,2,B-II,1,0,0,0,0,0,1
20070708-M-Wimbledon-F-Roger_Federer-Rafael_Nadal,2,S-XC,5,1,0,1,0,4,1
20070708-M-Wimbledon-F-Roger_Federer-Rafael_Nadal,2,S-DTM,7,1,0,0,1,3,4
20070708-M-Wimbledon-F-Roger_Federer-Rafael_Nadal,2,S-DTL,15,0,0,0,0,7,8
20070708-M-Wimbledon-F-Roger_Federer-Rafael_Nadal,2,S-IO,1,1,0,0,1,0,1
20070708-M-Wimbledon-F-Roger_Federer-Rafael_Nadal,2,S-II,1,0,0,0,0,0,1
20091122-M-London-RR-Robin_Soderling-Novak_Djokovic,1,F-XC,46,7,3,1,3,28,18
20091122-M-London-RR-Robin_Soderling-Novak_Djokovic,1,F-DTM,9,0,0,0,0,4,5
20091122-M-London-RR-Robin_Soderling-Novak_Djokovic,1,F-DTL,27,8,2,1,5,15,12
20091122-M-London-RR-Robin_Soderling-Novak_Djokovic,1,F-IO,26,5,2,0,3,13,13
20091122-M-London-RR-Robin_Soderling-Novak_Djokovic,1,F-II,8,0,0,0,0,4,4
20091122-M-London-RR-Robin_Soderling-Novak_Djokovic,1,B-XC,47,5,0,1,4,22,25
20091122-M-London-RR-Robin_Soderling-Novak_Djokovic,1,B-DTM,9,0,0,0,0,4,5
20091122-M-London-RR-Robin_Soderling-Novak_Djokovic,1,B-DTL,14,5,2,0,3,9,5
20091122-M-London-RR-Robin_Soderling-Novak_Djokovic,1,B-IO,2,1,0,1,0,2,0
20091122-M-London-RR-Robin_Soderling-Novak_Djokovic,1,S-XC,3,1,0,0,1,1,2
20091122-M-London-RR-Robin_Soderling-Novak_Djokovic,2,F-XC,43,9,0,1,8,14,29
20091122-M-London-RR-Robin_Soderling-Novak_Djokovic,2,F-DTM,10,1,0,0,1,2,8
20091122-M-London-RR-Robin_Soderling-Novak_Djokovic,2,F-DTL,10,1,0,0,1,2,8
20091122-M-London-RR-Robin_Soderling-Novak_Djokovic,2,F-IO,16,5,2,0,3,8,8
20091122-M-London-RR-Robin_Soderling-Novak_Djokovic,2,F-II,1,0,0,0,0,0,1
20091122-M-London-RR-Robin_Soderling-Novak_Djokovic,2,B-XC,37,7,1,1,5,18,19
20091122-M-London-RR-Robin_Soderling-Novak_Djokovic,2,B-DTM,19,1,0,0,1,7,12
20091122-M-London-RR-Robin_Soderling-Novak_Djokovic,2,B-DTL,8,3,3,0,0,7,1
20091122-M-London-RR-Robin_Soderling-Novak_Djokovic,2,B-IO,5,1,0,0,1,3,2
20091122-M-London-RR-Robin_Soderling-Novak_Djokovic,2,S-XC,21,2,0,0,2,13,8
20091122-M-London-RR-Robin_Soderling-Novak_Djokovic,2,S-DTM,6,0,0,0,0,4,2
20091122-M-London-RR-Robin_Soderling-Novak_Djokovic,2,S-DTL,1,0,0,0,0,1,0
20090810-M-Montreal_Masters-R32-Fernando_Gonzalez-Milos_Raonic,1,F-XC,39,14,8,3,3,24,15
20090810-M-Montreal_Masters-R32-Fernando_Gonzalez-Milos_Raonic,1,F-DTM,20,3,0,2,1,9,11
20090810-M-Montreal_Masters-R32-Fernando_Gonzalez-Milos_Raonic,1,F-DTL,8,3,0,1,2,5,3
20090810-M-Montreal_Masters-R32-Fernando_Gonzalez-Milos_Raonic,1,F-IO,50,11,2,5,4,34,16
20090810-M-Montreal_Masters-R32-Fernando_Gonzalez-Milos_Raonic,1,F-II,12,8,5,3,0,11,1
20090810-M-Montreal_Masters-R32-Fernando_Gonzalez-Milos_Raonic,1,B-XC,11,1,0,1,0,7,4
20090810-M-Montreal_Masters-R32-Fernando_Gonzalez-Milos_Raonic,1,B-DTM,5,1,0,0,1,2,3
20090810-M-Montreal_Masters-R32-Fernando_Gonzalez-Milos_Raonic,1,B-DTL,5,3,2,1,0,5,0
20090810-M-Montreal_Masters-R32-Fernando_Gonzalez-Milos_Raonic,1,B-IO,4,1,0,0,1,1,3
20090810-M-Montreal_Masters-R32-Fernando_Gonzalez-Milos_Raonic,1,S-XC,22,3,0,1,2,12,10
20090810-M-Montreal_Masters-R32-Fernando_Gonzalez-Milos_Raonic,1,S-DTM,6,0,0,0,0,4,2
20090810-M-Montreal_Masters-R32-Fernando_Gonzalez-Milos_Raonic,1,S-DTL,2,0,0,0,0,2,0
20090810-M-Montreal_Masters-R32-Fernando_Gonzalez-Milos_Raonic,1,S-IO,1,1,0,1,0,1,0
20090810-M-Montreal_Masters-R32-Fernando_Gonzalez-Milos_Raonic,2,F-XC,28,13,6,3,4,14,14
20090810-M-Montreal_Masters-R32-Fernando_Gonzalez-Milos_Raonic,2,F-DTM,23,3,0,1,2,9,14
20090810-M-Montreal_Masters-R32-Fernando_Gonzalez-Milos_Raonic,2,F-DTL,15,3,3,0,0,8,7
20090810-M-Montreal_Masters-R32-Fernando_Gonzalez-Milos_Raonic,2,F-IO,48,16,5,2,9,20,28
20090810-M-Montreal_Masters-R32-Fernando_Gonzalez-Milos_Raonic,2,F-II,9,4,1,1,2,4,5
20090810-M-Montreal_Masters-R32-Fernando_Gonzalez-Milos_Raonic,2,B-XC,11,4,1,1,2,4,7
20090810-M-Montreal_Masters-R32-Fernando_Gonzalez-Milos_Raonic,2,B-DTM,14,2,0,1,1,3,11
20090810-M-Montreal_Masters-R32-Fernando_Gonzalez-Milos_Raonic,2,B-DTL,7,2,1,0,1,4,3
20090810-M-Montreal_Masters-R32-Fernando_Gonzalez-Milos_Raonic,2,B-IO,1,0,0,0,0,1,0
20090810-M-Montreal_Masters-R32-Fernando_Gonzalez-Milos_Raonic,2,S-XC,19,3,0,0,3,5,14
20090810-M-Montreal_Masters-R32-Fernando_Gonzalez-Milos_Raonic,2,S-DTM,7,1,0,0,1,3,4
20090810-M-Montreal_Masters-R32-Fernando_Gonzalez-Milos_Raonic,2,S-DTL,6,2,0,0,2,3,3
20090912-M-US_Open-F-Roger_Federer-Juan_Martin_Del_Potro,1,F-XC,91,20,6,4,10,56,35
20090912-M-US_Open-F-Roger_Federer-Juan_Martin_Del_Potro,1,F-DTM,50,1,0,0,1,31,19
20090912-M-US_Open-F-Roger_Federer-Juan_Martin_Del_Potro,1,F-DTL,23,6,1,2,3,14,9
20090912-M-US_Open-F-Roger_Federer-Juan_Martin_Del_Potro,1,F-IO,57,18,5,6,7,30,27
20090912-M-US_Open-F-Roger_Federer-Juan_Martin_Del_Potro,1,F-II,17,9,3,0,6,8,9
20090912-M-US_Open-F-Roger_Federer-Juan_Martin_Del_Potro,1,B-XC,77,16,4,2,10,39,38
20090912-M-US_Open-F-Roger_Federer-Juan_Martin_Del_Potro,1,B-DTM,48,2,0,0,2,25,23
20090912-M-US_Open-F-Roger_Federer-Juan_Martin_Del_Potro,1,B-DTL,28,10,4,1,5,11,17
20090912-M-US_Open-F-Roger_Federer-Juan_Martin_Del_Potro,1,B-IO,3,2,0,0,2,0,3
20090912-M-US_Open-F-Roger_Federer-Juan_Martin_Del_Potro,1,S-XC,36,6,0,1,5,18,18
20090912-M-US_Open-F-Roger_Federer-Juan_Martin_Del_Potro,1,S-DTM,13,0,0,0,0,6,7
20090912-M-US_Open-F-Roger_Federer-Juan_Martin_Del_Potro,1,S-DTL,5,1,0,0,1,4,1
20090912-M-US_Open-F-Roger_Federer-Juan_Martin_Del_Potro,1,S-IO,1,0,0,0,0,1,0
20090912-M-US_Open-F-Roger_Federer-Juan_Martin_Del_Potro,2,F-XC,118,48,12,11,25,56,62
20090912-M-US_Open-F-Roger_Federer-Juan_Martin_Del_Potro,2,F-DTM,38,2,0,0,2,17,21
20090912-M-US_Open-F-Roger_Federer-Juan_Martin_Del_Potro,2,F-DTL,47,18,9,3,6,26,21
20090912-M-US_Open-F-Roger_Federer-Juan_Martin_Del_Potro,2,F-IO,98,20,6,7,7,51,47
20090912-M-US_Open-F-Roger_Federer-Juan_Martin_Del_Potro,2,F-II,10,6,1,2,3,4,6
20090912-M-US_Open-F-Roger_Federer-Juan_Martin_Del_Potro,2,B-XC,87,9,1,3,5,47,40
20090912-M-US_Open-F-Roger_Federer-Juan_Martin_Del_Potro,2,B-DTM,43,2,0,0,2,16,27
20090912-M-US_Open-F-Roger_Federer-Juan_Martin_Del_Potro,2,B-DTL,24,7,2,2,3,11,13
20090912-M-US_Open-F-Roger_Federer-Juan_Martin_Del_Potro,2,B-IO,2,1,0,0,1,0,2
20090912-M-US_Open-F-Roger_Federer-Juan_Martin_Del_Potro,2,S-XC,10,1,0,1,0,6,4
20090912-M-US_Open-F-Roger_Federer-Juan_Martin_Del_Potro,2,S-DTM,1,0,0,0,0,0,1
20090912-M-US_Open-F-Roger_Federer-Juan_Martin_Del_Potro,2,S-DTL,3,0,0,0,0,1,2
20090831-M-US_Open-SF-Juan_Martin_Del_Potro-Rafael_Nadal,1,F-XC,84,10,0,7,3,51,33
20090831-M-US_Open-SF-Juan_Martin_Del_Potro-Rafael_Nadal,1,F-DTM,17,3,0,0,3,6,11
20090831-M-US_Open-SF-Juan_Martin_Del_Potro-Rafael_Nadal,1,F-DTL,21,11,3,2,6,12,9
20090831-M-US_Open-SF-Juan_Martin_Del_Potro-Rafael_Nadal,1,F-IO,35,16,7,6,3,25,10
20090831-M-US_Open-SF-Juan_Martin_Del_Potro-Rafael_Nadal,1,F-II,4,1,1,0,0,4,0
20090831-M-US_Open-SF-Juan_Martin_Del_Potro-Rafael_Nadal,1,B-XC,87,18,1,5,12,48,39
20090831-M-US_Open-SF-Juan_Martin_Del_Potro-Rafael_Nadal,1,B-DTM,34,3,0,0,3,12,22
20090831-M-US_Open-SF-Juan_Martin_Del_Potro-Rafael_Nadal,1,B-DTL,16,5,3,1,1,11,5
20090831-M-US_Open-SF-Juan_Martin_Del_Potro-Rafael_Nadal,1,B-IO,5,0,0,0,0,1,4
20090831-M-US_Open-SF-Juan_Martin_Del_Potro-Rafael_Nadal,1,S-XC,1,0,0,0,0,0,1
20090831-M-US_Open-SF-Juan_Martin_Del_Potro-Rafael_Nadal,1,S-DTM,1,0,0,0,0,1,0
20090831-M-US_Open-SF-Juan_Martin_Del_Potro-Rafael_Nadal,1,S-DTL,3,0,0,0,0,1,2
20090831-M-US_Open-SF-Juan_Martin_Del_Potro-Rafael_Nadal,2,F-XC,102,11,1,4,6,44,58
20090831-M-US_Open-SF-Juan_Martin_Del_Potro-Rafael_Nadal,2,F-DTM,32,1,0,0,1,14,18
20090831-M-US_Open-SF-Juan_Martin_Del_Potro-Rafael_Nadal,2,F-DTL,22,9,2,1,6,8,14
20090831-M-US_Open-SF-Juan_Martin_Del_Potro-Rafael_Nadal,2,F-IO,36,6,1,2,3,20,16
20090831-M-US_Open-SF-Juan_Martin_Del_Potro-Rafael_Nadal,2,F-II,10,2,0,2,0,5,5
20090831-M-US_Open-SF-Juan_Martin_Del_Potro-Rafael_Nadal,2,B-XC,36,6,2,0,4,15,21
20090831-M-US_Open-SF-Juan_Martin_Del_Potro-Rafael_Nadal,2,B-DTM,14,1,0,0,1,7,7
20090831-M-US_Open-SF-Juan_Martin_Del_Potro-Rafael_Nadal,2,B-DTL,14,2,1,0,1,8,6
20090831-M-US_Open-SF-Juan_Martin_Del_Potro-Rafael_Nadal,2,B-IO,3,1,0,0,1,2,1
20090831-M-US_Open-SF-Juan_Martin_Del_Potro-Rafael_Nadal,2,B-II,1,0,0,0,0,0,1
20090831-M-US_Open-SF-Juan_Martin_Del_Potro-Rafael_Nadal,2,S-XC,6,0,0,0,0,2,4
20090831-M-US_Open-SF-Juan_Martin_Del_Potro-Rafael_Nadal,2,S-DTM,13,1,0,0,1,4,9
20090831-M-US_Open-SF-Juan_Martin_Del_Potro-Rafael_Nadal,2,S-DTL,11,0,0,0,0,4,7
20090831-M-US_Open-SF-Juan_Martin_Del_Potro-Rafael_Nadal,2,S-IO,5,1,0,0,1,3,2
20090831-M-US_Open-SF-Juan_Martin_Del_Potro-Rafael_Nadal,2,S-II,1,0,0,0,0,0,1
20090705-M-Wimbledon-F-Andy_Roddick-Roger_Federer,1,F-XC,75,23,7,8,8,35,40
20090705-M-Wimbledon-F-Andy_Roddick-Roger_Federer,1,F-DTM,30,6,3,0,3,13,17
20090705-M-Wimbledon-F-Andy_Roddick-Roger_Federer,1,F-DTL,25,4,1,2,1,9,16
20090705-M-Wimbledon-F-Andy_Roddick-Roger_Federer,1,F-IO,59,15,8,3,4,36,23
20090705-M-Wimbledon-F-Andy_Roddick-Roger_Federer,1,F-II,4,0,0,0,0,2,2
20090705-M-Wimbledon-F-Andy_Roddick-Roger_Federer,1,B-XC,78,12,1,3,8,36,42
20090705-M-Wimbledon-F-Andy_Roddick-Roger_Federer,1,B-DTM,44,4,0,0,4,12,32
20090705-M-Wimbledon-F-Andy_Roddick-Roger_Federer,1,B-DTL,27,14,5,4,5,15,12
20090705-M-Wimbledon-F-Andy_Roddick-Roger_Federer,1,B-IO,9,3,1,0,2,3,6
20090705-M-Wimbledon-F-Andy_Roddick-Roger_Federer,1,S-XC,12,2,0,1,1,9,3
20090705-M-Wimbledon-F-Andy_Roddick-Roger_Federer,1,S-DTM,7,2,0,1,1,3,4
20090705-M-Wimbledon-F-Andy_Roddick-Roger_Federer,1,S-DTL,7,2,0,0,2,2,5
20090705-M-Wimbledon-F-Andy_Roddick-Roger_Federer,1,S-IO,3,2,0,0,2,0,3
20090705-M-Wimbledon-F-Andy_Roddick-Roger_Federer,2,F-XC,77,29,15,5,9,53,24
20090705-M-Wimbledon-F-Andy_Roddick-Roger_Federer,2,F-DTM,49,9,0,3,6,31,18
20090705-M-Wimbledon-F-Andy_Roddick-Roger_Federer,2,F-DTL,32,13,6,2,5,21,11
20090705-M-Wimbledon-F-Andy_Roddick-Roger_Federer,2,F-IO,46,21,13,5,3,28,18
20090705-M-Wimbledon-F-Andy_Roddick-Roger_Federer,2,F-II,7,2,0,1,1,2,5
20090705-M-Wimbledon-F-Andy_Roddick-Roger_Federer,2,B-XC,41,12,3,5,4,23,18
20090705-M-Wimbledon-F-Andy_Roddick-Roger_Federer,2,B-DTM,31,3,0,1,2,17,14
20090705-M-Wimbledon-F-Andy_Roddick-Roger_Federer,2,B-DTL,19,8,2,1,5,7,12
20090705-M-Wimbledon-F-Andy_Roddick-Roger_Federer,2,S-XC,47,8,1,2,5,24,23
20090705-M-Wimbledon-F-Andy_Roddick-Roger_Federer,2,S-DTM,16,2,0,0,2,9,7
20090705-M-Wimbledon-F-Andy_Roddick-Roger_Federer,2,S-DTL,6,1,0,1,0,3,3
20101010-M-Shanghai_Masters-QF-Robin_Soderling-Roger_Federer,1,F-XC,19,5,1,1,3,7,12
20101010-M-Shanghai_Masters-QF-Robin_Soderling-Roger_Federer,1,F-DTM,4,0,0,0,0,0,4
20101010-M-Shanghai_Masters-QF-Robin_Soderling-Roger_Federer,1,F-DTL,9,3,0,0,3,1,8
20101010-M-Shanghai_Masters-QF-Robin_Soderling-Roger_Federer,1,F-IO,24,6,1,1,4,8,16
20101010-M-Shanghai_Masters-QF-Robin_Soderling-Roger_Federer,1,B-XC,24,4,0,0,4,8,16
20101010-M-Shanghai_Masters-QF-Robin_Soderling-Roger_Federer,1,B-DTM,3,0,0,0,0,1,2
20101010-M-Shanghai_Masters-QF-Robin_Soderling-Roger_Federer,1,B-DTL,7,4,0,0,4,0,7
20101010-M-Shanghai_Masters-QF-Robin_Soderling-Roger_Federer,1,B-IO,2,0,0,0,0,0,2
20101010-M-Shanghai_Masters-QF-Robin_Soderling-Roger_Federer,1,S-XC,2,1,0,0,1,1,1
20101010-M-Shanghai_Masters-QF-Robin_Soderling-Roger_Federer,1,S-DTM,1,0,0,0,0,0,1
20101010-M-Shanghai_Masters-QF-Robin_Soderling-Roger_Federer,1,S-DTL,1,1,0,0,1,0,1
20101010-M-Shanghai_Masters-QF-Robin_Soderling-Roger_Federer,2,F-XC,19,4,2,0,2,13,6
20101010-M-Shanghai_Masters-QF-Robin_Soderling-Roger_Federer,2,F-DTM,2,1,0,1,0,1,1
20101010-M-Shanghai_Masters-QF-Robin_Soderling-Roger_Federer,2,F-DTL,5,0,0,0,0,5,0
20101010-M-Shanghai_Masters-QF-Robin_Soderling-Roger_Federer,2,F-IO,15,3,1,0,2,11,4
20101010-M-Shanghai_Masters-QF-Robin_Soderling-Roger_Federer,2,F-II,3,2,1,0,1,2,1
20101010-M-Shanghai_Masters-QF-Robin_Soderling-Roger_Federer,2,B-XC,12,2,0,0,2,6,6
20101010-M-Shanghai_Masters-QF-Robin_Soderling-Roger_Federer,2,B-DTM,7,1,0,0,1,4,3
20101010-M-Shanghai_Masters-QF-Robin_Soderling-Roger_Federer,2,B-DTL,7,5,2,0,3,3,4
20101010-M-Shanghai_Masters-QF-Robin_Soderling-Roger_Federer,2,B-IO,1,0,0,0,0,1,0
20101010-M-Shanghai_Masters-QF-Robin_Soderling-Roger_Federer,2,S-XC,9,0,0,0,0,5,4
20101010-M-Shanghai_Masters-QF-Robin_Soderling-Roger_Federer,2,S-DTM,4,0,0,0,0,4,0
20101010-M-Shanghai_Masters-QF-Robin_Soderling-Roger_Federer,2,S-DTL,1,0,0,0,0,1,0
20110102-M-Brisbane-R16-Robin_Soderling-Michael_Berrer,1,F-XC,37,11,4,3,4,20,17
20110102-M-Brisbane-R16-Robin_Soderling-Michael_Berrer,1,F-DTM,8,1,0,0,1,2,6
20110102-M-Brisbane-R16-Robin_Soderling-Michael_Berrer,1,F-DTL,13,6,1,2,3,8,5
20110102-M-Brisbane-R16-Robin_Soderling-Michael_Berrer,1,F-IO,24,5,2,1,2,13,11
20110102-M-Brisbane-R16-Robin_Soderling-Michael_Berrer,1,F-II,7,2,0,0,2,4,3
20110102-M-Brisbane-R16-Robin_Soderling-Michael_Berrer,1,B-XC,20,5,1,0,4,7,13
20110102-M-Brisbane-R16-Robin_Soderling-Michael_Berrer,1,B-DTM,6,0,0,0,0,2,4
20110102-M-Brisbane-R16-Robin_Soderling-Michael_Berrer,1,B-DTL,26,7,4,0,3,16,10
20110102-M-Brisbane-R16-Robin_Soderling-Michael_Berrer,1,B-IO,6,0,0,0,0,3,3
20110102-M-Brisbane-R16-Robin_Soderling-Michael_Berrer,1,S-DTM,2,1,0,0,1,0,2
20110102-M-Brisbane-R16-Robin_Soderling-Michael_Berrer,1,S-DTL,2,0,0,0,0,0,2
20110102-M-Brisbane-R16-Robin_Soderling-Michael_Berrer,2,F-XC,44,10,1,2,7,27,17
20110102-M-Brisbane-R16-Robin_Soderling-Michael_Berrer,2,F-DTM,6,0,0,0,0,3,3
20110102-M-Brisbane-R16-Robin_Soderling-Michael_Berrer,2,F-DTL,12,6,0,3,3,6,6
20110102-M-Brisbane-R16-Robin_Soderling-Michael_Berrer,2,F-IO,8,1,1,0,0,6,2
20110102-M-Brisbane-R16-Robin_Soderling-Michael_Berrer,2,B-XC,9,5,2,1,2,6,3
20110102-M-Brisbane-R16-Robin_Soderling-Michael_Berrer,2,B-DTM,14,3,0,0,3,4,10
20110102-M-Brisbane-R16-Robin_Soderling-Michael_Berrer,2,B-DTL,10,1,0,0,1,2,8
20110102-M-Brisbane-R16-Robin_Soderling-Michael_Berrer,2,B-IO,3,1,0,0,1,2,1
20110102-M-Brisbane-R16-Robin_Soderling-Michael_Berrer,2,S-XC,15,2,1,0,1,8,7
20110102-M-Brisbane-R16-Robin_Soderling-Michael_Berrer,2,S-DTM,9,1,0,0,1,4,5
20110102-M-Brisbane-R16-Robin_Soderling-Michael_Berrer,2,S-DTL,7,0,0,0,0,3,4
20110102-M-Brisbane-R16-Robin_Soderling-Michael_Berrer,2,S-IO,2,1,0,0,1,0,2
20110102-M-Brisbane-R16-Robin_Soderling-Michael_Berrer,2,S-II,1,0,0,0,0,1,0
20120221-M-Buenos_Aires-R32-Wayne_Odesnik-David_Nalbandian,1,F-XC,44,6,3,1,2,23,21
20120221-M-Buenos_Aires-R32-Wayne_Odesnik-David_Nalbandian,1,F-DTM,36,1,0,0,1,11,25
20120221-M-Buenos_Aires-R32-Wayne_Odesnik-David_Nalbandian,1,F-DTL,6,1,1,0,0,3,3
20120221-M-Buenos_Aires-R32-Wayne_Odesnik-David_Nalbandian,1,F-IO,24,4,0,0,4,9,15
20120221-M-Buenos_Aires-R32-Wayne_Odesnik-David_Nalbandian,1,F-II,1,0,0,0,0,0,1
20120221-M-Buenos_Aires-R32-Wayne_Odesnik-David_Nalbandian,1,B-XC,25,2,0,0,2,10,15
20120221-M-Buenos_Aires-R32-Wayne_Odesnik-David_Nalbandian,1,B-DTM,45,1,0,1,0,18,27
20120221-M-Buenos_Aires-R32-Wayne_Odesnik-David_Nalbandian,1,B-DTL,5,1,0,0,1,3,2
20120221-M-Buenos_Aires-R32-Wayne_Odesnik-David_Nalbandian,1,B-IO,3,0,0,0,0,2,1
20120221-M-Buenos_Aires-R32-Wayne_Odesnik-David_Nalbandian,1,B-II,1,1,0,1,0,1,0
20120221-M-Buenos_Aires-R32-Wayne_Odesnik-David_Nalbandian,1,S-XC,1,1,0,0,1,0,1
20120221-M-Buenos_Aires-R32-Wayne_Odesnik-David_Nalbandian,1,S-DTM,5,1,0,0,1,0,5
20120221-M-Buenos_Aires-R32-Wayne_Odesnik-David_Nalbandian,1,S-DTL,4,1,0,0,1,2,2
20120221-M-Buenos_Aires-R32-Wayne_Odesnik-David_Nalbandian,2,F-XC,69,9,3,2,4,43,26
20120221-M-Buenos_Aires-R32-Wayne_Odesnik-David_Nalbandian,2,F-DTM,28,4,0,0,4,15,13
20120221-M-Buenos_Aires-R32-Wayne_Odesnik-David_Nalbandian,2,F-DTL,5,3,2,0,1,3,2
20120221-M-Buenos_Aires-R32-Wayne_Odesnik-David_Nalbandian,2,F-IO,18,9,5,2,2,13,5
20120221-M-Buenos_Aires-R32-Wayne_Odesnik-David_Nalbandian,2,B-XC,33,6,0,2,4,18,15
20120221-M-Buenos_Aires-R32-Wayne_Odesnik-David_Nalbandian,2,B-DTM,26,4,1,1,2,13,13
20120221-M-Buenos_Aires-R32-Wayne_Odesnik-David_Nalbandian,2,B-DTL,5,0,0,0,0,3,2
20120221-M-Buenos_Aires-R32-Wayne_Odesnik-David_Nalbandian,2,B-IO,8,3,1,1,1,5,3
20120221-M-Buenos_Aires-R32-Wayne_Odesnik-David_Nalbandian,2,S-DTM,2,0,0,0,0,1,1
20120221-M-Buenos_Aires-R32-Wayne_Odesnik-David_Nalbandian,2,S-DTL,1,1,0,1,0,1,0
20120314-M-Indian_Wells_Masters-R16-Roger_Federer-Thomaz_Bellucci,1,F-XC,44,11,2,3,6,22,22
20120314-M-Indian_Wells_Masters-R16-Roger_Federer-Thomaz_Bellucci,1,F-DTM,27,5,0,0,5,11,16
20120314-M-Indian_Wells_Masters-R16-Roger_Federer-Thomaz_Bellucci,1,F-DTL,10,7,3,1,3,6,4
20120314-M-Indian_Wells_Masters-R16-Roger_Federer-Thomaz_Bellucci,1,F-IO,21,10,4,1,5,13,8
20120314-M-Indian_Wells_Masters-R16-Roger_Federer-Thomaz_Bellucci,1,F-II,6,3,1,0,2,3,3
20120314-M-Indian_Wells_Masters-R16-Roger_Federer-Thomaz_Bellucci,1,B-XC,18,9,1,1,7,8,10
20120314-M-Indian_Wells_Masters-R16-Roger_Federer-Thomaz_Bellucci,1,B-DTM,32,5,0,0,5,13,19
20120314-M-Indian_Wells_Masters-R16-Roger_Federer-Thomaz_Bellucci,1,B-DTL,7,1,0,0,1,3,4
20120314-M-Indian_Wells_Masters-R16-Roger_Federer-Thomaz_Bellucci,1,B-IO,3,0,0,0,0,2,1
20120314-M-Indian_Wells_Masters-R16-Roger_Federer-Thomaz_Bellucci,1,S-XC,5,0,0,0,0,1,4
20120314-M-Indian_Wells_Masters-R16-Roger_Federer-Thomaz_Bellucci,1,S-DTM,6,0,0,0,0,2,4
20120314-M-Indian_Wells_Masters-R16-Roger_Federer-Thomaz_Bellucci,1,S-DTL,3,0,0,0,0,0,3
20120314-M-Indian_Wells_Masters-R16-Roger_Federer-Thomaz_Bellucci,2,F-XC,47,4,3,0,1,27,20
20120314-M-Indian_Wells_Masters-R16-Roger_Federer-Thomaz_Bellucci,2,F-DTM,20,2,0,0,2,11,9
20120314-M-Indian_Wells_Masters-R16-Roger_Federer-Thomaz_Bellucci,2,F-DTL,4,3,0,0,3,0,4
20120314-M-Indian_Wells_Masters-R16-Roger_Federer-Thomaz_Bellucci,2,F-IO,15,7,1,1,5,7,8
20120314-M-Indian_Wells_Masters-R16-Roger_Federer-Thomaz_Bellucci,2,F-II,4,0,0,0,0,3,1
20120314-M-Indian_Wells_Masters-R16-Roger_Federer-Thomaz_Bellucci,2,B-XC,31,7,0,1,6,15,16
20120314-M-Indian_Wells_Masters-R16-Roger_Federer-Thomaz_Bellucci,2,B-DTM,42,6,0,0,6,17,25
20120314-M-Indian_Wells_Masters-R16-Roger_Federer-Thomaz_Bellucci,2,B-DTL,4,1,1,0,0,2,2
20120314-M-Indian_Wells_Masters-R16-Roger_Federer-Thomaz_Bellucci,2,B-IO,7,2,0,0,2,5,2
20120314-M-Indian_Wells_Masters-R16-Roger_Federer-Thomaz_Bellucci,2,B-II,1,0,0,0,0,0,1
20120314-M-Indian_Wells_Masters-R16-Roger_Federer-Thomaz_Bellucci,2,S-DTM,5,1,0,0,1,2,3
20120314-M-Indian_Wells_Masters-R16-Roger_Federer-Thomaz_Bellucci,2,S-DTL,4,1,0,0,1,1,3
20120726-M-Olympics-R64-Tomas_Berdych-Steve_Darcis,1,F-XC,34,12,3,6,3,21,13
20120726-M-Olympics-R64-Tomas_Berdych-Steve_Darcis,1,F-DTM,23,1,0,0,1,14,9
20120726-M-Olympics-R64-Tomas_Berdych-Steve_Darcis,1,F-DTL,8,4,1,0,3,3,5
20120726-M-Olympics-R64-Tomas_Berdych-Steve_Darcis,1,F-IO,29,8,1,4,3,15,14
20120726-M-Olympics-R64-Tomas_Berdych-Steve_Darcis,1,F-II,2,1,0,0,1,0,2
20120726-M-Olympics-R64-Tomas_Berdych-Steve_Darcis,1,B-XC,21,1,0,0,1,14,7
20120726-M-Olympics-R64-Tomas_Berdych-Steve_Darcis,1,B-DTM,21,3,0,0,3,10,11
20120726-M-Olympics-R64-Tomas_Berdych-Steve_Darcis,1,B-DTL,8,2,0,1,1,5,3
20120726-M-Olympics-R64-Tomas_Berdych-Steve_Darcis,1,B-IO,1,1,0,0,1,0,1
20120726-M-Olympics-R64-Tomas_Berdych-Steve_Darcis,1,S-XC,6,0,0,0,0,2,4
20120726-M-Olympics-R64-Tomas_Berdych-Steve_Darcis,1,S-DTM,3,0,0,0,0,2,1
20120726-M-Olympics-R64-Tomas_Berdych-Steve_Darcis,1,S-DTL,5,1,0,1,0,4,1
20120726-M-Olympics-R64-Tomas_Berdych-Steve_Darcis,2,F-XC,27,5,3,0,2,12,15
20120726-M-Olympics-R64-Tomas_Berdych-Steve_Darcis,2,F-DTM,16,1,1,0,0,7,9
20120726-M-Olympics-R64-Tomas_Berdych-Steve_Darcis,2,F-DTL,8,3,2,1,0,6,2
20120726-M-Olympics-R64-Tomas_Berdych-Steve_Darcis,2,F-IO,13,4,3,0,1,9,4
20120726-M-Olympics-R64-Tomas_Berdych-Steve_Darcis,2,B-XC,5,0,0,0,0,2,3
20120726-M-Olympics-R64-Tomas_Berdych-Steve_Darcis,2,B-DTM,9,3,0,0,3,1,8
20120726-M-Olympics-R64-Tomas_Berdych-Steve_Darcis,2,B-DTL,3,2,1,0,1,2,1
20120726-M-Olympics-R64-Tomas_Berdych-Steve_Darcis,2,B-IO,1,0,0,0,0,0,1
20120726-M-Olympics-R64-Tomas_Berdych-Steve_Darcis,2,S-XC,30,4,1,1,2,13,17
20120726-M-Olympics-R64-Tomas_Berdych-Steve_Darcis,2,S-DTM,36,4,0,1,3,11,25
20120726-M-Olympics-R64-Tomas_Berdych-Steve_Darcis,2,S-IO,1,0,0,0,0,1,0
20120803-M-Olympics-SF-Andy_Murray-Novak_Djokovic,1,F-XC,46,11,4,4,3,28,18
20120803-M-Olympics-SF-Andy_Murray-Novak_Djokovic,1,F-DTM,36,5,0,1,4,17,19
20120803-M-Olympics-SF-Andy_Murray-Novak_Djokovic,1,F-DTL,16,4,1,2,1,10,6
20120803-M-Olympics-SF-Andy_Murray-Novak_Djokovic,1,F-IO,29,5,3,1,1,17,12
20120803-M-Olympics-SF-Andy_Murray-Novak_Djokovic,1,B-XC,28,6,0,2,4,16,12
20120803-M-Olympics-SF-Andy_Murray-Novak_Djokovic,1,B-DTM,41,3,0,2,1,24,17
20120803-M-Olympics-SF-Andy_Murray-Novak_Djokovic,1,B-DTL,8,1,0,0,1,4,4
20120803-M-Olympics-SF-Andy_Murray-Novak_Djokovic,1,B-IO,6,1,0,1,0,4,2
20120803-M-Olympics-SF-Andy_Murray-Novak_Djokovic,1,S-XC,7,0,0,0,0,6,1
20120803-M-Olympics-SF-Andy_Murray-Novak_Djokovic,1,S-DTM,16,0,0,0,0,8,8
20120803-M-Olympics-SF-Andy_Murray-Novak_Djokovic,1,S-DTL,2,1,0,1,0,1,1
20120803-M-Olympics-SF-Andy_Murray-Novak_Djokovic,1,S-IO,3,0,0,0,0,2,1
20120803-M-Olympics-SF-Andy_Murray-Novak_Djokovic,2,F-XC,41,8,4,2,2,18,23
20120803-M-Olympics-SF-Andy_Murray-Novak_Djokovic,2,F-DTM,43,2,0,1,1,16,27
20120803-M-Olympics-SF-Andy_Murray-Novak_Djokovic,2,F-DTL,15,4,2,0,2,9,6
20120803-M-Olympics-SF-Andy_Murray-Novak_Djokovic,2,F-IO,26,7,2,3,2,18,8
20120803-M-Olympics-SF-Andy_Murray-Novak_Djokovic,2,B-XC,30,5,0,3,2,12,18
20120803-M-Olympics-SF-Andy_Murray-Novak_Djokovic,2,B-DTM,44,2,0,1,1,15,29
20120803-M-Olympics-SF-Andy_Murray-Novak_Djokovic,2,B-DTL,10,3,0,1,2,4,6
20120803-M-Olympics-SF-Andy_Murray-Novak_Djokovic,2,B-IO,10,4,3,0,1,6,4
20120803-M-Olympics-SF-Andy_Murray-Novak_Djokovic,2,S-XC,4,0,0,0,0,0,4
20120803-M-Olympics-SF-Andy_Murray-Novak_Djokovic,2,S-DTM,4,0,0,0,0,3,1
20120803-M-Olympics-SF-Andy_Murray-Novak_Djokovic,2,S-DTL,4,0,0,0,0,0,4
20120731-M-Olympics-R32-Novak_Djokovic-Andy_Roddick,1,F-XC,12,4,2,1,1,8,4
20120731-M-Olympics-R32-Novak_Djokovic-Andy_Roddick,1,F-DTM,9,2,0,0,2,2,7
20120731-M-Olympics-R32-Novak_Djokovic-Andy_Roddick,1,F-DTL,9,3,2,1,0,6,3
20120731-M-Olympics-R32-Novak_Djokovic-Andy_Roddick,1,F-IO,12,4,3,0,1,5,7
20120731-M-Olympics-R32-Novak_Djokovic-Andy_Roddick,1,F-II,2,2,2,0,0,2,0
20120731-M-Olympics-R32-Novak_Djokovic-Andy_Roddick,1,B-XC,8,2,1,1,0,5,3
20120731-M-Olympics-R32-Novak_Djokovic-Andy_Roddick,1,B-DTM,8,1,0,0,1,6,2
20120731-M-Olympics-R32-Novak_Djokovic-Andy_Roddick,1,B-DTL,9,3,2,0,1,6,3
20120731-M-Olympics-R32-Novak_Djokovic-Andy_Roddick,1,B-IO,3,1,0,0,1,1,2
20120731-M-Olympics-R32-Novak_Djokovic-Andy_Roddick,1,S-XC,7,0,0,0,0,2,5
20120731-M-Olympics-R32-Novak_Djokovic-Andy_Roddick,1,S-DTM,1,0,0,0,0,0,1
20120731-M-Olympics-R32-Novak_Djokovic-Andy_Roddick,1,S-DTL,4,1,0,0,1,2,2
20120731-M-Olympics-R32-Novak_Djokovic-Andy_Roddick,2,F-XC,15,4,1,2,1,6,9
20120731-M-Olympics-R32-Novak_Djokovic-Andy_Roddick,2,F-DTM,13,2,0,0,2,5,8
20120731-M-Olympics-R32-Novak_Djokovic-Andy_Roddick,2,F-DTL,4,0,0,0,0,2,2
20120731-M-Olympics-R32-Novak_Djokovic-Andy_Roddick,2,F-IO,15,5,3,1,1,7,8
20120731-M-Olympics-R32-Novak_Djokovic-Andy_Roddick,2,F-II,1,1,1,0,0,1,0
20120731-M-Olympics-R32-Novak_Djokovic-Andy_Roddick,2,B-XC,13,1,1,0,0,6,7
20120731-M-Olympics-R32-Novak_Djokovic-Andy_Roddick,2,B-DTM,6,1,0,0,1,4,2
20120731-M-Olympics-R32-Novak_Djokovic-Andy_Roddick,2,B-DTL,2,1,0,1,0,2,0
20120731-M-Olympics-R32-Novak_Djokovic-Andy_Roddick,2,B-IO,3,1,0,0,1,0,3
20120731-M-Olympics-R32-Novak_Djokovic-Andy_Roddick,2,S-XC,8,1,0,0,1,3,5
20120731-M-Olympics-R32-Novak_Djokovic-Andy_Roddick,2,S-DTM,3,0,0,0,0,3,0
20120731-M-Olympics-R32-Novak_Djokovic-Andy_Roddick,2,S-DTL,4,0,0,0,0,3,1
20120731-M-Olympics-R32-Novak_Djokovic-Andy_Roddick,2,S-IO,2,0,0,0,0,1,1
20121112-M-Tour_Finals-F-Roger_Federer-Novak_Djokovic,1,F-XC,58,19,4,6,9,30,28
20121112-M-Tour_Finals-F-Roger_Federer-Novak_Djokovic,1,F-DTM,51,5,0,2,3,22,29
20121112-M-Tour_Finals-F-Roger_Federer-Novak_Djokovic,1,F-DTL,16,6,0,4,2,10,6
20121112-M-Tour_Finals-F-Roger_Federer-Novak_Djokovic,1,F-IO,48,10,2,4,4,26,22
20121112-M-Tour_Finals-F-Roger_Federer-Novak_Djokovic,1,F-II,4,4,3,0,1,3,1
20121112-M-Tour_Finals-F-Roger_Federer-Novak_Djokovic,1,B-XC,55,2,0,2,0,34,21
20121112-M-Tour_Finals-F-Roger_Federer-Novak_Djokovic,1,B-DTM,36,4,0,0,4,15,21
20121112-M-Tour_Finals-F-Roger_Federer-Novak_Djokovic,1,B-DTL,18,4,2,2,0,12,6
20121112-M-Tour_Finals-F-Roger_Federer-Novak_Djokovic,1,B-IO,2,2,1,0,1,1,1
20121112-M-Tour_Finals-F-Roger_Federer-Novak_Djokovic,1,S-XC,24,2,0,0,2,7,17
20121112-M-Tour_Finals-F-Roger_Federer-Novak_Djokovic,1,S-DTM,9,0,0,0,0,4,5
20121112-M-Tour_Finals-F-Roger_Federer-Novak_Djokovic,1,S-DTL,2,1,0,0,1,0,2
20121112-M-Tour_Finals-F-Roger_Federer-Novak_Djokovic,1,S-IO,1,0,0,0,0,0,1
20121112-M-Tour_Finals-F-Roger_Federer-Novak_Djokovic,2,F-XC,62,15,3,9,3,34,28
20121112-M-Tour_Finals-F-Roger_Federer-Novak_Djokovic,2,F-DTM,37,0,0,0,0,20,17
20121112-M-Tour_Finals-F-Roger_Federer-Novak_Djokovic,2,F-DTL,13,3,1,1,1,6,7
20121112-M-Tour_Finals-F-Roger_Federer-Novak_Djokovic,2,F-IO,24,8,3,2,3,13,11
20121112-M-Tour_Finals-F-Roger_Federer-Novak_Djokovic,2,F-II,2,1,0,1,0,1,1
20121112-M-Tour_Finals-F-Roger_Federer-Novak_Djokovic,2,B-XC,99,11,0,5,6,50,49
20121112-M-Tour_Finals-F-Roger_Federer-Novak_Djokovic,2,B-DTM,56,3,0,0,3,24,32
20121112-M-Tour_Finals-F-Roger_Federer-Novak_Djokovic,2,B-DTL,19,8,1,4,3,8,11
20121112-M-Tour_Finals-F-Roger_Federer-Novak_Djokovic,2,B-IO,15,7,2,3,2,10,5
20121112-M-Tour_Finals-F-Roger_Federer-Novak_Djokovic,2,B-II,1,0,0,0,0,1,0
20121112-M-Tour_Finals-F-Roger_Federer-Novak_Djokovic,2,S-XC,1,0,0,0,0,0,1
20121112-M-Tour_Finals-F-Roger_Federer-Novak_Djokovic,2,S-DTM,3,0,0,0,0,1,2
20121112-M-Tour_Finals-F-Roger_Federer-Novak_Djokovic,2,S-DTL,2,1,0,1,0,2,0
20130225-M-Dubai-R32-Roger_Federer-Malek_Jaziri,1,F-XC,23,11,6,1,4,14,9
20130225-M-Dubai-R32-Roger_Federer-Malek_Jaziri,1,F-DTM,12,0,0,0,0,11,1
20130225-M-Dubai-R32-Roger_Federer-Malek_Jaziri,1,F-DTL,7,3,1,0,2,3,4
20130225-M-Dubai-R32-Roger_Federer-Malek_Jaziri,1,F-IO,15,4,1,1,2,7,8
20130225-M-Dubai-R32-Roger_Federer-Malek_Jaziri,1,F-II,2,1,0,0,1,0,2
20130225-M-Dubai-R32-Roger_Federer-Malek_Jaziri,1,B-XC,9,0,0,0,0,8,1
20130225-M-Dubai-R32-Roger_Federer-Malek_Jaziri,1,B-DTM,12,3,0,1,2,7,5
20130225-M-Dubai-R32-Roger_Federer-Malek_Jaziri,1,S-XC,4,0,0,0,0,1,3
20130225-M-Dubai-R32-Roger_Federer-Malek_Jaziri,1,S-DTM,2,0,0,0,0,1,1
20130225-M-Dubai-R32-Roger_Federer-Malek_Jaziri,1,S-DTL,1,1,1,0,0,1,0
20130225-M-Dubai-R32-Roger_Federer-Malek_Jaziri,2,F-XC,15,8,3,1,4,9,6
20130225-M-Dubai-R32-Roger_Federer-Malek_Jaziri,2,F-DTM,21,4,0,0,4,5,16
20130225-M-Dubai-R32-Roger_Federer-Malek_Jaziri,2,F-DTL,3,3,2,1,0,3,0
20130225-M-Dubai-R32-Roger_Federer-Malek_Jaziri,2,F-IO,18,6,0,2,4,6,12
20130225-M-Dubai-R32-Roger_Federer-Malek_Jaziri,2,F-II,6,4,1,0,3,3,3
20130225-M-Dubai-R32-Roger_Federer-Malek_Jaziri,2,B-XC,7,3,2,1,0,5,2
20130225-M-Dubai-R32-Roger_Federer-Malek_Jaziri,2,B-DTM,9,4,0,0,4,4,5
20130225-M-Dubai-R32-Roger_Federer-Malek_Jaziri,2,B-DTL,2,1,1,0,0,2,0
20130225-M-Dubai-R32-Roger_Federer-Malek_Jaziri,2,B-IO,2,2,1,0,1,1,1
20130225-M-Dubai-R32-Roger_Federer-Malek_Jaziri,2,S-XC,10,2,0,0,2,4,6
20130225-M-Dubai-R32-Roger_Federer-Malek_Jaziri,2,S-DTM,10,1,0,0,1,3,7
20130225-M-Dubai-R32-Roger_Federer-Malek_Jaziri,2,S-DTL,7,1,0,0,1,1,6
20130225-M-Dubai-R32-Roger_Federer-Malek_Jaziri,2,S-IO,2,1,0,0,1,1,1
20130808-M-Canada_Masters-R16-Ernests_Gulbis-Andy_Murray,1,F-XC,27,8,0,3,5,13,14
20130808-M-Canada_Masters-R16-Ernests_Gulbis-Andy_Murray,1,F-DTM,19,2,0,0,2,9,10
20130808-M-Canada_Masters-R16-Ernests_Gulbis-Andy_Murray,1,F-DTL,9,4,3,0,1,3,6
20130808-M-Canada_Masters-R16-Ernests_Gulbis-Andy_Murray,1,F-IO,9,4,2,1,1,6,3
20130808-M-Canada_Masters-R16-Ernests_Gulbis-Andy_Murray,1,B-XC,32,1,0,0,1,19,13
20130808-M-Canada_Masters-R16-Ernests_Gulbis-Andy_Murray,1,B-DTM,21,2,0,1,1,12,9
20130808-M-Canada_Masters-R16-Ernests_Gulbis-Andy_Murray,1,B-DTL,9,4,1,1,2,6,3
20130808-M-Canada_Masters-R16-Ernests_Gulbis-Andy_Murray,1,B-IO,6,2,0,1,1,4,2
20130808-M-Canada_Masters-R16-Ernests_Gulbis-Andy_Murray,1,S-XC,4,0,0,0,0,2,2
20130808-M-Canada_Masters-R16-Ernests_Gulbis-Andy_Murray,1,S-DTM,4,0,0,0,0,2,2
20130808-M-Canada_Masters-R16-Ernests_Gulbis-Andy_Murray,1,S-DTL,1,1,0,1,0,1,0
20130808-M-Canada_Masters-R16-Ernests_Gulbis-Andy_Murray,2,F-XC,34,5,1,2,2,17,17
20130808-M-Canada_Masters-R16-Ernests_Gulbis-Andy_Murray,2,F-DTM,12,1,0,0,1,4,8
20130808-M-Canada_Masters-R16-Ernests_Gulbis-Andy_Murray,2,F-DTL,9,0,0,0,0,3,6
20130808-M-Canada_Masters-R16-Ernests_Gulbis-Andy_Murray,2,F-IO,23,4,1,0,3,8,15
20130808-M-Canada_Masters-R16-Ernests_Gulbis-Andy_Murray,2,F-II,1,0,0,0,0,1,0
20130808-M-Canada_Masters-R16-Ernests_Gulbis-Andy_Murray,2,B-XC,18,2,1,1,0,10,8
20130808-M-Canada_Masters-R16-Ernests_Gulbis-Andy_Murray,2,B-DTM,17,1,0,0,1,9,8
20130808-M-Canada_Masters-R16-Ernests_Gulbis-Andy_Murray,2,B-DTL,4,1,0,1,0,2,2
20130808-M-Canada_Masters-R16-Ernests_Gulbis-Andy_Murray,2,B-IO,7,1,0,0,1,3,4
20130808-M-Canada_Masters-R16-Ernests_Gulbis-Andy_Murray,2,S-XC,2,0,0,0,0,0,2
20130808-M-Canada_Masters-R16-Ernests_Gulbis-Andy_Murray,2,S-DTM,8,0,0,0,0,2,6
20130808-M-Canada_Masters-R16-Ernests_Gulbis-Andy_Murray,2,S-DTL,2,0,0,0,0,0,2
20130808-M-Canada_Masters-R16-Ernests_Gulbis-Andy_Murray,2,S-IO,2,1,0,1,0,2,0
20130112-M-Sydney-F-Bernard_Tomic-Kevin_Anderson,1,F-XC,36,11,6,2,3,23,13
20130112-M-Sydney-F-Bernard_Tomic-Kevin_Anderson,1,F-DTM,24,4,0,0,4,9,15
20130112-M-Sydney-F-Bernard_Tomic-Kevin_Anderson,1,F-DTL,24,9,4,2,3,14,10
20130112-M-Sydney-F-Bernard_Tomic-Kevin_Anderson,1,F-IO,19,8,5,1,2,13,6
20130112-M-Sydney-F-Bernard_Tomic-Kevin_Anderson,1,B-XC,17,2,0,1,1,11,6
20130112-M-Sydney-F-Bernard_Tomic-Kevin_Anderson,1,B-DTM,22,4,0,0,4,9,13
20130112-M-Sydney-F-Bernard_Tomic-Kevin_Anderson,1,B-DTL,14,9,2,3,4,9,5
20130112-M-Sydney-F-Bernard_Tomic-Kevin_Anderson,1,B-IO,3,1,1,0,0,2,1
20130112-M-Sydney-F-Bernard_Tomic-Kevin_Anderson,1,S-XC,32,1,0,0,1,23,9
20130112-M-Sydney-F-Bernard_Tomic-Kevin_Anderson,1,S-DTM,35,3,1,0,2,18,17
20130112-M-Sydney-F-Bernard_Tomic-Kevin_Anderson,1,S-DTL,11,0,0,0,0,9,2
20130112-M-Sydney-F-Bernard_Tomic-Kevin_Anderson,1,S-IO,1,0,0,0,0,0,1
20130112-M-Sydney-F-Bernard_Tomic-Kevin_Anderson,2,F-XC,56,8,2,3,3,30,26
20130112-M-Sydney-F-Bernard_Tomic-Kevin_Anderson,2,F-DTM,14,2,0,0,2,3,11
20130112-M-Sydney-F-Bernard_Tomic-Kevin_Anderson,2,F-DTL,13,3,1,1,1,6,7
20130112-M-Sydney-F-Bernard_Tomic-Kevin_Anderson,2,F-IO,37,11,4,2,5,19,18
20130112-M-Sydney-F-Bernard_Tomic-Kevin_Anderson,2,F-II,5,1,0,1,0,2,3
20130112-M-Sydney-F-Bernard_Tomic-Kevin_Anderson,2,B-XC,32,3,1,0,2,16,16
20130112-M-Sydney-F-Bernard_Tomic-Kevin_Anderson,2,B-DTM,22,2,0,0,2,8,14
20130112-M-Sydney-F-Bernard_Tomic-Kevin_Anderson,2,B-DTL,7,3,2,0,1,4,3
20130112-M-Sydney-F-Bernard_Tomic-Kevin_Anderson,2,B-IO,1,0,0,0,0,1,0
20130112-M-Sydney-F-Bernard_Tomic-Kevin_Anderson,2,B-II,1,1,1,0,0,1,0
20130112-M-Sydney-F-Bernard_Tomic-Kevin_Anderson,2,S-XC,23,1,0,0,1,7,16
20130112-M-Sydney-F-Bernard_Tomic-Kevin_Anderson,2,S-DTM,10,2,0,0,2,2,8
20130112-M-Sydney-F-Bernard_Tomic-Kevin_Anderson,2,S-DTL,2,0,0,0,0,0,2
20130729-M-Washington-R16-Bernard_Tomic-Juan_Martin_Del_Potro,1,F-XC,16,7,3,1,3,6,10
20130729-M-Washington-R16-Bernard_Tomic-Juan_Martin_Del_Potro,1,F-DTM,16,2,0,0,2,4,12
20130729-M-Washington-R16-Bernard_Tomic-Juan_Martin_Del_Potro,1,F-DTL,14,6,0,1,5,3,11
20130729-M-Washington-R16-Bernard_Tomic-Juan_Martin_Del_Potro,1,F-IO,19,3,1,1,1,8,11
20130729-M-Washington-R16-Bernard_Tomic-Juan_Martin_Del_Potro,1,F-II,1,1,1,0,0,1,0
20130729-M-Washington-R16-Bernard_Tomic-Juan_Martin_Del_Potro,1,B-XC,23,7,0,0,7,7,16
20130729-M-Washington-R16-Bernard_Tomic-Juan_Martin_Del_Potro,1,B-DTM,14,1,0,0,1,5,9
20130729-M-Washington-R16-Bernard_Tomic-Juan_Martin_Del_Potro,1,B-DTL,8,6,1,0,5,3,5
20130729-M-Washington-R16-Bernard_Tomic-Juan_Martin_Del_Potro,1,B-IO,9,3,0,0,3,2,7
20130729-M-Washington-R16-Bernard_Tomic-Juan_Martin_Del_Potro,1,S-XC,8,0,0,0,0,3,5
20130729-M-Washington-R16-Bernard_Tomic-Juan_Martin_Del_Potro,1,S-DTM,9,0,0,0,0,3,6
20130729-M-Washington-R16-Bernard_Tomic-Juan_Martin_Del_Potro,1,S-DTL,3,0,0,0,0,1,2
20130729-M-Washington-R16-Bernard_Tomic-Juan_Martin_Del_Potro,1,S-IO,1,0,0,0,0,1,0
20130729-M-Washington-R16-Bernard_Tomic-Juan_Martin_Del_Potro,2,F-XC,37,11,3,3,5,25,12
20130729-M-Washington-R16-Bernard_Tomic-Juan_Martin_Del_Potro,2,F-DTM,15,1,0,0,1,9,6
20130729-M-Washington-R16-Bernard_Tomic-Juan_Martin_Del_Potro,2,F-DTL,4,0,0,0,0,3,1
20130729-M-Washington-R16-Bernard_Tomic-Juan_Martin_Del_Potro,2,F-IO,26,5,1,2,2,14,12
20130729-M-Washington-R16-Bernard_Tomic-Juan_Martin_Del_Potro,2,F-II,2,1,0,1,0,2,0
20130729-M-Washington-R16-Bernard_Tomic-Juan_Martin_Del_Potro,2,B-XC,17,5,0,1,4,12,5
20130729-M-Washington-R16-Bernard_Tomic-Juan_Martin_Del_Potro,2,B-DTM,21,0,0,0,0,15,6
20130729-M-Washington-R16-Bernard_Tomic-Juan_Martin_Del_Potro,2,B-DTL,1,1,1,0,0,1,0
20130729-M-Washington-R16-Bernard_Tomic-Juan_Martin_Del_Potro,2,B-IO,2,1,1,0,0,2,0
20130729-M-Washington-R16-Bernard_Tomic-Juan_Martin_Del_Potro,2,S-XC,10,0,0,0,0,6,4
20130729-M-Washington-R16-Bernard_Tomic-Juan_Martin_Del_Potro,2,S-DTM,2,0,0,0,0,2,0
20140120-M-Australian_Open-R16-Roger_Federer-Jo_Wilfried_Tsonga,1,F-XC,29,11,6,2,3,18,11
20140120-M-Australian_Open-R16-Roger_Federer-Jo_Wilfried_Tsonga,1,F-DTM,27,1,0,1,0,15,12
20140120-M-Australian_Open-R16-Roger_Federer-Jo_Wilfried_Tsonga,1,F-DTL,14,4,1,1,2,8,6
20140120-M-Australian_Open-R16-Roger_Federer-Jo_Wilfried_Tsonga,1,F-IO,32,10,5,3,2,25,7
20140120-M-Australian_Open-R16-Roger_Federer-Jo_Wilfried_Tsonga,1,F-II,4,2,1,0,1,2,2
20140120-M-Australian_Open-R16-Roger_Federer-Jo_Wilfried_Tsonga,1,B-XC,36,4,0,3,1,23,13
20140120-M-Australian_Open-R16-Roger_Federer-Jo_Wilfried_Tsonga,1,B-DTM,22,1,0,0,1,8,14
20140120-M-Australian_Open-R16-Roger_Federer-Jo_Wilfried_Tsonga,1,B-DTL,10,2,0,0,2,7,3
20140120-M-Australian_Open-R16-Roger_Federer-Jo_Wilfried_Tsonga,1,B-IO,1,0,0,0,0,1,0
20140120-M-Australian_Open-R16-Roger_Federer-Jo_Wilfried_Tsonga,1,S-XC,14,0,0,0,0,8,6
20140120-M-Australian_Open-R16-Roger_Federer-Jo_Wilfried_Tsonga,1,S-DTM,4,1,1,0,0,2,2
20140120-M-Australian_Open-R16-Roger_Federer-Jo_Wilfried_Tsonga,1,S-DTL,1,1,1,0,0,1,0
20140120-M-Australian_Open-R16-Roger_Federer-Jo_Wilfried_Tsonga,2,F-XC,37,10,5,0,5,17,20
20140120-M-Australian_Open-R16-Roger_Federer-Jo_Wilfried_Tsonga,2,F-DTM,17,1,0,0,1,8,9
20140120-M-Australian_Open-R16-Roger_Federer-Jo_Wilfried_Tsonga,2,F-DTL,10,5,2,1,2,4,6
20140120-M-Australian_Open-R16-Roger_Federer-Jo_Wilfried_Tsonga,2,F-IO,33,4,3,1,0,19,14
20140120-M-Australian_Open-R16-Roger_Federer-Jo_Wilfried_Tsonga,2,F-II,6,2,1,1,0,5,1
20140120-M-Australian_Open-R16-Roger_Federer-Jo_Wilfried_Tsonga,2,B-XC,47,8,2,2,4,20,27
20140120-M-Australian_Open-R16-Roger_Federer-Jo_Wilfried_Tsonga,2,B-DTM,22,3,1,0,2,10,12
20140120-M-Australian_Open-R16-Roger_Federer-Jo_Wilfried_Tsonga,2,B-DTL,12,5,0,2,3,5,7
20140120-M-Australian_Open-R16-Roger_Federer-Jo_Wilfried_Tsonga,2,B-IO,1,0,0,0,0,0,1
20140120-M-Australian_Open-R16-Roger_Federer-Jo_Wilfried_Tsonga,2,S-XC,11,3,0,1,2,4,7
20140120-M-Australian_Open-R16-Roger_Federer-Jo_Wilfried_Tsonga,2,S-DTM,6,0,0,0,0,1,5
20140120-M-Australian_Open-R16-Roger_Federer-Jo_Wilfried_Tsonga,2,S-DTL,4,0,0,0,0,0,4
20131230-M-Brisbane-R32-Grigor_Dimitrov-Robin_Haase,1,F-XC,18,5,3,1,1,15,3
20131230-M-Brisbane-R32-Grigor_Dimitrov-Robin_Haase,1,F-DTM,12,0,0,0,0,7,5
20131230-M-Brisbane-R32-Grigor_Dimitrov-Robin_Haase,1,F-DTL,4,3,1,1,1,3,1
20131230-M-Brisbane-R32-Grigor_Dimitrov-Robin_Haase,1,F-IO,17,3,2,1,0,16,1
20131230-M-Brisbane-R32-Grigor_Dimitrov-Robin_Haase,1,F-II,1,1,1,0,0,1,0
20131230-M-Brisbane-R32-Grigor_Dimitrov-Robin_Haase,1,B-XC,7,2,1,0,1,5,2
20131230-M-Brisbane-R32-Grigor_Dimitrov-Robin_Haase,1,B-DTM,5,1,0,0,1,2,3
20131230-M-Brisbane-R32-Grigor_Dimitrov-Robin_Haase,1,B-DTL,2,2,1,1,0,2,0
20131230-M-Brisbane-R32-Grigor_Dimitrov-Robin_Haase,1,S-XC,9,0,0,0,0,9,0
20131230-M-Brisbane-R32-Grigor_Dimitrov-Robin_Haase,1,S-DTM,7,0,0,0,0,3,4
20131230-M-Brisbane-R32-Grigor_Dimitrov-Robin_Haase,1,S-DTL,1,0,0,0,0,0,1
20131230-M-Brisbane-R32-Grigor_Dimitrov-Robin_Haase,2,F-XC,16,8,4,2,2,7,9
20131230-M-Brisbane-R32-Grigor_Dimitrov-Robin_Haase,2,F-DTM,8,1,0,0,1,4,4
20131230-M-Brisbane-R32-Grigor_Dimitrov-Robin_Haase,2,F-DTL,8,3,1,0,2,3,5
20131230-M-Brisbane-R32-Grigor_Dimitrov-Robin_Haase,2,F-IO,30,12,5,2,5,13,17
20131230-M-Brisbane-R32-Grigor_Dimitrov-Robin_Haase,2,F-II,2,0,0,0,0,0,2
20131230-M-Brisbane-R32-Grigor_Dimitrov-Robin_Haase,2,B-XC,10,3,0,0,3,1,9
20131230-M-Brisbane-R32-Grigor_Dimitrov-Robin_Haase,2,B-DTM,12,0,0,0,0,1,11
20131230-M-Brisbane-R32-Grigor_Dimitrov-Robin_Haase,2,B-DTL,3,3,1,0,2,1,2
20131230-M-Brisbane-R32-Grigor_Dimitrov-Robin_Haase,2,B-IO,1,0,0,0,0,1,0
20131230-M-Brisbane-R32-Grigor_Dimitrov-Robin_Haase,2,S-XC,2,0,0,0,0,0,2
20131230-M-Brisbane-R32-Grigor_Dimitrov-Robin_Haase,2,S-DTM,2,0,0,0,0,0,2
20131230-M-Brisbane-R32-Grigor_Dimitrov-Robin_Haase,2,S-DTL,1,0,0,0,0,0,1
20140102-M-Brisbane-QF-Roger_Federer-Marinko_Matosevic,1,F-XC,16,8,5,2,1,10,6
20140102-M-Brisbane-QF-Roger_Federer-Marinko_Matosevic,1,F-DTM,21,5,1,1,3,13,8
20140102-M-Brisbane-QF-Roger_Federer-Marinko_Matosevic,1,F-DTL,2,0,0,0,0,2,0
20140102-M-Brisbane-QF-Roger_Federer-Marinko_Matosevic,1,F-IO,7,3,1,1,1,6,1
20140102-M-Brisbane-QF-Roger_Federer-Marinko_Matosevic,1,B-XC,8,1,1,0,0,8,0
20140102-M-Brisbane-QF-Roger_Federer-Marinko_Matosevic,1,B-DTM,13,1,0,0,1,6,7
20140102-M-Brisbane-QF-Roger_Federer-Marinko_Matosevic,1,B-DTL,1,1,0,1,0,1,0
20140102-M-Brisbane-QF-Roger_Federer-Marinko_Matosevic,1,B-IO,1,0,0,0,0,0,1
20140102-M-Brisbane-QF-Roger_Federer-Marinko_Matosevic,1,S-XC,6,0,0,0,0,6,0
20140102-M-Brisbane-QF-Roger_Federer-Marinko_Matosevic,1,S-DTM,5,0,0,0,0,3,2
20140102-M-Brisbane-QF-Roger_Federer-Marinko_Matosevic,2,F-XC,10,2,0,1,1,6,4
20140102-M-Brisbane-QF-Roger_Federer-Marinko_Matosevic,2,F-DTM,14,1,0,0,1,4,10
20140102-M-Brisbane-QF-Roger_Federer-Marinko_Matosevic,2,F-DTL,4,0,0,0,0,2,2
20140102-M-Brisbane-QF-Roger_Federer-Marinko_Matosevic,2,F-IO,7,2,1,0,1,2,5
20140102-M-Brisbane-QF-Roger_Federer-Marinko_Matosevic,2,B-XC,20,9,0,4,5,7,13
20140102-M-Brisbane-QF-Roger_Federer-Marinko_Matosevic,2,B-DTM,21,7,1,1,5,5,16
20140102-M-Brisbane-QF-Roger_Federer-Marinko_Matosevic,2,B-DTL,1,1,0,0,1,0,1
20140102-M-Brisbane-QF-Roger_Federer-Marinko_Matosevic,2,B-IO,5,2,0,1,1,1,4
20140102-M-Brisbane-QF-Roger_Federer-Marinko_Matosevic,2,S-XC,1,1,0,0,1,0,1
20140102-M-Brisbane-QF-Roger_Federer-Marinko_Matosevic,2,S-DTM,4,0,0,0,0,1,3
20140616-M-Eastbourne-R32-Ivo_Karlovic-Jeremy_Chardy,1,F-XC,5,1,0,1,0,4,1
20140616-M-Eastbourne-R32-Ivo_Karlovic-Jeremy_Chardy,1,F-DTM,2,0,0,0,0,0,2
20140616-M-Eastbourne-R32-Ivo_Karlovic-Jeremy_Chardy,1,F-DTL,4,2,0,0,2,2,2
20140616-M-Eastbourne-R32-Ivo_Karlovic-Jeremy_Chardy,1,F-IO,2,0,0,0,0,1,1
20140616-M-Eastbourne-R32-Ivo_Karlovic-Jeremy_Chardy,1,B-DTM,1,0,0,0,0,0,1
20140616-M-Eastbourne-R32-Ivo_Karlovic-Jeremy_Chardy,1,B-DTL,1,1,0,0,1,0,1
20140616-M-Eastbourne-R32-Ivo_Karlovic-Jeremy_Chardy,1,S-XC,5,1,1,0,0,5,0
20140616-M-Eastbourne-R32-Ivo_Karlovic-Jeremy_Chardy,1,S-DTM,5,0,0,0,0,2,3
20140616-M-Eastbourne-R32-Ivo_Karlovic-Jeremy_Chardy,1,S-DTL,3,0,0,0,0,1,2
20140616-M-Eastbourne-R32-Ivo_Karlovic-Jeremy_Chardy,2,F-XC,9,3,0,1,2,5,4
20140616-M-Eastbourne-R32-Ivo_Karlovic-Jeremy_Chardy,2,F-DTM,5,0,0,0,0,3,2
20140616-M-Eastbourne-R32-Ivo_Karlovic-Jeremy_Chardy,2,F-DTL,5,0,0,0,0,2,3
20140616-M-Eastbourne-R32-Ivo_Karlovic-Jeremy_Chardy,2,F-IO,10,5,2,1,2,7,3
20140616-M-Eastbourne-R32-Ivo_Karlovic-Jeremy_Chardy,2,F-II,6,2,1,1,0,3,3
20140616-M-Eastbourne-R32-Ivo_Karlovic-Jeremy_Chardy,2,B-XC,1,0,0,0,0,0,1
20140616-M-Eastbourne-R32-Ivo_Karlovic-Jeremy_Chardy,2,B-DTL,1,0,0,0,0,0,1
20140616-M-Eastbourne-R32-Ivo_Karlovic-Jeremy_Chardy,2,B-IO,1,1,0,1,0,1,0
20140616-M-Eastbourne-R32-Ivo_Karlovic-Jeremy_Chardy,2,S-XC,4,1,0,0,1,1,3
20140616-M-Eastbourne-R32-Ivo_Karlovic-Jeremy_Chardy,2,S-DTM,2,0,0,0,0,1,1
20140616-M-Eastbourne-R32-Ivo_Karlovic-Jeremy_Chardy,2,S-IO,1,1,0,1,0,1,0
20141101-M-Paris_Masters-F-Novak_Djokovic-Milos_Raonic,1,F-XC,29,5,3,1,1,16,13
20141101-M-Paris_Masters-F-Novak_Djokovic-Milos_Raonic,1,F-DTM,12,0,0,0,0,10,2
20141101-M-Paris_Masters-F-Novak_Djokovic-Milos_Raonic,1,F-DTL,4,2,1,1,0,3,1
20141101-M-Paris_Masters-F-Novak_Djokovic-Milos_Raonic,1,F-IO,14,4,1,2,1,11,3
20141101-M-Paris_Masters-F-Novak_Djokovic-Milos_Raonic,1,F-II,2,0,0,0,0,1,1
20141101-M-Paris_Masters-F-Novak_Djokovic-Milos_Raonic,1,B-XC,46,7,1,0,6,24,22
20141101-M-Paris_Masters-F-Novak_Djokovic-Milos_Raonic,1,B-DTM,26,2,0,1,1,15,11
20141101-M-Paris_Masters-F-Novak_Djokovic-Milos_Raonic,1,B-DTL,4,2,1,1,0,3,1
20141101-M-Paris_Masters-F-Novak_Djokovic-Milos_Raonic,1,B-IO,4,0,0,0,0,3,1
20141101-M-Paris_Masters-F-Novak_Djokovic-Milos_Raonic,1,S-XC,3,0,0,0,0,2,1
20141101-M-Paris_Masters-F-Novak_Djokovic-Milos_Raonic,1,S-DTM,4,0,0,0,0,3,1
20141101-M-Paris_Masters-F-Novak_Djokovic-Milos_Raonic,1,S-DTL,2,0,0,0,0,1,1
20141101-M-Paris_Masters-F-Novak_Djokovic-Milos_Raonic,2,F-XC,24,7,3,0,4,13,11
20141101-M-Paris_Masters-F-Novak_Djokovic-Milos_Raonic,2,F-DTM,31,2,0,0,2,10,21
20141101-M-Paris_Masters-F-Novak_Djokovic-Milos_Raonic,2,F-DTL,6,2,1,0,1,3,3
20141101-M-Paris_Masters-F-Novak_Djokovic-Milos_Raonic,2,F-IO,46,11,1,0,10,12,34
20141101-M-Paris_Masters-F-Novak_Djokovic-Milos_Raonic,2,F-II,2,1,0,0,1,0,2
20141101-M-Paris_Masters-F-Novak_Djokovic-Milos_Raonic,2,B-XC,14,5,1,1,3,7,7
20141101-M-Paris_Masters-F-Novak_Djokovic-Milos_Raonic,2,B-DTM,15,2,0,0,2,4,11
20141101-M-Paris_Masters-F-Novak_Djokovic-Milos_Raonic,2,B-DTL,1,1,1,0,0,1,0
20141101-M-Paris_Masters-F-Novak_Djokovic-Milos_Raonic,2,S-XC,8,0,0,0,0,5,3
20141101-M-Paris_Masters-F-Novak_Djokovic-Milos_Raonic,2,S-DTM,4,0,0,0,0,1,3
20141101-M-Paris_Masters-F-Novak_Djokovic-Milos_Raonic,2,S-DTL,1,0,0,0,0,1,0
20140614-M-Queens_Club-SF-Stanislas_Wawrinka-Grigor_Dimitrov,1,F-XC,24,9,3,2,4,15,9
20140614-M-Queens_Club-SF-Stanislas_Wawrinka-Grigor_Dimitrov,1,F-DTM,8,0,0,0,0,3,5
20140614-M-Queens_Club-SF-Stanislas_Wawrinka-Grigor_Dimitrov,1,F-DTL,4,0,0,0,0,2,2
20140614-M-Queens_Club-SF-Stanislas_Wawrinka-Grigor_Dimitrov,1,F-IO,13,6,1,2,3,5,8
20140614-M-Queens_Club-SF-Stanislas_Wawrinka-Grigor_Dimitrov,1,F-II,1,0,0,0,0,1,0
20140614-M-Queens_Club-SF-Stanislas_Wawrinka-Grigor_Dimitrov,1,B-XC,22,4,2,0,2,11,11
20140614-M-Queens_Club-SF-Stanislas_Wawrinka-Grigor_Dimitrov,1,B-DTM,3,0,0,0,0,3,0
20140614-M-Queens_Club-SF-Stanislas_Wawrinka-Grigor_Dimitrov,1,B-DTL,7,3,1,0,2,3,4
20140614-M-Queens_Club-SF-Stanislas_Wawrinka-Grigor_Dimitrov,1,B-IO,1,0,0,0,0,1,0
20140614-M-Queens_Club-SF-Stanislas_Wawrinka-Grigor_Dimitrov,1,S-XC,6,1,0,0,1,5,1
20140614-M-Queens_Club-SF-Stanislas_Wawrinka-Grigor_Dimitrov,1,S-DTM,2,0,0,0,0,0,2
20140614-M-Queens_Club-SF-Stanislas_Wawrinka-Grigor_Dimitrov,2,F-XC,19,7,1,3,3,10,9
20140614-M-Queens_Club-SF-Stanislas_Wawrinka-Grigor_Dimitrov,2,F-DTM,10,1,0,1,0,3,7
20140614-M-Queens_Club-SF-Stanislas_Wawrinka-Grigor_Dimitrov,2,F-DTL,7,1,1,0,0,3,4
20140614-M-Queens_Club-SF-Stanislas_Wawrinka-Grigor_Dimitrov,2,F-IO,10,6,3,2,1,8,2
20140614-M-Queens_Club-SF-Stanislas_Wawrinka-Grigor_Dimitrov,2,F-II,2,0,0,0,0,1,1
20140614-M-Queens_Club-SF-Stanislas_Wawrinka-Grigor_Dimitrov,2,B-XC,10,3,0,2,1,7,3
20140614-M-Queens_Club-SF-Stanislas_Wawrinka-Grigor_Dimitrov,2,B-DTM,10,2,0,0,2,3,7
20140614-M-Queens_Club-SF-Stanislas_Wawrinka-Grigor_Dimitrov,2,B-DTL,6,2,2,0,0,4,2
20140614-M-Queens_Club-SF-Stanislas_Wawrinka-Grigor_Dimitrov,2,S-XC,8,1,0,1,0,4,4
20140614-M-Queens_Club-SF-Stanislas_Wawrinka-Grigor_Dimitrov,2,S-DTM,7,1,0,0,1,3,4
20140614-M-Queens_Club-SF-Stanislas_Wawrinka-Grigor_Dimitrov,2,S-DTL,1,1,0,1,0,1,0
20140927-M-Shenzhen-SF-Tommy_Robredo-Santiago_Giraldo,1,F-XC,18,7,1,3,3,9,9
20140927-M-Shenzhen-SF-Tommy_Robredo-Santiago_Giraldo,1,F-DTM,8,2,0,0,2,2,6
20140927-M-Shenzhen-SF-Tommy_Robredo-Santiago_Giraldo,1,F-DTL,3,3,1,1,1,2,1
20140927-M-Shenzhen-SF-Tommy_Robredo-Santiago_Giraldo,1,F-IO,21,3,1,1,1,10,11
20140927-M-Shenzhen-SF-Tommy_Robredo-Santiago_Giraldo,1,F-II,2,1,1,0,0,1,1
20140927-M-Shenzhen-SF-Tommy_Robredo-Santiago_Giraldo,1,B-XC,8,1,0,0,1,3,5
20140927-M-Shenzhen-SF-Tommy_Robredo-Santiago_Giraldo,1,B-DTM,5,1,0,0,1,1,4
20140927-M-Shenzhen-SF-Tommy_Robredo-Santiago_Giraldo,1,S-XC,11,0,0,0,0,6,5
20140927-M-Shenzhen-SF-Tommy_Robredo-Santiago_Giraldo,1,S-DTM,8,1,0,0,1,1,7
20140927-M-Shenzhen-SF-Tommy_Robredo-Santiago_Giraldo,2,F-XC,20,6,0,2,4,11,9
20140927-M-Shenzhen-SF-Tommy_Robredo-Santiago_Giraldo,2,F-DTM,12,3,0,0,3,4,8
20140927-M-Shenzhen-SF-Tommy_Robredo-Santiago_Giraldo,2,F-DTL,7,2,0,1,1,4,3
20140927-M-Shenzhen-SF-Tommy_Robredo-Santiago_Giraldo,2,F-IO,18,5,1,1,3,11,7
20140927-M-Shenzhen-SF-Tommy_Robredo-Santiago_Giraldo,2,F-II,6,4,0,2,2,4,2
20140927-M-Shenzhen-SF-Tommy_Robredo-Santiago_Giraldo,2,B-XC,14,2,0,0,2,9,5
20140927-M-Shenzhen-SF-Tommy_Robredo-Santiago_Giraldo,2,B-DTM,12,4,0,0,4,4,8
20140927-M-Shenzhen-SF-Tommy_Robredo-Santiago_Giraldo,2,B-DTL,6,3,2,0,1,5,1
20140927-M-Shenzhen-SF-Tommy_Robredo-Santiago_Giraldo,2,B-IO,1,1,0,0,1,0,1
20140927-M-Shenzhen-SF-Tommy_Robredo-Santiago_Giraldo,2,S-XC,1,0,0,0,0,0,1
20140927-M-Shenzhen-SF-Tommy_Robredo-Santiago_Giraldo,2,S-DTM,2,1,0,0,1,1,1
20140906-M-St_Remy_CH-QF-Vincent_Millot-Denys_Molchanov,1,F-XC,76,11,2,6,3,36,40
20140906-M-St_Remy_CH-QF-Vincent_Millot-Denys_Molchanov,1,F-DTM,22,3,0,0,3,11,11
20140906-M-St_Remy_CH-QF-Vincent_Millot-Denys_Molchanov,1,F-DTL,22,8,1,2,5,9,13
20140906-M-St_Remy_CH-QF-Vincent_Millot-Denys_Molchanov,1,F-IO,21,8,0,4,4,13,8
20140906-M-St_Remy_CH-QF-Vincent_Millot-Denys_Molchanov,1,F-II,2,0,0,0,0,2,0
20140906-M-St_Remy_CH-QF-Vincent_Millot-Denys_Molchanov,1,B-XC,50,14,4,3,7,27,23
20140906-M-St_Remy_CH-QF-Vincent_Millot-Denys_Molchanov,1,B-DTM,32,3,0,1,2,19,13
20140906-M-St_Remy_CH-QF-Vincent_Millot-Denys_Molchanov,1,B-DTL,10,5,1,1,3,6,4
20140906-M-St_Remy_CH-QF-Vincent_Millot-Denys_Molchanov,1,B-IO,7,5,1,3,1,5,2
20140906-M-St_Remy_CH-QF-Vincent_Millot-Denys_Molchanov,1,S-IO,1,0,0,0,0,1,0
20140906-M-St_Remy_CH-QF-Vincent_Millot-Denys_Molchanov,2,F-XC,39,3,0,2,1,14,25
20140906-M-St_Remy_CH-QF-Vincent_Millot-Denys_Molchanov,2,F-DTM,23,3,1,0,2,11,12
20140906-M-St_Remy_CH-QF-Vincent_Millot-Denys_Molchanov,2,F-DTL,12,6,1,1,4,5,7
20140906-M-St_Remy_CH-QF-Vincent_Millot-Denys_Molchanov,2,F-IO,39,11,3,4,4,21,18
20140906-M-St_Remy_CH-QF-Vincent_Millot-Denys_Molchanov,2,F-II,2,2,1,0,1,1,1
20140906-M-St_Remy_CH-QF-Vincent_Millot-Denys_Molchanov,2,B-DTM,2,0,0,0,0,0,2
20140906-M-St_Remy_CH-QF-Vincent_Millot-Denys_Molchanov,2,B-IO,1,1,0,0,1,0,1
20140906-M-St_Remy_CH-QF-Vincent_Millot-Denys_Molchanov,2,B-II,1,1,0,0,1,0,1
20140906-M-St_Remy_CH-QF-Vincent_Millot-Denys_Molchanov,2,S-XC,36,2,0,0,2,18,18
20140906-M-St_Remy_CH-QF-Vincent_Millot-Denys_Molchanov,2,S-DTM,33,2,0,0,2,14,19
20140906-M-St_Remy_CH-QF-Vincent_Millot-Denys_Molchanov,2,S-DTL,12,4,0,2,2,7,5
20140906-M-St_Remy_CH-QF-Vincent_Millot-Denys_Molchanov,2,S-IO,12,0,0,0,0,5,7
20140727-M-Umag-SF-Marin_Cilic-Tommy_Robredo,1,F-XC,46,17,6,2,9,23,23
20140727-M-Umag-SF-Marin_Cilic-Tommy_Robredo,1,F-DTM,23,0,0,0,0,5,18
20140727-M-Umag-SF-Marin_Cilic-Tommy_Robredo,1,F-DTL,14,2,0,0,2,3,11
20140727-M-Umag-SF-Marin_Cilic-Tommy_Robredo,1,F-IO,36,10,5,0,5,17,19
20140727-M-Umag-SF-Marin_Cilic-Tommy_Robredo,1,F-II,4,2,0,1,1,2,2
20140727-M-Umag-SF-Marin_Cilic-Tommy_Robredo,1,B-XC,31,7,0,0,7,10,21
20140727-M-Umag-SF-Marin_Cilic-Tommy_Robredo,1,B-DTM,15,2,1,0,1,6,9
20140727-M-Umag-SF-Marin_Cilic-Tommy_Robredo,1,B-DTL,8,3,1,0,2,2,6
20140727-M-Umag-SF-Marin_Cilic-Tommy_Robredo,1,S-XC,2,0,0,0,0,2,0
20140727-M-Umag-SF-Marin_Cilic-Tommy_Robredo,1,S-DTM,4,0,0,0,0,2,2
20140727-M-Umag-SF-Marin_Cilic-Tommy_Robredo,1,S-DTL,1,0,0,0,0,1,0
20140727-M-Umag-SF-Marin_Cilic-Tommy_Robredo,2,F-XC,43,12,4,6,2,28,15
20140727-M-Umag-SF-Marin_Cilic-Tommy_Robredo,2,F-DTM,13,0,0,0,0,9,4
20140727-M-Umag-SF-Marin_Cilic-Tommy_Robredo,2,F-DTL,14,3,0,1,2,5,9
20140727-M-Umag-SF-Marin_Cilic-Tommy_Robredo,2,F-IO,30,5,3,0,2,22,8
20140727-M-Umag-SF-Marin_Cilic-Tommy_Robredo,2,F-II,11,3,1,1,1,8,3
20140727-M-Umag-SF-Marin_Cilic-Tommy_Robredo,2,B-XC,16,2,0,1,1,10,6
20140727-M-Umag-SF-Marin_Cilic-Tommy_Robredo,2,B-DTM,23,2,0,0,2,13,10
20140727-M-Umag-SF-Marin_Cilic-Tommy_Robredo,2,B-DTL,14,4,1,1,2,10,4
20140727-M-Umag-SF-Marin_Cilic-Tommy_Robredo,2,B-IO,2,1,1,0,0,1,1
20140727-M-Umag-SF-Marin_Cilic-Tommy_Robredo,2,S-XC,15,3,0,0,3,6,9
20140727-M-Umag-SF-Marin_Cilic-Tommy_Robredo,2,S-DTM,7,0,0,0,0,3,4
20140727-M-Umag-SF-Marin_Cilic-Tommy_Robredo,2,S-DTL,1,0,0,0,0,1,0
20141109-M-London-RR-Roger_Federer-Milos_Raonic,1,F-XC,18,7,4,1,2,11,7
20141109-M-London-RR-Roger_Federer-Milos_Raonic,1,F-DTM,10,0,0,0,0,4,6
20141109-M-London-RR-Roger_Federer-Milos_Raonic,1,F-DTL,4,0,0,0,0,1,3
20141109-M-London-RR-Roger_Federer-Milos_Raonic,1,F-IO,12,8,5,1,2,10,2
20141109-M-London-RR-Roger_Federer-Milos_Raonic,1,F-II,1,1,0,1,0,1,0
20141109-M-London-RR-Roger_Federer-Milos_Raonic,1,B-XC,31,7,2,1,4,19,12
20141109-M-London-RR-Roger_Federer-Milos_Raonic,1,B-DTM,16,1,0,1,0,11,5
20141109-M-London-RR-Roger_Federer-Milos_Raonic,1,B-DTL,4,3,1,1,1,2,2
20141109-M-London-RR-Roger_Federer-Milos_Raonic,1,S-XC,10,1,0,0,1,5,5
20141109-M-London-RR-Roger_Federer-Milos_Raonic,1,S-DTM,4,1,0,0,1,2,2
20141109-M-London-RR-Roger_Federer-Milos_Raonic,2,F-XC,15,5,5,0,0,14,1
20141109-M-London-RR-Roger_Federer-Milos_Raonic,2,F-DTM,7,2,0,1,1,3,4
20141109-M-London-RR-Roger_Federer-Milos_Raonic,2,F-DTL,6,1,0,0,1,3,3
20141109-M-London-RR-Roger_Federer-Milos_Raonic,2,F-IO,55,18,4,4,10,22,33
20141109-M-London-RR-Roger_Federer-Milos_Raonic,2,F-II,8,4,1,1,2,4,4
20141109-M-London-RR-Roger_Federer-Milos_Raonic,2,B-XC,9,2,0,0,2,2,7
20141109-M-London-RR-Roger_Federer-Milos_Raonic,2,B-DTM,6,0,0,0,0,3,3
20141109-M-London-RR-Roger_Federer-Milos_Raonic,2,B-DTL,5,3,1,0,2,2,3
20141109-M-London-RR-Roger_Federer-Milos_Raonic,2,B-IO,1,1,1,0,0,1,0
20141109-M-London-RR-Roger_Federer-Milos_Raonic,2,S-XC,4,1,0,0,1,1,3
20141109-M-London-RR-Roger_Federer-Milos_Raonic,2,S-DTM,2,1,0,1,0,1,1
20150127-M-Australian_Open-QF-Tomas_Berdych-Rafael_Nadal,1,F-XC,41,20,13,4,3,27,14
20150127-M-Australian_Open-QF-Tomas_Berdych-Rafael_Nadal,1,F-DTM,20,1,0,0,1,7,13
20150127-M-Australian_Open-QF-Tomas_Berdych-Rafael_Nadal,1,F-DTL,37,4,1,1,2,20,17
20150127-M-Australian_Open-QF-Tomas_Berdych-Rafael_Nadal,1,F-IO,40,12,4,2,6,21,19
20150127-M-Australian_Open-QF-Tomas_Berdych-Rafael_Nadal,1,F-II,9,4,4,0,0,4,5
20150127-M-Australian_Open-QF-Tomas_Berdych-Rafael_Nadal,1,B-XC,10,0,0,0,0,6,4
20150127-M-Australian_Open-QF-Tomas_Berdych-Rafael_Nadal,1,B-DTM,23,3,0,0,3,9,14
20150127-M-Australian_Open-QF-Tomas_Berdych-Rafael_Nadal,1,B-DTL,34,6,1,2,3,20,14
20150127-M-Australian_Open-QF-Tomas_Berdych-Rafael_Nadal,1,B-IO,9,3,2,1,0,6,3
20150127-M-Australian_Open-QF-Tomas_Berdych-Rafael_Nadal,1,S-DTM,3,0,0,0,0,1,2
20150127-M-Australian_Open-QF-Tomas_Berdych-Rafael_Nadal,1,S-IO,1,0,0,0,0,1,0
20150127-M-Australian_Open-QF-Tomas_Berdych-Rafael_Nadal,2,F-XC,25,5,3,2,0,16,9
20150127-M-Australian_Open-QF-Tomas_Berdych-Rafael_Nadal,2,F-DTM,23,3,0,0,3,9,14
20150127-M-Australian_Open-QF-Tomas_Berdych-Rafael_Nadal,2,F-DTL,2,1,1,0,0,2,0
20150127-M-Australian_Open-QF-Tomas_Berdych-Rafael_Nadal,2,F-IO,51,20,6,8,6,31,20
20150127-M-Australian_Open-QF-Tomas_Berdych-Rafael_Nadal,2,F-II,24,2,1,0,1,11,13
20150127-M-Australian_Open-QF-Tomas_Berdych-Rafael_Nadal,2,B-XC,5,2,0,0,2,3,2
20150127-M-Australian_Open-QF-Tomas_Berdych-Rafael_Nadal,2,B-DTM,21,2,0,1,1,8,13
20150127-M-Australian_Open-QF-Tomas_Berdych-Rafael_Nadal,2,B-DTL,1,0,0,0,0,0,1
20150127-M-Australian_Open-QF-Tomas_Berdych-Rafael_Nadal,2,B-IO,15,5,1,2,2,9,6
20150127-M-Australian_Open-QF-Tomas_Berdych-Rafael_Nadal,2,B-II,26,5,0,2,3,12,14
20150127-M-Australian_Open-QF-Tomas_Berdych-Rafael_Nadal,2,S-DTM,11,0,0,0,0,1,10
20150127-M-Australian_Open-QF-Tomas_Berdych-Rafael_Nadal,2,S-IO,11,0,0,0,0,4,7
20150127-M-Australian_Open-QF-Tomas_Berdych-Rafael_Nadal,2,S-II,2,0,0,0,0,2,0
20150125-M-Australian_Open-R16-Bernard_Tomic-Tomas_Berdych,1,F-XC,60,15,5,3,7,28,32
20150125-M-Australian_Open-R16-Bernard_Tomic-Tomas_Berdych,1,F-DTM,46,6,1,0,5,16,30
20150125-M-Australian_Open-R16-Bernard_Tomic-Tomas_Berdych,1,F-DTL,24,9,2,2,5,10,14
20150125-M-Australian_Open-R16-Bernard_Tomic-Tomas_Berdych,1,F-IO,23,5,2,2,1,13,10
20150125-M-Australian_Open-R16-Bernard_Tomic-Tomas_Berdych,1,F-II,2,0,0,0,0,1,1
20150125-M-Australian_Open-R16-Bernard_Tomic-Tomas_Berdych,1,B-XC,29,3,2,1,0,14,15
20150125-M-Australian_Open-R16-Bernard_Tomic-Tomas_Berdych,1,B-DTM,27,4,0,0,4,9,18
20150125-M-Australian_Open-R16-Bernard_Tomic-Tomas_Berdych,1,B-DTL,11,4,1,0,3,7,4
20150125-M-Australian_Open-R16-Bernard_Tomic-Tomas_Berdych,1,B-IO,11,1,0,1,0,7,4
20150125-M-Australian_Open-R16-Bernard_Tomic-Tomas_Berdych,1,S-XC,13,0,0,0,0,6,7
20150125-M-Australian_Open-R16-Bernard_Tomic-Tomas_Berdych,1,S-DTM,20,1,0,0,1,7,13
20150125-M-Australian_Open-R16-Bernard_Tomic-Tomas_Berdych,1,S-DTL,8,1,1,0,0,4,4
20150125-M-Australian_Open-R16-Bernard_Tomic-Tomas_Berdych,1,S-IO,2,0,0,0,0,2,0
20150125-M-Australian_Open-R16-Bernard_Tomic-Tomas_Berdych,1,S-II,1,0,0,0,0,0,1
20150125-M-Australian_Open-R16-Bernard_Tomic-Tomas_Berdych,2,F-XC,74,18,8,2,8,44,30
20150125-M-Australian_Open-R16-Bernard_Tomic-Tomas_Berdych,2,F-DTM,29,5,0,0,5,8,21
20150125-M-Australian_Open-R16-Bernard_Tomic-Tomas_Berdych,2,F-DTL,16,2,0,1,1,11,5
20150125-M-Australian_Open-R16-Bernard_Tomic-Tomas_Berdych,2,F-IO,37,16,11,2,3,26,11
20150125-M-Australian_Open-R16-Bernard_Tomic-Tomas_Berdych,2,F-II,4,2,1,0,1,3,1
20150125-M-Australian_Open-R16-Bernard_Tomic-Tomas_Berdych,2,B-XC,39,6,3,0,3,21,18
20150125-M-Australian_Open-R16-Bernard_Tomic-Tomas_Berdych,2,B-DTM,20,2,0,0,2,11,9
20150125-M-Australian_Open-R16-Bernard_Tomic-Tomas_Berdych,2,B-DTL,13,2,1,0,1,9,4
20150125-M-Australian_Open-R16-Bernard_Tomic-Tomas_Berdych,2,B-IO,6,1,0,0,1,4,2
20150125-M-Australian_Open-R16-Bernard_Tomic-Tomas_Berdych,2,S-XC,9,0,0,0,0,4,5
20150125-M-Australian_Open-R16-Bernard_Tomic-Tomas_Berdych,2,S-DTM,7,0,0,0,0,3,4
20150125-M-Australian_Open-R16-Bernard_Tomic-Tomas_Berdych,2,S-DTL,5,1,0,0,1,4,1
20150116-M-Auckland-SF-Kevin_Anderson-Jiri_Vesely,1,F-XC,34,4,1,0,3,20,14
20150116-M-Auckland-SF-Kevin_Anderson-Jiri_Vesely,1,F-DTM,17,2,0,0,2,10,7
20150116-M-Auckland-SF-Kevin_Anderson-Jiri_Vesely,1,F-DTL,11,5,3,1,1,7,4
20150116-M-Auckland-SF-Kevin_Anderson-Jiri_Vesely,1,F-IO,19,5,3,0,2,8,11
20150116-M-Auckland-SF-Kevin_Anderson-Jiri_Vesely,1,F-II,1,0,0,0,0,1,0
20150116-M-Auckland-SF-Kevin_Anderson-Jiri_Vesely,1,B-XC,16,8,2,2,4,7,9
20150116-M-Auckland-SF-Kevin_Anderson-Jiri_Vesely,1,B-DTM,22,1,0,0,1,12,10
20150116-M-Auckland-SF-Kevin_Anderson-Jiri_Vesely,1,B-DTL,3,2,1,0,1,2,1
20150116-M-Auckland-SF-Kevin_Anderson-Jiri_Vesely,1,B-IO,10,5,1,0,4,4,6
20150116-M-Auckland-SF-Kevin_Anderson-Jiri_Vesely,1,S-XC,1,0,0,0,0,1,0
20150116-M-Auckland-SF-Kevin_Anderson-Jiri_Vesely,1,S-DTM,5,0,0,0,0,5,0
20150116-M-Auckland-SF-Kevin_Anderson-Jiri_Vesely,1,S-DTL,2,0,0,0,0,1,1
20150116-M-Auckland-SF-Kevin_Anderson-Jiri_Vesely,2,F-XC,30,7,0,2,5,10,20
20150116-M-Auckland-SF-Kevin_Anderson-Jiri_Vesely,2,F-DTM,20,4,0,1,3,12,8
20150116-M-Auckland-SF-Kevin_Anderson-Jiri_Vesely,2,F-IO,10,6,1,2,3,5,5
20150116-M-Auckland-SF-Kevin_Anderson-Jiri_Vesely,2,F-II,1,0,0,0,0,1,0
20150116-M-Auckland-SF-Kevin_Anderson-Jiri_Vesely,2,B-XC,21,0,0,0,0,7,14
20150116-M-Auckland-SF-Kevin_Anderson-Jiri_Vesely,2,B-DTM,21,2,0,0,2,8,13
20150116-M-Auckland-SF-Kevin_Anderson-Jiri_Vesely,2,B-DTL,7,3,1,1,1,5,2
20150116-M-Auckland-SF-Kevin_Anderson-Jiri_Vesely,2,B-IO,7,2,0,0,2,2,5
20150116-M-Auckland-SF-Kevin_Anderson-Jiri_Vesely,2,S-DTM,3,0,0,0,0,1,2
20150116-M-Auckland-SF-Kevin_Anderson-Jiri_Vesely,2,S-DTL,1,0,0,0,0,0,1
20150109-M-Brisbane-QF-Bernard_Tomic-Kei_Nishikori,1,F-XC,21,12,3,3,6,11,10
20150109-M-Brisbane-QF-Bernard_Tomic-Kei_Nishikori,1,F-DTM,5,1,0,0,1,0,5
20150109-M-Brisbane-QF-Bernard_Tomic-Kei_Nishikori,1,F-DTL,2,0,0,0,0,2,0
20150109-M-Brisbane-QF-Bernard_Tomic-Kei_Nishikori,1,F-IO,15,4,2,1,1,7,8
20150109-M-Brisbane-QF-Bernard_Tomic-Kei_Nishikori,1,F-II,1,1,1,0,0,1,0
20150109-M-Brisbane-QF-Bernard_Tomic-Kei_Nishikori,1,B-XC,17,3,0,0,3,4,13
20150109-M-Brisbane-QF-Bernard_Tomic-Kei_Nishikori,1,B-DTM,12,2,0,0,2,3,9
20150109-M-Brisbane-QF-Bernard_Tomic-Kei_Nishikori,1,B-DTL,3,3,0,0,3,0,3
20150109-M-Brisbane-QF-Bernard_Tomic-Kei_Nishikori,1,B-IO,1,0,0,0,0,1,0
20150109-M-Brisbane-QF-Bernard_Tomic-Kei_Nishikori,1,S-XC,16,1,0,0,1,5,11
20150109-M-Brisbane-QF-Bernard_Tomic-Kei_Nishikori,1,S-DTM,12,2,0,0,2,2,10
20150109-M-Brisbane-QF-Bernard_Tomic-Kei_Nishikori,1,S-DTL,1,0,0,0,0,1,0
20150109-M-Brisbane-QF-Bernard_Tomic-Kei_Nishikori,2,F-XC,13,4,3,0,1,8,5
20150109-M-Brisbane-QF-Bernard_Tomic-Kei_Nishikori,2,F-DTM,3,1,0,0,1,1,2
20150109-M-Brisbane-QF-Bernard_Tomic-Kei_Nishikori,2,F-DTL,7,3,2,0,1,5,2
20150109-M-Brisbane-QF-Bernard_Tomic-Kei_Nishikori,2,F-IO,13,4,3,0,1,11,2
20150109-M-Brisbane-QF-Bernard_Tomic-Kei_Nishikori,2,F-II,3,2,0,1,1,1,2
20150109-M-Brisbane-QF-Bernard_Tomic-Kei_Nishikori,2,B-XC,35,7,3,1,3,24,11
20150109-M-Brisbane-QF-Bernard_Tomic-Kei_Nishikori,2,B-DTM,9,2,0,0,2,5,4
20150109-M-Brisbane-QF-Bernard_Tomic-Kei_Nishikori,2,B-DTL,4,3,2,1,0,4,0
20150109-M-Brisbane-QF-Bernard_Tomic-Kei_Nishikori,2,B-IO,1,0,0,0,0,1,0
20150109-M-Brisbane-QF-Bernard_Tomic-Kei_Nishikori,2,S-XC,1,0,0,0,0,0,1
20150109-M-Brisbane-QF-Bernard_Tomic-Kei_Nishikori,2,S-DTM,3,0,0,0,0,2,1
20150218-M-Delray_Beach-R32-Steve_Johnson-Andrey_Rublev,1,F-XC,27,9,3,2,4,16,11
20150218-M-Delray_Beach-R32-Steve_Johnson-Andrey_Rublev,1,F-DTM,17,2,0,0,2,12,5
20150218-M-Delray_Beach-R32-Steve_Johnson-Andrey_Rublev,1,F-DTL,14,6,4,0,2,8,6
20150218-M-Delray_Beach-R32-Steve_Johnson-Andrey_Rublev,1,F-IO,26,6,2,2,2,21,5
20150218-M-Delray_Beach-R32-Steve_Johnson-Andrey_Rublev,1,F-II,2,0,0,0,0,2,0
20150218-M-Delray_Beach-R32-Steve_Johnson-Andrey_Rublev,1,B-XC,3,0,0,0,0,0,3
20150218-M-Delray_Beach-R32-Steve_Johnson-Andrey_Rublev,1,B-DTM,8,0,0,0,0,4,4
20150218-M-Delray_Beach-R32-Steve_Johnson-Andrey_Rublev,1,B-DTL,2,1,0,1,0,2,0
20150218-M-Delray_Beach-R32-Steve_Johnson-Andrey_Rublev,1,B-IO,1,0,0,0,0,0,1
20150218-M-Delray_Beach-R32-Steve_Johnson-Andrey_Rublev,1,S-XC,41,5,0,0,5,19,22
20150218-M-Delray_Beach-R32-Steve_Johnson-Andrey_Rublev,1,S-DTM,9,0,0,0,0,6,3
20150218-M-Delray_Beach-R32-Steve_Johnson-Andrey_Rublev,1,S-DTL,4,0,0,0,0,1,3
20150218-M-Delray_Beach-R32-Steve_Johnson-Andrey_Rublev,1,S-IO,1,0,0,0,0,1,0
20150218-M-Delray_Beach-R32-Steve_Johnson-Andrey_Rublev,2,F-XC,27,9,1,2,6,10,17
20150218-M-Delray_Beach-R32-Steve_Johnson-Andrey_Rublev,2,F-DTM,13,0,0,0,0,6,7
20150218-M-Delray_Beach-R32-Steve_Johnson-Andrey_Rublev,2,F-DTL,9,3,1,0,2,4,5
20150218-M-Delray_Beach-R32-Steve_Johnson-Andrey_Rublev,2,F-IO,50,6,0,3,3,27,23
20150218-M-Delray_Beach-R32-Steve_Johnson-Andrey_Rublev,2,F-II,5,0,0,0,0,2,3
20150218-M-Delray_Beach-R32-Steve_Johnson-Andrey_Rublev,2,B-XC,23,7,0,0,7,5,18
20150218-M-Delray_Beach-R32-Steve_Johnson-Andrey_Rublev,2,B-DTM,19,2,0,0,2,4,15
20150218-M-Delray_Beach-R32-Steve_Johnson-Andrey_Rublev,2,B-DTL,7,3,2,0,1,3,4
20150218-M-Delray_Beach-R32-Steve_Johnson-Andrey_Rublev,2,B-IO,2,2,0,0,2,0,2
20150218-M-Delray_Beach-R32-Steve_Johnson-Andrey_Rublev,2,S-XC,7,4,0,2,2,3,4
20150218-M-Delray_Beach-R32-Steve_Johnson-Andrey_Rublev,2,S-DTM,4,1,0,0,1,1,3
20150218-M-Delray_Beach-R32-Steve_Johnson-Andrey_Rublev,2,S-DTL,4,1,0,1,0,1,3
20150106-M-Doha-R32-Novak_Djokovic-Dusan_Lajovic,1,F-XC,23,8,4,3,1,12,11
20150106-M-Doha-R32-Novak_Djokovic-Dusan_Lajovic,1,F-DTM,27,0,0,0,0,18,9
20150106-M-Doha-R32-Novak_Djokovic-Dusan_Lajovic,1,F-DTL,8,2,0,2,0,5,3
20150106-M-Doha-R32-Novak_Djokovic-Dusan_Lajovic,1,F-IO,24,9,4,2,3,19,5
20150106-M-Doha-R32-Novak_Djokovic-Dusan_Lajovic,1,F-II,2,1,0,0,1,1,1
20150106-M-Doha-R32-Novak_Djokovic-Dusan_Lajovic,1,B-XC,14,2,0,0,2,9,5
20150106-M-Doha-R32-Novak_Djokovic-Dusan_Lajovic,1,B-DTM,15,0,0,0,0,9,6
20150106-M-Doha-R32-Novak_Djokovic-Dusan_Lajovic,1,B-DTL,1,0,0,0,0,1,0
20150106-M-Doha-R32-Novak_Djokovic-Dusan_Lajovic,1,B-IO,8,4,0,0,4,4,4
20150106-M-Doha-R32-Novak_Djokovic-Dusan_Lajovic,1,S-DTM,1,0,0,0,0,1,0
20150106-M-Doha-R32-Novak_Djokovic-Dusan_Lajovic,1,S-DTL,1,0,0,0,0,0,1
20150106-M-Doha-R32-Novak_Djokovic-Dusan_Lajovic,2,F-XC,27,7,4,0,3,15,12
20150106-M-Doha-R32-Novak_Djokovic-Dusan_Lajovic,2,F-DTM,25,1,0,0,1,5,20
20150106-M-Doha-R32-Novak_Djokovic-Dusan_Lajovic,2,F-DTL,1,0,0,0,0,0,1
20150106-M-Doha-R32-Novak_Djokovic-Dusan_Lajovic,2,F-IO,5,0,0,0,0,2,3
20150106-M-Doha-R32-Novak_Djokovic-Dusan_Lajovic,2,F-II,1,0,0,0,0,1,0
20150106-M-Doha-R32-Novak_Djokovic-Dusan_Lajovic,2,B-XC,12,1,0,0,1,4,8
20150106-M-Doha-R32-Novak_Djokovic-Dusan_Lajovic,2,B-DTM,26,1,0,0,1,10,16
20150106-M-Doha-R32-Novak_Djokovic-Dusan_Lajovic,2,B-DTL,1,1,0,0,1,0,1
20150106-M-Doha-R32-Novak_Djokovic-Dusan_Lajovic,2,B-IO,5,2,1,0,1,2,3
20150106-M-Doha-R32-Novak_Djokovic-Dusan_Lajovic,2,S-XC,1,0,0,0,0,0,1
20150106-M-Doha-R32-Novak_Djokovic-Dusan_Lajovic,2,S-DTM,11,0,0,0,0,3,8
20150106-M-Doha-R32-Novak_Djokovic-Dusan_Lajovic,2,S-IO,1,0,0,0,0,0,1
20150225-M-Dubai-R16-Fernando_Verdasco-Roger_Federer,1,F-XC,28,2,0,0,2,6,22
20150225-M-Dubai-R16-Fernando_Verdasco-Roger_Federer,1,F-DTM,10,3,0,1,2,6,4
20150225-M-Dubai-R16-Fernando_Verdasco-Roger_Federer,1,F-DTL,1,0,0,0,0,0,1
20150225-M-Dubai-R16-Fernando_Verdasco-Roger_Federer,1,F-IO,9,7,2,2,3,5,4
20150225-M-Dubai-R16-Fernando_Verdasco-Roger_Federer,1,F-II,1,1,1,0,0,1,0
20150225-M-Dubai-R16-Fernando_Verdasco-Roger_Federer,1,B-XC,14,8,1,0,7,4,10
20150225-M-Dubai-R16-Fernando_Verdasco-Roger_Federer,1,B-DTM,11,3,0,1,2,2,9
20150225-M-Dubai-R16-Fernando_Verdasco-Roger_Federer,1,B-DTL,1,1,0,0,1,0,1
20150225-M-Dubai-R16-Fernando_Verdasco-Roger_Federer,1,B-IO,5,3,1,0,2,3,2
20150225-M-Dubai-R16-Fernando_Verdasco-Roger_Federer,1,S-DTL,3,0,0,0,0,0,3
20150225-M-Dubai-R16-Fernando_Verdasco-Roger_Federer,2,F-XC,11,2,0,1,1,8,3
20150225-M-Dubai-R16-Fernando_Verdasco-Roger_Federer,2,F-DTM,12,2,0,0,2,4,8
20150225-M-Dubai-R16-Fernando_Verdasco-Roger_Federer,2,F-DTL,2,2,1,0,1,1,1
20150225-M-Dubai-R16-Fernando_Verdasco-Roger_Federer,2,F-IO,6,1,1,0,0,4,2
20150225-M-Dubai-R16-Fernando_Verdasco-Roger_Federer,2,F-II,4,2,0,0,2,1,3
20150225-M-Dubai-R16-Fernando_Verdasco-Roger_Federer,2,B-XC,7,3,0,2,1,4,3
20150225-M-Dubai-R16-Fernando_Verdasco-Roger_Federer,2,B-DTM,11,0,0,0,0,8,3
20150225-M-Dubai-R16-Fernando_Verdasco-Roger_Federer,2,B-DTL,3,1,1,0,0,3,0
20150225-M-Dubai-R16-Fernando_Verdasco-Roger_Federer,2,B-IO,1,0,0,0,0,1,0
20150225-M-Dubai-R16-Fernando_Verdasco-Roger_Federer,2,S-XC,2,0,0,0,0,2,0
20150225-M-Dubai-R16-Fernando_Verdasco-Roger_Federer,2,S-DTM,4,0,0,0,0,4,0
20150225-M-Dubai-R16-Fernando_Verdasco-Roger_Federer,2,S-DTL,3,0,0,0,0,2,1
20150223-M-Dubai-R32-Joao_Sousa-James_Mcgee,1,F-XC,25,8,2,2,4,13,12
20150223-M-Dubai-R32-Joao_Sousa-James_Mcgee,1,F-DTM,28,3,0,1,2,14,14
20150223-M-Dubai-R32-Joao_Sousa-James_Mcgee,1,F-DTL,6,2,0,1,1,3,3
20150223-M-Dubai-R32-Joao_Sousa-James_Mcgee,1,F-IO,42,10,0,6,4,24,18
20150223-M-Dubai-R32-Joao_Sousa-James_Mcgee,1,F-II,7,3,0,2,1,5,2
20150223-M-Dubai-R32-Joao_Sousa-James_Mcgee,1,B-XC,11,2,0,0,2,6,5
20150223-M-Dubai-R32-Joao_Sousa-James_Mcgee,1,B-DTM,9,2,0,0,2,5,4
20150223-M-Dubai-R32-Joao_Sousa-James_Mcgee,1,B-DTL,1,1,0,1,0,1,0
20150223-M-Dubai-R32-Joao_Sousa-James_Mcgee,1,B-IO,1,0,0,0,0,0,1
20150223-M-Dubai-R32-Joao_Sousa-James_Mcgee,1,S-XC,5,2,0,1,1,3,2
20150223-M-Dubai-R32-Joao_Sousa-James_Mcgee,1,S-DTM,6,0,0,0,0,0,6
20150223-M-Dubai-R32-Joao_Sousa-James_Mcgee,1,S-DTL,1,1,0,1,0,1,0
20150223-M-Dubai-R32-Joao_Sousa-James_Mcgee,2,F-XC,22,7,2,1,4,10,12
20150223-M-Dubai-R32-Joao_Sousa-James_Mcgee,2,F-DTM,24,2,0,0,2,9,15
20150223-M-Dubai-R32-Joao_Sousa-James_Mcgee,2,F-DTL,5,1,0,1,0,4,1
20150223-M-Dubai-R32-Joao_Sousa-James_Mcgee,2,F-IO,8,3,1,0,2,5,3
20150223-M-Dubai-R32-Joao_Sousa-James_Mcgee,2,B-XC,30,4,0,1,3,10,20
20150223-M-Dubai-R32-Joao_Sousa-James_Mcgee,2,B-DTM,24,1,0,1,0,15,9
20150223-M-Dubai-R32-Joao_Sousa-James_Mcgee,2,B-DTL,5,1,0,0,1,1,4
20150223-M-Dubai-R32-Joao_Sousa-James_Mcgee,2,B-IO,4,3,1,0,2,1,3
20150223-M-Dubai-R32-Joao_Sousa-James_Mcgee,2,S-XC,10,2,0,0,2,2,8
20150223-M-Dubai-R32-Joao_Sousa-James_Mcgee,2,S-DTM,1,0,0,0,0,0,1
20150131-M-Hong_Kong_CH-SF-Kyle_Edmund-Yoshihito_Nishioka,1,F-XC,71,11,0,3,8,40,31
20150131-M-Hong_Kong_CH-SF-Kyle_Edmund-Yoshihito_Nishioka,1,F-DTM,27,1,0,0,1,16,11
20150131-M-Hong_Kong_CH-SF-Kyle_Edmund-Yoshihito_Nishioka,1,F-DTL,17,8,3,3,2,11,6
20150131-M-Hong_Kong_CH-SF-Kyle_Edmund-Yoshihito_Nishioka,1,F-IO,33,14,4,5,5,21,12
20150131-M-Hong_Kong_CH-SF-Kyle_Edmund-Yoshihito_Nishioka,1,F-II,2,0,0,0,0,1,1
20150131-M-Hong_Kong_CH-SF-Kyle_Edmund-Yoshihito_Nishioka,1,B-XC,41,8,2,3,3,28,13
20150131-M-Hong_Kong_CH-SF-Kyle_Edmund-Yoshihito_Nishioka,1,B-DTM,18,0,0,0,0,12,6
20150131-M-Hong_Kong_CH-SF-Kyle_Edmund-Yoshihito_Nishioka,1,B-DTL,10,2,1,0,1,4,6
20150131-M-Hong_Kong_CH-SF-Kyle_Edmund-Yoshihito_Nishioka,1,B-IO,4,1,0,1,0,4,0
20150131-M-Hong_Kong_CH-SF-Kyle_Edmund-Yoshihito_Nishioka,1,S-DTM,4,0,0,0,0,2,2
20150131-M-Hong_Kong_CH-SF-Kyle_Edmund-Yoshihito_Nishioka,1,S-DTL,7,0,0,0,0,5,2
20150131-M-Hong_Kong_CH-SF-Kyle_Edmund-Yoshihito_Nishioka,1,S-IO,1,0,0,0,0,1,0
20150131-M-Hong_Kong_CH-SF-Kyle_Edmund-Yoshihito_Nishioka,2,F-XC,52,7,1,0,6,17,35
20150131-M-Hong_Kong_CH-SF-Kyle_Edmund-Yoshihito_Nishioka,2,F-DTM,28,4,0,1,3,11,17
20150131-M-Hong_Kong_CH-SF-Kyle_Edmund-Yoshihito_Nishioka,2,F-DTL,7,3,1,0,2,2,5
20150131-M-Hong_Kong_CH-SF-Kyle_Edmund-Yoshihito_Nishioka,2,F-IO,16,5,1,1,3,6,10
20150131-M-Hong_Kong_CH-SF-Kyle_Edmund-Yoshihito_Nishioka,2,F-II,2,2,1,0,1,1,1
20150131-M-Hong_Kong_CH-SF-Kyle_Edmund-Yoshihito_Nishioka,2,B-XC,54,10,3,3,4,26,28
20150131-M-Hong_Kong_CH-SF-Kyle_Edmund-Yoshihito_Nishioka,2,B-DTM,38,3,0,0,3,12,26
20150131-M-Hong_Kong_CH-SF-Kyle_Edmund-Yoshihito_Nishioka,2,B-DTL,14,3,0,1,2,6,8
20150131-M-Hong_Kong_CH-SF-Kyle_Edmund-Yoshihito_Nishioka,2,B-IO,7,0,0,0,0,4,3
20150131-M-Hong_Kong_CH-SF-Kyle_Edmund-Yoshihito_Nishioka,2,S-DTM,6,1,0,0,1,0,6
20150131-M-Hong_Kong_CH-SF-Kyle_Edmund-Yoshihito_Nishioka,2,S-DTL,5,2,0,1,1,2,3
20150131-M-Hong_Kong_CH-SF-Kyle_Edmund-Yoshihito_Nishioka,2,S-IO,2,0,0,0,0,1,1
20150207-M-Montpellier-SF-Richard_Gasquet-Gael_Monfils,1,F-XC,23,4,3,1,0,14,9
20150207-M-Montpellier-SF-Richard_Gasquet-Gael_Monfils,1,F-DTM,18,0,0,0,0,10,8
20150207-M-Montpellier-SF-Richard_Gasquet-Gael_Monfils,1,F-DTL,8,1,1,0,0,5,3
20150207-M-Montpellier-SF-Richard_Gasquet-Gael_Monfils,1,F-IO,24,3,0,1,2,13,11
20150207-M-Montpellier-SF-Richard_Gasquet-Gael_Monfils,1,F-II,1,0,0,0,0,0,1
20150207-M-Montpellier-SF-Richard_Gasquet-Gael_Monfils,1,B-XC,85,7,0,4,3,46,39
20150207-M-Montpellier-SF-Richard_Gasquet-Gael_Monfils,1,B-DTM,22,1,0,1,0,11,11
20150207-M-Montpellier-SF-Richard_Gasquet-Gael_Monfils,1,B-DTL,15,7,5,1,1,10,5
20150207-M-Montpellier-SF-Richard_Gasquet-Gael_Monfils,1,B-IO,7,2,1,0,1,3,4
20150207-M-Montpellier-SF-Richard_Gasquet-Gael_Monfils,1,S-XC,10,0,0,0,0,5,5
20150207-M-Montpellier-SF-Richard_Gasquet-Gael_Monfils,1,S-DTM,6,0,0,0,0,3,3
20150207-M-Montpellier-SF-Richard_Gasquet-Gael_Monfils,2,F-XC,23,6,3,1,2,10,13
20150207-M-Montpellier-SF-Richard_Gasquet-Gael_Monfils,2,F-DTM,24,1,0,0,1,12,12
20150207-M-Montpellier-SF-Richard_Gasquet-Gael_Monfils,2,F-DTL,5,3,2,0,1,3,2
20150207-M-Montpellier-SF-Richard_Gasquet-Gael_Monfils,2,F-IO,23,4,3,0,1,14,9
20150207-M-Montpellier-SF-Richard_Gasquet-Gael_Monfils,2,F-II,4,3,2,1,0,4,0
20150207-M-Montpellier-SF-Richard_Gasquet-Gael_Monfils,2,B-XC,78,7,1,1,5,29,49
20150207-M-Montpellier-SF-Richard_Gasquet-Gael_Monfils,2,B-DTM,34,2,0,0,2,17,17
20150207-M-Montpellier-SF-Richard_Gasquet-Gael_Monfils,2,B-DTL,8,3,2,1,0,4,4
20150207-M-Montpellier-SF-Richard_Gasquet-Gael_Monfils,2,S-XC,3,0,0,0,0,0,3
20150207-M-Montpellier-SF-Richard_Gasquet-Gael_Monfils,2,S-DTM,4,0,0,0,0,3,1
20150207-M-Montpellier-SF-Richard_Gasquet-Gael_Monfils,2,S-DTL,1,0,0,0,0,1,0
20150206-M-Montpellier-QF-Gilles_Simon-Jerzy_Janowicz,1,F-XC,31,7,2,0,5,14,17
20150206-M-Montpellier-QF-Gilles_Simon-Jerzy_Janowicz,1,F-DTM,26,0,0,0,0,11,15
20150206-M-Montpellier-QF-Gilles_Simon-Jerzy_Janowicz,1,F-DTL,17,5,1,1,3,11,6
20150206-M-Montpellier-QF-Gilles_Simon-Jerzy_Janowicz,1,F-IO,13,1,0,1,0,7,6
20150206-M-Montpellier-QF-Gilles_Simon-Jerzy_Janowicz,1,F-II,1,0,0,0,0,0,1
20150206-M-Montpellier-QF-Gilles_Simon-Jerzy_Janowicz,1,B-XC,43,3,1,0,2,13,30
20150206-M-Montpellier-QF-Gilles_Simon-Jerzy_Janowicz,1,B-DTM,15,0,0,0,0,10,5
20150206-M-Montpellier-QF-Gilles_Simon-Jerzy_Janowicz,1,B-DTL,6,2,1,0,1,4,2
20150206-M-Montpellier-QF-Gilles_Simon-Jerzy_Janowicz,1,B-IO,1,0,0,0,0,1,0
20150206-M-Montpellier-QF-Gilles_Simon-Jerzy_Janowicz,1,S-XC,2,0,0,0,0,0,2
20150206-M-Montpellier-QF-Gilles_Simon-Jerzy_Janowicz,1,S-DTM,1,0,0,0,0,0,1
20150206-M-Montpellier-QF-Gilles_Simon-Jerzy_Janowicz,2,F-XC,51,13,2,2,9,27,24
20150206-M-Montpellier-QF-Gilles_Simon-Jerzy_Janowicz,2,F-DTM,5,0,0,0,0,2,3
20150206-M-Montpellier-QF-Gilles_Simon-Jerzy_Janowicz,2,F-DTL,7,2,2,0,0,3,4
20150206-M-Montpellier-QF-Gilles_Simon-Jerzy_Janowicz,2,F-IO,23,8,6,0,2,12,11
20150206-M-Montpellier-QF-Gilles_Simon-Jerzy_Janowicz,2,F-II,5,1,0,1,0,4,1
20150206-M-Montpellier-QF-Gilles_Simon-Jerzy_Janowicz,2,B-XC,19,5,1,0,4,13,6
20150206-M-Montpellier-QF-Gilles_Simon-Jerzy_Janowicz,2,B-DTM,17,0,0,0,0,12,5
20150206-M-Montpellier-QF-Gilles_Simon-Jerzy_Janowicz,2,B-DTL,10,6,4,1,1,8,2
20150206-M-Montpellier-QF-Gilles_Simon-Jerzy_Janowicz,2,B-IO,10,4,2,1,1,4,6
20150206-M-Montpellier-QF-Gilles_Simon-Jerzy_Janowicz,2,S-XC,17,2,1,0,1,10,7
20150206-M-Montpellier-QF-Gilles_Simon-Jerzy_Janowicz,2,S-DTM,7,1,0,0,1,2,5
20150206-M-Montpellier-QF-Gilles_Simon-Jerzy_Janowicz,2,S-DTL,4,0,0,0,0,0,4
20150206-M-Montpellier-QF-Gilles_Simon-Jerzy_Janowicz,2,S-IO,5,3,1,0,2,2,3
20150208-M-Quito-F-Feliciano_Lopez-Victor_Estrella,1,F-XC,66,13,1,2,10,32,34
20150208-M-Quito-F-Feliciano_Lopez-Victor_Estrella,1,F-DTM,18,2,0,0,2,7,11
20150208-M-Quito-F-Feliciano_Lopez-Victor_Estrella,1,F-DTL,10,7,0,1,6,1,9
20150208-M-Quito-F-Feliciano_Lopez-Victor_Estrella,1,F-IO,14,4,0,1,3,5,9
20150208-M-Quito-F-Feliciano_Lopez-Victor_Estrella,1,B-XC,3,0,0,0,0,2,1
20150208-M-Quito-F-Feliciano_Lopez-Victor_Estrella,1,B-DTM,6,0,0,0,0,4,2
20150208-M-Quito-F-Feliciano_Lopez-Victor_Estrella,1,B-DTL,2,1,0,0,1,1,1
20150208-M-Quito-F-Feliciano_Lopez-Victor_Estrella,1,B-IO,1,0,0,0,0,0,1
20150208-M-Quito-F-Feliciano_Lopez-Victor_Estrella,1,S-XC,25,5,0,2,3,9,16
20150208-M-Quito-F-Feliciano_Lopez-Victor_Estrella,1,S-DTM,18,1,0,0,1,3,15
20150208-M-Quito-F-Feliciano_Lopez-Victor_Estrella,1,S-DTL,10,6,0,2,4,3,7
20150208-M-Quito-F-Feliciano_Lopez-Victor_Estrella,1,S-IO,15,7,0,3,4,8,7
20150208-M-Quito-F-Feliciano_Lopez-Victor_Estrella,2,F-XC,52,13,5,1,7,37,15
20150208-M-Quito-F-Feliciano_Lopez-Victor_Estrella,2,F-DTM,39,6,0,0,6,19,20
20150208-M-Quito-F-Feliciano_Lopez-Victor_Estrella,2,F-DTL,8,4,1,1,2,4,4
20150208-M-Quito-F-Feliciano_Lopez-Victor_Estrella,2,F-IO,48,16,8,5,3,34,14
20150208-M-Quito-F-Feliciano_Lopez-Victor_Estrella,2,F-II,5,2,0,2,0,2,3
20150208-M-Quito-F-Feliciano_Lopez-Victor_Estrella,2,B-XC,1,1,0,0,1,0,1
20150208-M-Quito-F-Feliciano_Lopez-Victor_Estrella,2,B-DTM,3,0,0,0,0,1,2
20150208-M-Quito-F-Feliciano_Lopez-Victor_Estrella,2,B-DTL,2,2,1,1,0,2,0
20150208-M-Quito-F-Feliciano_Lopez-Victor_Estrella,2,S-XC,29,7,1,0,6,14,15
20150208-M-Quito-F-Feliciano_Lopez-Victor_Estrella,2,S-DTM,20,0,0,0,0,12,8
20150208-M-Quito-F-Feliciano_Lopez-Victor_Estrella,2,S-DTL,6,1,1,0,0,3,3
20150208-M-Quito-F-Feliciano_Lopez-Victor_Estrella,2,S-IO,3,0,0,0,0,3,0
20150202-M-Quito-Q3-Gerald_Melzer-Roberto_Carballes_Baena,1,F-XC,134,19,7,2,10,76,58
20150202-M-Quito-Q3-Gerald_Melzer-Roberto_Carballes_Baena,1,F-DTM,33,4,0,0,4,18,15
20150202-M-Quito-Q3-Gerald_Melzer-Roberto_Carballes_Baena,1,F-DTL,14,7,4,1,2,10,4
20150202-M-Quito-Q3-Gerald_Melzer-Roberto_Carballes_Baena,1,F-IO,34,12,4,6,2,18,16
20150202-M-Quito-Q3-Gerald_Melzer-Roberto_Carballes_Baena,1,F-II,5,3,0,2,1,3,2
20150202-M-Quito-Q3-Gerald_Melzer-Roberto_Carballes_Baena,1,B-XC,13,3,0,1,2,6,7
20150202-M-Quito-Q3-Gerald_Melzer-Roberto_Carballes_Baena,1,B-DTM,19,3,0,0,3,11,8
20150202-M-Quito-Q3-Gerald_Melzer-Roberto_Carballes_Baena,1,B-DTL,6,1,0,1,0,3,3
20150202-M-Quito-Q3-Gerald_Melzer-Roberto_Carballes_Baena,1,B-IO,5,0,0,0,0,4,1
20150202-M-Quito-Q3-Gerald_Melzer-Roberto_Carballes_Baena,1,S-XC,2,1,0,0,1,0,2
20150202-M-Quito-Q3-Gerald_Melzer-Roberto_Carballes_Baena,1,S-DTM,3,0,0,0,0,0,3
20150202-M-Quito-Q3-Gerald_Melzer-Roberto_Carballes_Baena,1,S-DTL,1,1,0,0,1,0,1
20150202-M-Quito-Q3-Gerald_Melzer-Roberto_Carballes_Baena,2,F-XC,30,8,4,2,2,17,13
20150202-M-Quito-Q3-Gerald_Melzer-Roberto_Carballes_Baena,2,F-DTM,32,4,1,1,2,13,19
20150202-M-Quito-Q3-Gerald_Melzer-Roberto_Carballes_Baena,2,F-DTL,15,7,3,2,2,11,4
20150202-M-Quito-Q3-Gerald_Melzer-Roberto_Carballes_Baena,2,F-IO,40,18,4,4,10,18,22
20150202-M-Quito-Q3-Gerald_Melzer-Roberto_Carballes_Baena,2,F-II,6,3,2,1,0,5,1
20150202-M-Quito-Q3-Gerald_Melzer-Roberto_Carballes_Baena,2,B-XC,56,7,1,1,5,25,31
20150202-M-Quito-Q3-Gerald_Melzer-Roberto_Carballes_Baena,2,B-DTM,74,10,0,1,9,30,44
20150202-M-Quito-Q3-Gerald_Melzer-Roberto_Carballes_Baena,2,B-DTL,7,2,0,2,0,5,2
20150202-M-Quito-Q3-Gerald_Melzer-Roberto_Carballes_Baena,2,B-IO,1,1,0,0,1,0,1
20150202-M-Quito-Q3-Gerald_Melzer-Roberto_Carballes_Baena,2,S-XC,3,1,0,1,0,1,2
20150202-M-Quito-Q3-Gerald_Melzer-Roberto_Carballes_Baena,2,S-DTM,5,1,0,1,0,1,4
20150202-M-Quito-Q3-Gerald_Melzer-Roberto_Carballes_Baena,2,S-DTL,2,0,0,0,0,1,1
20150219-M-Rio_De_Janeiro-R16-Rafael_Nadal-Pablo_Carreno_Busta,1,B-XC,1,1,0,0,1,0,1
20150219-M-Rio_De_Janeiro-R16-Rafael_Nadal-Pablo_Carreno_Busta,2,F-XC,1,1,1,0,0,1,0
20150219-M-Rio_De_Janeiro-R16-Rafael_Nadal-Pablo_Carreno_Busta,2,F-IO,1,1,1,0,0,1,0
20150219-M-Rio_De_Janeiro-R16-Rafael_Nadal-Pablo_Carreno_Busta,2,B-DTL,1,1,1,0,0,1,0
20150211-M-Rotterdam-R16-Grigor_Dimitrov-Gilles_Muller,1,F-XC,22,9,2,3,4,14,8
20150211-M-Rotterdam-R16-Grigor_Dimitrov-Gilles_Muller,1,F-DTM,2,0,0,0,0,0,2
20150211-M-Rotterdam-R16-Grigor_Dimitrov-Gilles_Muller,1,F-DTL,3,2,1,1,0,3,0
20150211-M-Rotterdam-R16-Grigor_Dimitrov-Gilles_Muller,1,F-IO,10,3,1,1,1,6,4
20150211-M-Rotterdam-R16-Grigor_Dimitrov-Gilles_Muller,1,F-II,4,1,0,0,1,2,2
20150211-M-Rotterdam-R16-Grigor_Dimitrov-Gilles_Muller,1,B-XC,13,5,0,2,3,6,7
20150211-M-Rotterdam-R16-Grigor_Dimitrov-Gilles_Muller,1,B-DTM,9,0,0,0,0,4,5
20150211-M-Rotterdam-R16-Grigor_Dimitrov-Gilles_Muller,1,B-DTL,5,2,0,0,2,2,3
20150211-M-Rotterdam-R16-Grigor_Dimitrov-Gilles_Muller,1,B-IO,1,1,0,0,1,0,1
20150211-M-Rotterdam-R16-Grigor_Dimitrov-Gilles_Muller,1,S-XC,3,1,0,1,0,2,1
20150211-M-Rotterdam-R16-Grigor_Dimitrov-Gilles_Muller,1,S-DTM,4,0,0,0,0,2,2
20150211-M-Rotterdam-R16-Grigor_Dimitrov-Gilles_Muller,1,S-DTL,1,0,0,0,0,1,0
20150211-M-Rotterdam-R16-Grigor_Dimitrov-Gilles_Muller,1,S-IO,1,0,0,0,0,1,0
20150211-M-Rotterdam-R16-Grigor_Dimitrov-Gilles_Muller,2,F-XC,27,7,2,2,3,11,16
20150211-M-Rotterdam-R16-Grigor_Dimitrov-Gilles_Muller,2,F-DTM,2,1,0,0,1,0,2
20150211-M-Rotterdam-R16-Grigor_Dimitrov-Gilles_Muller,2,F-DTL,5,3,1,0,2,3,2
20150211-M-Rotterdam-R16-Grigor_Dimitrov-Gilles_Muller,2,F-IO,5,4,2,1,1,3,2
20150211-M-Rotterdam-R16-Grigor_Dimitrov-Gilles_Muller,2,F-II,1,0,0,0,0,1,0
20150211-M-Rotterdam-R16-Grigor_Dimitrov-Gilles_Muller,2,B-XC,7,2,0,1,1,3,4
20150211-M-Rotterdam-R16-Grigor_Dimitrov-Gilles_Muller,2,B-DTM,1,0,0,0,0,0,1
20150211-M-Rotterdam-R16-Grigor_Dimitrov-Gilles_Muller,2,B-DTL,3,2,0,0,2,1,2
20150211-M-Rotterdam-R16-Grigor_Dimitrov-Gilles_Muller,2,B-IO,2,0,0,0,0,2,0
20150211-M-Rotterdam-R16-Grigor_Dimitrov-Gilles_Muller,2,S-XC,4,1,0,0,1,0,4
20150211-M-Rotterdam-R16-Grigor_Dimitrov-Gilles_Muller,2,S-DTM,4,1,0,0,1,0,4
20150211-M-Rotterdam-R16-Grigor_Dimitrov-Gilles_Muller,2,S-DTL,5,1,0,1,0,3,2
20150211-M-Rotterdam-R16-Grigor_Dimitrov-Gilles_Muller,2,S-IO,1,0,0,0,0,1,0
20150209-M-Rotterdam-R32-Grigor_Dimitrov-Paul_Henri_Mathieu,1,F-XC,8,7,5,0,2,5,3
20150209-M-Rotterdam-R32-Grigor_Dimitrov-Paul_Henri_Mathieu,1,F-DTM,4,0,0,0,0,1,3
20150209-M-Rotterdam-R32-Grigor_Dimitrov-Paul_Henri_Mathieu,1,F-DTL,2,1,1,0,0,1,1
20150209-M-Rotterdam-R32-Grigor_Dimitrov-Paul_Henri_Mathieu,1,F-IO,1,1,1,0,0,1,0
20150209-M-Rotterdam-R32-Grigor_Dimitrov-Paul_Henri_Mathieu,1,B-XC,2,1,0,0,1,0,2
20150209-M-Rotterdam-R32-Grigor_Dimitrov-Paul_Henri_Mathieu,1,B-DTM,1,0,0,0,0,1,0
20150209-M-Rotterdam-R32-Grigor_Dimitrov-Paul_Henri_Mathieu,1,B-DTL,2,2,2,0,0,2,0
20150209-M-Rotterdam-R32-Grigor_Dimitrov-Paul_Henri_Mathieu,1,S-XC,1,0,0,0,0,0,1
20150209-M-Rotterdam-R32-Grigor_Dimitrov-Paul_Henri_Mathieu,2,F-XC,5,2,2,0,0,4,1
20150209-M-Rotterdam-R32-Grigor_Dimitrov-Paul_Henri_Mathieu,2,F-DTM,1,0,0,0,0,1,0
20150209-M-Rotterdam-R32-Grigor_Dimitrov-Paul_Henri_Mathieu,2,F-DTL,3,2,0,0,2,1,2
20150209-M-Rotterdam-R32-Grigor_Dimitrov-Paul_Henri_Mathieu,2,F-IO,4,2,2,0,0,3,1
20150209-M-Rotterdam-R32-Grigor_Dimitrov-Paul_Henri_Mathieu,2,F-II,2,2,1,0,1,1,1
20150209-M-Rotterdam-R32-Grigor_Dimitrov-Paul_Henri_Mathieu,2,B-DTM,4,1,1,0,0,1,3
20150209-M-Rotterdam-R32-Grigor_Dimitrov-Paul_Henri_Mathieu,2,B-DTL,4,4,4,0,0,4,0
20150209-M-Rotterdam-R32-Grigor_Dimitrov-Paul_Henri_Mathieu,2,B-IO,1,1,0,1,0,1,0
20150209-M-Rotterdam-R32-Grigor_Dimitrov-Paul_Henri_Mathieu,2,S-DTL,1,0,0,0,0,0,1
20150210-M-Rotterdam-R32-Vasek_Pospisil-Philipp_Kohlschreiber,1,F-XC,21,10,8,1,1,18,3
20150210-M-Rotterdam-R32-Vasek_Pospisil-Philipp_Kohlschreiber,1,F-DTM,15,0,0,0,0,10,5
20150210-M-Rotterdam-R32-Vasek_Pospisil-Philipp_Kohlschreiber,1,F-DTL,4,2,2,0,0,4,0
20150210-M-Rotterdam-R32-Vasek_Pospisil-Philipp_Kohlschreiber,1,F-IO,6,2,2,0,0,4,2
20150210-M-Rotterdam-R32-Vasek_Pospisil-Philipp_Kohlschreiber,1,F-II,2,1,1,0,0,2,0
20150210-M-Rotterdam-R32-Vasek_Pospisil-Philipp_Kohlschreiber,1,B-XC,6,1,0,0,1,4,2
20150210-M-Rotterdam-R32-Vasek_Pospisil-Philipp_Kohlschreiber,1,B-DTM,6,0,0,0,0,5,1
20150210-M-Rotterdam-R32-Vasek_Pospisil-Philipp_Kohlschreiber,1,B-DTL,1,0,0,0,0,0,1
20150210-M-Rotterdam-R32-Vasek_Pospisil-Philipp_Kohlschreiber,1,B-IO,3,1,0,0,1,1,2
20150210-M-Rotterdam-R32-Vasek_Pospisil-Philipp_Kohlschreiber,1,S-XC,4,0,0,0,0,2,2
20150210-M-Rotterdam-R32-Vasek_Pospisil-Philipp_Kohlschreiber,1,S-DTM,6,0,0,0,0,4,2
20150210-M-Rotterdam-R32-Vasek_Pospisil-Philipp_Kohlschreiber,1,S-DTL,3,1,0,0,1,2,1
20150210-M-Rotterdam-R32-Vasek_Pospisil-Philipp_Kohlschreiber,1,S-IO,1,0,0,0,0,1,0
20150210-M-Rotterdam-R32-Vasek_Pospisil-Philipp_Kohlschreiber,2,F-XC,20,5,1,0,4,5,15
20150210-M-Rotterdam-R32-Vasek_Pospisil-Philipp_Kohlschreiber,2,F-DTM,11,4,0,1,3,3,8
20150210-M-Rotterdam-R32-Vasek_Pospisil-Philipp_Kohlschreiber,2,F-DTL,10,6,0,1,5,1,9
20150210-M-Rotterdam-R32-Vasek_Pospisil-Philipp_Kohlschreiber,2,F-IO,7,2,0,0,2,2,5
20150210-M-Rotterdam-R32-Vasek_Pospisil-Philipp_Kohlschreiber,2,F-II,1,1,0,1,0,1,0
20150210-M-Rotterdam-R32-Vasek_Pospisil-Philipp_Kohlschreiber,2,B-XC,16,0,0,0,0,3,13
20150210-M-Rotterdam-R32-Vasek_Pospisil-Philipp_Kohlschreiber,2,B-DTM,4,1,0,0,1,0,4
20150210-M-Rotterdam-R32-Vasek_Pospisil-Philipp_Kohlschreiber,2,B-DTL,2,2,0,1,1,1,1
20150210-M-Rotterdam-R32-Vasek_Pospisil-Philipp_Kohlschreiber,2,B-IO,3,2,0,1,1,1,2
20150210-M-Rotterdam-R32-Vasek_Pospisil-Philipp_Kohlschreiber,2,S-XC,3,1,0,1,0,2,1
20150210-M-Rotterdam-R32-Vasek_Pospisil-Philipp_Kohlschreiber,2,S-IO,1,1,0,0,1,0,1
20150212-M-Rotterdam-R16-Milos_Raonic-Simone_Bolelli,1,F-XC,16,2,1,0,1,11,5
20150212-M-Rotterdam-R16-Milos_Raonic-Simone_Bolelli,1,F-DTM,11,0,0,0,0,6,5
20150212-M-Rotterdam-R16-Milos_Raonic-Simone_Bolelli,1,F-DTL,4,2,1,1,0,4,0
20150212-M-Rotterdam-R16-Milos_Raonic-Simone_Bolelli,1,F-IO,14,3,1,0,2,7,7
20150212-M-Rotterdam-R16-Milos_Raonic-Simone_Bolelli,1,F-II,3,1,0,0,1,1,2
20150212-M-Rotterdam-R16-Milos_Raonic-Simone_Bolelli,1,B-XC,4,1,0,1,0,2,2
20150212-M-Rotterdam-R16-Milos_Raonic-Simone_Bolelli,1,B-DTM,11,1,0,0,1,6,5
20150212-M-Rotterdam-R16-Milos_Raonic-Simone_Bolelli,1,B-DTL,3,3,2,0,1,2,1
20150212-M-Rotterdam-R16-Milos_Raonic-Simone_Bolelli,1,S-XC,15,1,0,0,1,9,6
20150212-M-Rotterdam-R16-Milos_Raonic-Simone_Bolelli,1,S-DTM,10,0,0,0,0,3,7
20150212-M-Rotterdam-R16-Milos_Raonic-Simone_Bolelli,1,S-DTL,3,1,1,0,0,2,1
20150212-M-Rotterdam-R16-Milos_Raonic-Simone_Bolelli,1,S-IO,1,1,1,0,0,1,0
20150212-M-Rotterdam-R16-Milos_Raonic-Simone_Bolelli,2,F-XC,40,14,4,4,6,18,22
20150212-M-Rotterdam-R16-Milos_Raonic-Simone_Bolelli,2,F-DTM,8,3,0,2,1,5,3
20150212-M-Rotterdam-R16-Milos_Raonic-Simone_Bolelli,2,F-DTL,5,0,0,0,0,1,4
20150212-M-Rotterdam-R16-Milos_Raonic-Simone_Bolelli,2,F-IO,34,15,6,2,7,16,18
20150212-M-Rotterdam-R16-Milos_Raonic-Simone_Bolelli,2,F-II,2,1,1,0,0,1,1
20150212-M-Rotterdam-R16-Milos_Raonic-Simone_Bolelli,2,B-XC,9,2,1,1,0,7,2
20150212-M-Rotterdam-R16-Milos_Raonic-Simone_Bolelli,2,B-DTM,10,3,0,0,3,4,6
20150212-M-Rotterdam-R16-Milos_Raonic-Simone_Bolelli,2,B-DTL,1,1,1,0,0,1,0
20150212-M-Rotterdam-R16-Milos_Raonic-Simone_Bolelli,2,S-XC,6,1,0,0,1,1,5
20150212-M-Rotterdam-R16-Milos_Raonic-Simone_Bolelli,2,S-DTM,3,0,0,0,0,2,1
20150212-M-Rotterdam-R16-Milos_Raonic-Simone_Bolelli,2,S-DTL,3,3,1,1,1,2,1
20150210-M-Rotterdam-R32-Andrey_Kuznetsov-Milos_Raonic,1,F-XC,35,16,8,3,5,20,15
20150210-M-Rotterdam-R32-Andrey_Kuznetsov-Milos_Raonic,1,F-DTM,17,7,0,0,7,3,14
20150210-M-Rotterdam-R32-Andrey_Kuznetsov-Milos_Raonic,1,F-DTL,6,2,1,0,1,2,4
20150210-M-Rotterdam-R32-Andrey_Kuznetsov-Milos_Raonic,1,F-IO,16,2,1,1,0,7,9
20150210-M-Rotterdam-R32-Andrey_Kuznetsov-Milos_Raonic,1,F-II,2,0,0,0,0,2,0
20150210-M-Rotterdam-R32-Andrey_Kuznetsov-Milos_Raonic,1,B-XC,22,4,0,2,2,9,13
20150210-M-Rotterdam-R32-Andrey_Kuznetsov-Milos_Raonic,1,B-DTM,9,3,0,2,1,4,5
20150210-M-Rotterdam-R32-Andrey_Kuznetsov-Milos_Raonic,1,B-DTL,8,7,4,0,3,4,4
20150210-M-Rotterdam-R32-Andrey_Kuznetsov-Milos_Raonic,1,B-IO,2,2,2,0,0,2,0
20150210-M-Rotterdam-R32-Andrey_Kuznetsov-Milos_Raonic,1,S-XC,1,0,0,0,0,1,0
20150210-M-Rotterdam-R32-Andrey_Kuznetsov-Milos_Raonic,1,S-DTM,4,1,0,0,1,0,4
20150210-M-Rotterdam-R32-Andrey_Kuznetsov-Milos_Raonic,1,S-DTL,1,0,0,0,0,0,1
20150210-M-Rotterdam-R32-Andrey_Kuznetsov-Milos_Raonic,2,F-XC,21,12,8,2,2,16,5
20150210-M-Rotterdam-R32-Andrey_Kuznetsov-Milos_Raonic,2,F-DTM,13,2,0,2,0,8,5
20150210-M-Rotterdam-R32-Andrey_Kuznetsov-Milos_Raonic,2,F-DTL,6,1,1,0,0,4,2
20150210-M-Rotterdam-R32-Andrey_Kuznetsov-Milos_Raonic,2,F-IO,20,7,3,0,4,11,9
20150210-M-Rotterdam-R32-Andrey_Kuznetsov-Milos_Raonic,2,F-II,2,1,1,0,0,2,0
20150210-M-Rotterdam-R32-Andrey_Kuznetsov-Milos_Raonic,2,B-XC,3,2,0,1,1,2,1
20150210-M-Rotterdam-R32-Andrey_Kuznetsov-Milos_Raonic,2,B-DTM,9,5,0,2,3,5,4
20150210-M-Rotterdam-R32-Andrey_Kuznetsov-Milos_Raonic,2,B-DTL,2,0,0,0,0,1,1
20150210-M-Rotterdam-R32-Andrey_Kuznetsov-Milos_Raonic,2,B-IO,1,0,0,0,0,1,0
20150210-M-Rotterdam-R32-Andrey_Kuznetsov-Milos_Raonic,2,S-XC,15,1,0,1,0,8,7
20150210-M-Rotterdam-R32-Andrey_Kuznetsov-Milos_Raonic,2,S-DTM,10,2,0,1,1,7,3
20150209-M-Rotterdam-R32-Roberto_Bautista_Agut-Alexander_Zverev,1,F-XC,44,8,5,2,1,34,10
20150209-M-Rotterdam-R32-Roberto_Bautista_Agut-Alexander_Zverev,1,F-DTM,12,1,0,0,1,7,5
20150209-M-Rotterdam-R32-Roberto_Bautista_Agut-Alexander_Zverev,1,F-DTL,6,2,2,0,0,5,1
20150209-M-Rotterdam-R32-Roberto_Bautista_Agut-Alexander_Zverev,1,F-IO,35,8,3,1,4,26,9
20150209-M-Rotterdam-R32-Roberto_Bautista_Agut-Alexander_Zverev,1,F-II,5,3,1,1,1,4,1
20150209-M-Rotterdam-R32-Roberto_Bautista_Agut-Alexander_Zverev,1,B-XC,26,3,0,0,3,16,10
20150209-M-Rotterdam-R32-Roberto_Bautista_Agut-Alexander_Zverev,1,B-DTM,19,1,0,0,1,13,6
20150209-M-Rotterdam-R32-Roberto_Bautista_Agut-Alexander_Zverev,1,B-DTL,3,1,0,1,0,3,0
20150209-M-Rotterdam-R32-Roberto_Bautista_Agut-Alexander_Zverev,1,B-IO,1,1,0,0,1,0,1
20150209-M-Rotterdam-R32-Roberto_Bautista_Agut-Alexander_Zverev,1,S-XC,10,2,1,0,1,7,3
20150209-M-Rotterdam-R32-Roberto_Bautista_Agut-Alexander_Zverev,1,S-DTM,6,0,0,0,0,4,2
20150209-M-Rotterdam-R32-Roberto_Bautista_Agut-Alexander_Zverev,1,S-DTL,2,0,0,0,0,1,1
20150209-M-Rotterdam-R32-Roberto_Bautista_Agut-Alexander_Zverev,2,F-XC,21,0,0,0,0,6,15
20150209-M-Rotterdam-R32-Roberto_Bautista_Agut-Alexander_Zverev,2,F-DTM,26,2,0,0,2,7,19
20150209-M-Rotterdam-R32-Roberto_Bautista_Agut-Alexander_Zverev,2,F-DTL,9,2,1,0,1,2,7
20150209-M-Rotterdam-R32-Roberto_Bautista_Agut-Alexander_Zverev,2,F-IO,12,4,1,0,3,2,10
20150209-M-Rotterdam-R32-Roberto_Bautista_Agut-Alexander_Zverev,2,F-II,2,2,0,0,2,0,2
20150209-M-Rotterdam-R32-Roberto_Bautista_Agut-Alexander_Zverev,2,B-XC,54,10,0,0,10,15,39
20150209-M-Rotterdam-R32-Roberto_Bautista_Agut-Alexander_Zverev,2,B-DTM,22,0,0,0,0,6,16
20150209-M-Rotterdam-R32-Roberto_Bautista_Agut-Alexander_Zverev,2,B-DTL,5,1,1,0,0,3,2
20150209-M-Rotterdam-R32-Roberto_Bautista_Agut-Alexander_Zverev,2,B-IO,3,1,0,0,1,0,3
20150209-M-Rotterdam-R32-Roberto_Bautista_Agut-Alexander_Zverev,2,S-XC,5,1,0,0,1,2,3
20150209-M-Rotterdam-R32-Roberto_Bautista_Agut-Alexander_Zverev,2,S-DTM,3,0,0,0,0,1,2
20150212-M-Rotterdam-R16-Jeremy_Chardy-Gilles_Simon,1,F-XC,22,7,5,0,2,10,12
20150212-M-Rotterdam-R16-Jeremy_Chardy-Gilles_Simon,1,F-DTM,15,1,0,0,1,4,11
20150212-M-Rotterdam-R16-Jeremy_Chardy-Gilles_Simon,1,F-DTL,9,5,1,1,3,3,6
20150212-M-Rotterdam-R16-Jeremy_Chardy-Gilles_Simon,1,F-IO,28,8,2,2,4,14,14
20150212-M-Rotterdam-R16-Jeremy_Chardy-Gilles_Simon,1,F-II,3,1,0,0,1,1,2
20150212-M-Rotterdam-R16-Jeremy_Chardy-Gilles_Simon,1,B-XC,5,2,0,0,2,1,4
20150212-M-Rotterdam-R16-Jeremy_Chardy-Gilles_Simon,1,B-DTM,6,1,0,0,1,2,4
20150212-M-Rotterdam-R16-Jeremy_Chardy-Gilles_Simon,1,B-DTL,2,0,0,0,0,0,2
20150212-M-Rotterdam-R16-Jeremy_Chardy-Gilles_Simon,1,S-XC,26,6,0,1,5,3,23
20150212-M-Rotterdam-R16-Jeremy_Chardy-Gilles_Simon,1,S-DTM,2,0,0,0,0,0,2
20150212-M-Rotterdam-R16-Jeremy_Chardy-Gilles_Simon,1,S-DTL,2,0,0,0,0,1,1
20150212-M-Rotterdam-R16-Jeremy_Chardy-Gilles_Simon,1,S-IO,1,1,0,0,1,0,1
20150212-M-Rotterdam-R16-Jeremy_Chardy-Gilles_Simon,2,F-XC,21,5,3,2,0,19,2
20150212-M-Rotterdam-R16-Jeremy_Chardy-Gilles_Simon,2,F-DTM,15,0,0,0,0,9,6
20150212-M-Rotterdam-R16-Jeremy_Chardy-Gilles_Simon,2,F-DTL,8,3,1,1,1,7,1
20150212-M-Rotterdam-R16-Jeremy_Chardy-Gilles_Simon,2,F-IO,13,1,0,1,0,12,1
20150212-M-Rotterdam-R16-Jeremy_Chardy-Gilles_Simon,2,F-II,1,0,0,0,0,1,0
20150212-M-Rotterdam-R16-Jeremy_Chardy-Gilles_Simon,2,B-XC,33,5,2,1,2,24,9
20150212-M-Rotterdam-R16-Jeremy_Chardy-Gilles_Simon,2,B-DTM,14,1,0,0,1,7,7
20150212-M-Rotterdam-R16-Jeremy_Chardy-Gilles_Simon,2,B-DTL,7,3,1,1,1,5,2
20150212-M-Rotterdam-R16-Jeremy_Chardy-Gilles_Simon,2,B-IO,1,1,0,0,1,0,1
20150215-M-Rotterdam-F-Stanislas_Wawrinka-Tomas_Berdych,1,F-XC,45,16,4,6,6,24,21
20150215-M-Rotterdam-F-Stanislas_Wawrinka-Tomas_Berdych,1,F-DTM,31,2,0,0,2,19,12
20150215-M-Rotterdam-F-Stanislas_Wawrinka-Tomas_Berdych,1,F-DTL,11,5,2,0,3,5,6
20150215-M-Rotterdam-F-Stanislas_Wawrinka-Tomas_Berdych,1,F-IO,15,7,5,1,1,9,6
20150215-M-Rotterdam-F-Stanislas_Wawrinka-Tomas_Berdych,1,B-XC,19,6,1,3,2,12,7
20150215-M-Rotterdam-F-Stanislas_Wawrinka-Tomas_Berdych,1,B-DTM,18,2,0,1,1,12,6
20150215-M-Rotterdam-F-Stanislas_Wawrinka-Tomas_Berdych,1,B-DTL,7,5,2,1,2,4,3
20150215-M-Rotterdam-F-Stanislas_Wawrinka-Tomas_Berdych,1,B-IO,7,3,0,0,3,3,4
20150215-M-Rotterdam-F-Stanislas_Wawrinka-Tomas_Berdych,1,S-XC,5,0,0,0,0,1,4
20150215-M-Rotterdam-F-Stanislas_Wawrinka-Tomas_Berdych,1,S-DTM,2,0,0,0,0,0,2
20150215-M-Rotterdam-F-Stanislas_Wawrinka-Tomas_Berdych,2,F-XC,49,6,1,2,3,24,25
20150215-M-Rotterdam-F-Stanislas_Wawrinka-Tomas_Berdych,2,F-DTM,23,7,0,0,7,6,17
20150215-M-Rotterdam-F-Stanislas_Wawrinka-Tomas_Berdych,2,F-DTL,2,1,1,0,0,2,0
20150215-M-Rotterdam-F-Stanislas_Wawrinka-Tomas_Berdych,2,F-IO,24,15,2,2,11,10,14
20150215-M-Rotterdam-F-Stanislas_Wawrinka-Tomas_Berdych,2,F-II,1,0,0,0,0,1,0
20150215-M-Rotterdam-F-Stanislas_Wawrinka-Tomas_Berdych,2,B-XC,10,2,0,0,2,4,6
20150215-M-Rotterdam-F-Stanislas_Wawrinka-Tomas_Berdych,2,B-DTM,18,0,0,0,0,3,15
20150215-M-Rotterdam-F-Stanislas_Wawrinka-Tomas_Berdych,2,B-DTL,10,3,2,0,1,5,5
20150215-M-Rotterdam-F-Stanislas_Wawrinka-Tomas_Berdych,2,B-IO,10,2,2,0,0,6,4
20150215-M-Rotterdam-F-Stanislas_Wawrinka-Tomas_Berdych,2,S-XC,6,0,0,0,0,3,3
20150215-M-Rotterdam-F-Stanislas_Wawrinka-Tomas_Berdych,2,S-DTM,2,0,0,0,0,2,0
20150215-M-Rotterdam-F-Stanislas_Wawrinka-Tomas_Berdych,2,S-DTL,3,0,0,0,0,2,1
20150211-M-Rotterdam-R16-Sergiy_Stakhovsky-Dominic_Thiem,1,F-XC,10,2,1,1,0,4,6
20150211-M-Rotterdam-R16-Sergiy_Stakhovsky-Dominic_Thiem,1,F-DTM,11,0,0,0,0,5,6
20150211-M-Rotterdam-R16-Sergiy_Stakhovsky-Dominic_Thiem,1,F-DTL,5,1,1,0,0,5,0
20150211-M-Rotterdam-R16-Sergiy_Stakhovsky-Dominic_Thiem,1,F-IO,6,2,0,2,0,4,2
20150211-M-Rotterdam-R16-Sergiy_Stakhovsky-Dominic_Thiem,1,B-XC,14,4,0,2,2,9,5
20150211-M-Rotterdam-R16-Sergiy_Stakhovsky-Dominic_Thiem,1,B-DTM,8,1,0,0,1,3,5
20150211-M-Rotterdam-R16-Sergiy_Stakhovsky-Dominic_Thiem,1,B-DTL,4,3,2,0,1,3,1
20150211-M-Rotterdam-R16-Sergiy_Stakhovsky-Dominic_Thiem,1,B-IO,3,1,1,0,0,3,0
20150211-M-Rotterdam-R16-Sergiy_Stakhovsky-Dominic_Thiem,1,S-XC,7,2,0,1,1,3,4
20150211-M-Rotterdam-R16-Sergiy_Stakhovsky-Dominic_Thiem,1,S-DTM,6,0,0,0,0,2,4
20150211-M-Rotterdam-R16-Sergiy_Stakhovsky-Dominic_Thiem,1,S-DTL,3,1,0,1,0,3,0
20150211-M-Rotterdam-R16-Sergiy_Stakhovsky-Dominic_Thiem,1,S-IO,1,1,0,0,1,0,1
20150211-M-Rotterdam-R16-Sergiy_Stakhovsky-Dominic_Thiem,2,F-XC,21,3,1,2,0,9,12
20150211-M-Rotterdam-R16-Sergiy_Stakhovsky-Dominic_Thiem,2,F-DTM,13,1,0,0,1,9,4
20150211-M-Rotterdam-R16-Sergiy_Stakhovsky-Dominic_Thiem,2,F-DTL,2,1,1,0,0,2,0
20150211-M-Rotterdam-R16-Sergiy_Stakhovsky-Dominic_Thiem,2,F-IO,11,3,2,0,1,5,6
20150211-M-Rotterdam-R16-Sergiy_Stakhovsky-Dominic_Thiem,2,B-XC,16,5,2,1,2,8,8
20150211-M-Rotterdam-R16-Sergiy_Stakhovsky-Dominic_Thiem,2,B-DTM,11,3,0,1,2,5,6
20150211-M-Rotterdam-R16-Sergiy_Stakhovsky-Dominic_Thiem,2,B-DTL,4,3,1,0,2,2,2
20150211-M-Rotterdam-R16-Sergiy_Stakhovsky-Dominic_Thiem,2,B-IO,1,1,0,0,1,0,1
20150211-M-Rotterdam-R16-Sergiy_Stakhovsky-Dominic_Thiem,2,S-XC,9,3,1,1,1,5,4
20150211-M-Rotterdam-R16-Sergiy_Stakhovsky-Dominic_Thiem,2,S-DTM,4,0,0,0,0,1,3
20150211-M-Rotterdam-R16-Sergiy_Stakhovsky-Dominic_Thiem,2,S-DTL,2,0,0,0,0,0,2
20150213-M-Sao_Paulo-QF-Nicolas_Almagro-Pablo_Cuevas,1,F-XC,60,13,6,1,6,41,19
20150213-M-Sao_Paulo-QF-Nicolas_Almagro-Pablo_Cuevas,1,F-DTM,21,5,0,0,5,9,12
20150213-M-Sao_Paulo-QF-Nicolas_Almagro-Pablo_Cuevas,1,F-DTL,7,2,1,1,0,5,2
20150213-M-Sao_Paulo-QF-Nicolas_Almagro-Pablo_Cuevas,1,F-IO,22,11,3,5,3,16,6
20150213-M-Sao_Paulo-QF-Nicolas_Almagro-Pablo_Cuevas,1,F-II,7,3,0,1,2,5,2
20150213-M-Sao_Paulo-QF-Nicolas_Almagro-Pablo_Cuevas,1,B-XC,71,8,2,1,5,32,39
20150213-M-Sao_Paulo-QF-Nicolas_Almagro-Pablo_Cuevas,1,B-DTM,36,6,1,0,5,18,18
20150213-M-Sao_Paulo-QF-Nicolas_Almagro-Pablo_Cuevas,1,B-DTL,13,6,4,1,1,9,4
20150213-M-Sao_Paulo-QF-Nicolas_Almagro-Pablo_Cuevas,1,B-IO,2,1,0,0,1,0,2
20150213-M-Sao_Paulo-QF-Nicolas_Almagro-Pablo_Cuevas,1,S-XC,1,0,0,0,0,0,1
20150213-M-Sao_Paulo-QF-Nicolas_Almagro-Pablo_Cuevas,1,S-DTM,1,0,0,0,0,1,0
20150213-M-Sao_Paulo-QF-Nicolas_Almagro-Pablo_Cuevas,2,F-XC,52,18,5,5,8,22,30
20150213-M-Sao_Paulo-QF-Nicolas_Almagro-Pablo_Cuevas,2,F-DTM,34,2,0,1,1,13,21
20150213-M-Sao_Paulo-QF-Nicolas_Almagro-Pablo_Cuevas,2,F-DTL,17,5,0,0,5,4,13
20150213-M-Sao_Paulo-QF-Nicolas_Almagro-Pablo_Cuevas,2,F-IO,36,7,3,3,1,26,10
20150213-M-Sao_Paulo-QF-Nicolas_Almagro-Pablo_Cuevas,2,F-II,7,5,2,1,2,5,2
20150213-M-Sao_Paulo-QF-Nicolas_Almagro-Pablo_Cuevas,2,B-XC,59,7,0,2,5,28,31
20150213-M-Sao_Paulo-QF-Nicolas_Almagro-Pablo_Cuevas,2,B-DTM,9,2,0,1,1,5,4
20150213-M-Sao_Paulo-QF-Nicolas_Almagro-Pablo_Cuevas,2,B-DTL,7,5,1,0,4,3,4
20150213-M-Sao_Paulo-QF-Nicolas_Almagro-Pablo_Cuevas,2,S-XC,10,1,0,0,1,2,8
20150213-M-Sao_Paulo-QF-Nicolas_Almagro-Pablo_Cuevas,2,S-DTM,5,0,0,0,0,2,3
20150213-M-Sao_Paulo-QF-Nicolas_Almagro-Pablo_Cuevas,2,S-DTL,1,0,0,0,0,0,1
19981005-M-Basel-R32-Andre_Agassi-Roger_Federer,1,F-XC,24,6,0,1,5,13,11
19981005-M-Basel-R32-Andre_Agassi-Roger_Federer,1,F-DTM,3,0,0,0,0,1,2
19981005-M-Basel-R32-Andre_Agassi-Roger_Federer,1,F-DTL,9,4,1,0,3,4,5
19981005-M-Basel-R32-Andre_Agassi-Roger_Federer,1,F-IO,8,4,1,2,1,6,2
19981005-M-Basel-R32-Andre_Agassi-Roger_Federer,1,F-II,1,1,0,1,0,1,0
19981005-M-Basel-R32-Andre_Agassi-Roger_Federer,1,B-XC,41,6,1,2,3,22,19
19981005-M-Basel-R32-Andre_Agassi-Roger_Federer,1,B-DTM,6,1,0,0,1,3,3
19981005-M-Basel-R32-Andre_Agassi-Roger_Federer,1,B-DTL,7,1,1,0,0,3,4
19981005-M-Basel-R32-Andre_Agassi-Roger_Federer,1,B-IO,1,0,0,0,0,1,0
19981005-M-Basel-R32-Andre_Agassi-Roger_Federer,1,S-XC,8,1,0,0,1,6,2
19981005-M-Basel-R32-Andre_Agassi-Roger_Federer,2,F-XC,25,6,1,1,4,10,15
19981005-M-Basel-R32-Andre_Agassi-Roger_Federer,2,F-DTM,6,1,0,0,1,2,4
19981005-M-Basel-R32-Andre_Agassi-Roger_Federer,2,F-DTL,13,4,1,0,3,6,7
19981005-M-Basel-R32-Andre_Agassi-Roger_Federer,2,F-IO,11,2,1,1,0,5,6
19981005-M-Basel-R32-Andre_Agassi-Roger_Federer,2,F-II,6,5,2,0,3,3,3
19981005-M-Basel-R32-Andre_Agassi-Roger_Federer,2,B-XC,22,4,1,1,2,11,11
19981005-M-Basel-R32-Andre_Agassi-Roger_Federer,2,B-DTM,10,2,0,0,2,2,8
19981005-M-Basel-R32-Andre_Agassi-Roger_Federer,2,B-DTL,7,3,0,0,3,2,5
19981005-M-Basel-R32-Andre_Agassi-Roger_Federer,2,B-IO,1,0,0,0,0,1,0
19981005-M-Basel-R32-Andre_Agassi-Roger_Federer,2,S-XC,13,2,0,1,1,5,8
19981005-M-Basel-R32-Andre_Agassi-Roger_Federer,2,S-DTM,3,0,0,0,0,0,3
19981005-M-Basel-R32-Andre_Agassi-Roger_Federer,2,S-DTL,5,1,0,0,1,1,4
20140117-M-Australian_Open-R32-Tomas_Berdych-Damir_Dzumhur,1,F-XC,47,12,4,2,6,31,16
20140117-M-Australian_Open-R32-Tomas_Berdych-Damir_Dzumhur,1,F-DTM,27,3,0,1,2,17,10
20140117-M-Australian_Open-R32-Tomas_Berdych-Damir_Dzumhur,1,F-DTL,2,1,0,0,1,1,1
20140117-M-Australian_Open-R32-Tomas_Berdych-Damir_Dzumhur,1,F-IO,34,10,6,1,3,23,11
20140117-M-Australian_Open-R32-Tomas_Berdych-Damir_Dzumhur,1,F-II,11,5,1,2,2,8,3
20140117-M-Australian_Open-R32-Tomas_Berdych-Damir_Dzumhur,1,B-XC,35,2,1,0,1,25,10
20140117-M-Australian_Open-R32-Tomas_Berdych-Damir_Dzumhur,1,B-DTM,28,6,0,1,5,14,14
20140117-M-Australian_Open-R32-Tomas_Berdych-Damir_Dzumhur,1,B-DTL,2,1,1,0,0,2,0
20140117-M-Australian_Open-R32-Tomas_Berdych-Damir_Dzumhur,1,B-IO,6,2,0,0,2,3,3
20140117-M-Australian_Open-R32-Tomas_Berdych-Damir_Dzumhur,1,S-XC,12,0,0,0,0,7,5
20140117-M-Australian_Open-R32-Tomas_Berdych-Damir_Dzumhur,1,S-DTM,4,0,0,0,0,2,2
20140117-M-Australian_Open-R32-Tomas_Berdych-Damir_Dzumhur,1,S-DTL,2,0,0,0,0,0,2
20140117-M-Australian_Open-R32-Tomas_Berdych-Damir_Dzumhur,2,F-XC,26,10,4,1,5,11,15
20140117-M-Australian_Open-R32-Tomas_Berdych-Damir_Dzumhur,2,F-DTM,37,2,0,0,2,13,24
20140117-M-Australian_Open-R32-Tomas_Berdych-Damir_Dzumhur,2,F-DTL,15,3,0,1,2,4,11
20140117-M-Australian_Open-R32-Tomas_Berdych-Damir_Dzumhur,2,F-IO,21,3,0,0,3,10,11
20140117-M-Australian_Open-R32-Tomas_Berdych-Damir_Dzumhur,2,F-II,5,3,1,0,2,2,3
20140117-M-Australian_Open-R32-Tomas_Berdych-Damir_Dzumhur,2,B-XC,29,3,0,0,3,7,22
20140117-M-Australian_Open-R32-Tomas_Berdych-Damir_Dzumhur,2,B-DTM,37,5,0,0,5,13,24
20140117-M-Australian_Open-R32-Tomas_Berdych-Damir_Dzumhur,2,B-DTL,11,6,3,0,3,5,6
20140117-M-Australian_Open-R32-Tomas_Berdych-Damir_Dzumhur,2,B-IO,6,3,1,0,2,3,3
20140117-M-Australian_Open-R32-Tomas_Berdych-Damir_Dzumhur,2,S-XC,12,0,0,0,0,2,10
20140117-M-Australian_Open-R32-Tomas_Berdych-Damir_Dzumhur,2,S-DTM,7,0,0,0,0,1,6
20140117-M-Australian_Open-R32-Tomas_Berdych-Damir_Dzumhur,2,S-DTL,1,1,1,0,0,1,0
20140117-M-Australian_Open-R32-Tomas_Berdych-Damir_Dzumhur,2,S-IO,1,1,0,0,1,0,1
20140725-M-Atlanta-QF-John_Isner-Marinko_Matosevic,1,F-XC,20,12,3,2,7,8,12
20140725-M-Atlanta-QF-John_Isner-Marinko_Matosevic,1,F-DTM,6,2,0,0,2,2,4
20140725-M-Atlanta-QF-John_Isner-Marinko_Matosevic,1,F-DTL,6,1,0,0,1,2,4
20140725-M-Atlanta-QF-John_Isner-Marinko_Matosevic,1,F-IO,23,12,5,1,6,10,13
20140725-M-Atlanta-QF-John_Isner-Marinko_Matosevic,1,B-XC,3,2,1,1,0,2,1
20140725-M-Atlanta-QF-John_Isner-Marinko_Matosevic,1,B-DTM,8,2,0,0,2,1,7
20140725-M-Atlanta-QF-John_Isner-Marinko_Matosevic,1,B-DTL,9,3,2,1,0,5,4
20140725-M-Atlanta-QF-John_Isner-Marinko_Matosevic,1,B-IO,5,2,0,1,1,3,2
20140725-M-Atlanta-QF-John_Isner-Marinko_Matosevic,1,S-XC,4,0,0,0,0,2,2
20140725-M-Atlanta-QF-John_Isner-Marinko_Matosevic,1,S-DTM,8,0,0,0,0,0,8
20140725-M-Atlanta-QF-John_Isner-Marinko_Matosevic,1,S-DTL,1,0,0,0,0,0,1
20140725-M-Atlanta-QF-John_Isner-Marinko_Matosevic,2,F-XC,14,3,0,1,2,11,3
20140725-M-Atlanta-QF-John_Isner-Marinko_Matosevic,2,F-DTM,10,0,0,0,0,3,7
20140725-M-Atlanta-QF-John_Isner-Marinko_Matosevic,2,F-DTL,10,4,0,1,3,6,4
20140725-M-Atlanta-QF-John_Isner-Marinko_Matosevic,2,F-IO,10,2,1,0,1,7,3
20140725-M-Atlanta-QF-John_Isner-Marinko_Matosevic,2,F-II,1,1,0,0,1,0,1
20140725-M-Atlanta-QF-John_Isner-Marinko_Matosevic,2,B-XC,14,2,0,1,1,10,4
20140725-M-Atlanta-QF-John_Isner-Marinko_Matosevic,2,B-DTM,9,1,0,0,1,5,4
20140725-M-Atlanta-QF-John_Isner-Marinko_Matosevic,2,B-DTL,5,4,2,0,2,3,2
20140725-M-Atlanta-QF-John_Isner-Marinko_Matosevic,2,B-IO,3,1,0,0,1,2,1
20140725-M-Atlanta-QF-John_Isner-Marinko_Matosevic,2,S-XC,4,0,0,0,0,4,0
20140725-M-Atlanta-QF-John_Isner-Marinko_Matosevic,2,S-DTM,1,0,0,0,0,0,1
20140725-M-Atlanta-QF-John_Isner-Marinko_Matosevic,2,S-DTL,2,1,1,0,0,1,1
20140725-M-Atlanta-QF-John_Isner-Marinko_Matosevic,2,S-IO,1,0,0,0,0,1,0
20140727-M-Atlanta-F-John_Isner-Dudi_Sela,1,F-XC,18,11,4,1,6,9,9
20140727-M-Atlanta-F-John_Isner-Dudi_Sela,1,F-DTM,7,3,0,0,3,1,6
20140727-M-Atlanta-F-John_Isner-Dudi_Sela,1,F-DTL,5,1,1,0,0,3,2
20140727-M-Atlanta-F-John_Isner-Dudi_Sela,1,F-IO,18,12,4,1,7,9,9
20140727-M-Atlanta-F-John_Isner-Dudi_Sela,1,F-II,2,2,0,2,0,2,0
20140727-M-Atlanta-F-John_Isner-Dudi_Sela,1,B-DTM,3,1,0,0,1,1,2
20140727-M-Atlanta-F-John_Isner-Dudi_Sela,1,B-DTL,2,2,1,0,1,1,1
20140727-M-Atlanta-F-John_Isner-Dudi_Sela,1,B-IO,1,1,0,0,1,0,1
20140727-M-Atlanta-F-John_Isner-Dudi_Sela,1,S-XC,4,0,0,0,0,1,3
20140727-M-Atlanta-F-John_Isner-Dudi_Sela,1,S-DTM,7,1,0,0,1,2,5
20140727-M-Atlanta-F-John_Isner-Dudi_Sela,1,S-DTL,1,0,0,0,0,1,0
20140727-M-Atlanta-F-John_Isner-Dudi_Sela,2,F-XC,13,3,1,1,1,7,6
20140727-M-Atlanta-F-John_Isner-Dudi_Sela,2,F-DTM,10,1,0,1,0,9,1
20140727-M-Atlanta-F-John_Isner-Dudi_Sela,2,F-DTL,1,1,0,1,0,1,0
20140727-M-Atlanta-F-John_Isner-Dudi_Sela,2,F-IO,2,1,0,1,0,2,0
20140727-M-Atlanta-F-John_Isner-Dudi_Sela,2,B-XC,6,3,2,0,1,5,1
20140727-M-Atlanta-F-John_Isner-Dudi_Sela,2,B-DTM,12,2,0,1,1,6,6
20140727-M-Atlanta-F-John_Isner-Dudi_Sela,2,B-DTL,4,3,3,0,0,4,0
20140727-M-Atlanta-F-John_Isner-Dudi_Sela,2,B-IO,1,1,1,0,0,1,0
20140727-M-Atlanta-F-John_Isner-Dudi_Sela,2,S-XC,6,1,1,0,0,2,4
20140727-M-Atlanta-F-John_Isner-Dudi_Sela,2,S-DTM,6,0,0,0,0,3,3
20140727-M-Atlanta-F-John_Isner-Dudi_Sela,2,S-DTL,2,1,0,0,1,0,2
20141024-M-Basel-QF-Grigor_Dimitrov-Roger_Federer,1,F-XC,29,9,3,3,3,15,14
20141024-M-Basel-QF-Grigor_Dimitrov-Roger_Federer,1,F-DTM,13,1,0,0,1,5,8
20141024-M-Basel-QF-Grigor_Dimitrov-Roger_Federer,1,F-DTL,3,2,1,0,1,1,2
20141024-M-Basel-QF-Grigor_Dimitrov-Roger_Federer,1,F-IO,26,9,5,1,3,15,11
20141024-M-Basel-QF-Grigor_Dimitrov-Roger_Federer,1,F-II,2,0,0,0,0,0,2
20141024-M-Basel-QF-Grigor_Dimitrov-Roger_Federer,1,B-XC,27,0,0,0,0,9,18
20141024-M-Basel-QF-Grigor_Dimitrov-Roger_Federer,1,B-DTM,23,6,1,1,4,9,14
20141024-M-Basel-QF-Grigor_Dimitrov-Roger_Federer,1,B-DTL,7,5,1,0,4,2,5
20141024-M-Basel-QF-Grigor_Dimitrov-Roger_Federer,1,S-XC,15,3,1,0,2,4,11
20141024-M-Basel-QF-Grigor_Dimitrov-Roger_Federer,1,S-DTM,3,0,0,0,0,2,1
20141024-M-Basel-QF-Grigor_Dimitrov-Roger_Federer,1,S-DTL,5,2,0,1,1,3,2
20141024-M-Basel-QF-Grigor_Dimitrov-Roger_Federer,2,F-XC,20,7,4,1,2,16,4
20141024-M-Basel-QF-Grigor_Dimitrov-Roger_Federer,2,F-DTM,18,2,0,2,0,11,7
20141024-M-Basel-QF-Grigor_Dimitrov-Roger_Federer,2,F-DTL,10,2,0,1,1,6,4
20141024-M-Basel-QF-Grigor_Dimitrov-Roger_Federer,2,F-IO,20,6,1,1,4,10,10
20141024-M-Basel-QF-Grigor_Dimitrov-Roger_Federer,2,F-II,2,0,0,0,0,2,0
20141024-M-Basel-QF-Grigor_Dimitrov-Roger_Federer,2,B-XC,30,2,1,0,1,19,11
20141024-M-Basel-QF-Grigor_Dimitrov-Roger_Federer,2,B-DTM,9,3,1,0,2,6,3
20141024-M-Basel-QF-Grigor_Dimitrov-Roger_Federer,2,B-DTL,6,2,2,0,0,5,1
20141024-M-Basel-QF-Grigor_Dimitrov-Roger_Federer,2,S-XC,12,2,0,1,1,5,7
20141024-M-Basel-QF-Grigor_Dimitrov-Roger_Federer,2,S-DTM,4,1,0,0,1,0,4
20141024-M-Basel-QF-Grigor_Dimitrov-Roger_Federer,2,S-DTL,1,0,0,0,0,1,0
20141022-M-Basel-R32-Ernests_Gulbis-Borna_Coric,1,F-XC,30,7,1,1,5,17,13
20141022-M-Basel-R32-Ernests_Gulbis-Borna_Coric,1,F-DTM,19,2,0,0,2,8,11
20141022-M-Basel-R32-Ernests_Gulbis-Borna_Coric,1,F-DTL,8,4,0,0,4,3,5
20141022-M-Basel-R32-Ernests_Gulbis-Borna_Coric,1,F-IO,19,3,0,0,3,7,12
20141022-M-Basel-R32-Ernests_Gulbis-Borna_Coric,1,B-XC,27,5,1,2,2,18,9
20141022-M-Basel-R32-Ernests_Gulbis-Borna_Coric,1,B-DTM,15,3,0,0,3,6,9
20141022-M-Basel-R32-Ernests_Gulbis-Borna_Coric,1,B-DTL,10,6,2,1,3,4,6
20141022-M-Basel-R32-Ernests_Gulbis-Borna_Coric,1,B-IO,16,8,1,2,5,4,12
20141022-M-Basel-R32-Ernests_Gulbis-Borna_Coric,1,S-XC,6,0,0,0,0,6,0
20141022-M-Basel-R32-Ernests_Gulbis-Borna_Coric,1,S-DTM,2,0,0,0,0,1,1
20141022-M-Basel-R32-Ernests_Gulbis-Borna_Coric,2,F-XC,40,4,2,1,1,18,22
20141022-M-Basel-R32-Ernests_Gulbis-Borna_Coric,2,F-DTM,24,2,0,1,1,13,11
20141022-M-Basel-R32-Ernests_Gulbis-Borna_Coric,2,F-DTL,5,2,0,1,1,3,2
20141022-M-Basel-R32-Ernests_Gulbis-Borna_Coric,2,F-IO,13,3,2,0,1,6,7
20141022-M-Basel-R32-Ernests_Gulbis-Borna_Coric,2,F-II,1,1,1,0,0,1,0
20141022-M-Basel-R32-Ernests_Gulbis-Borna_Coric,2,B-XC,27,5,1,3,1,12,15
20141022-M-Basel-R32-Ernests_Gulbis-Borna_Coric,2,B-DTM,25,5,0,0,5,10,15
20141022-M-Basel-R32-Ernests_Gulbis-Borna_Coric,2,B-DTL,5,4,3,0,1,3,2
20141022-M-Basel-R32-Ernests_Gulbis-Borna_Coric,2,B-IO,3,3,0,0,3,0,3
20141022-M-Basel-R32-Ernests_Gulbis-Borna_Coric,2,S-XC,7,0,0,0,0,5,2
20141022-M-Basel-R32-Ernests_Gulbis-Borna_Coric,2,S-DTM,8,0,0,0,0,4,4
20141022-M-Basel-R32-Ernests_Gulbis-Borna_Coric,2,S-DTL,3,2,2,0,0,2,1
20141026-M-Basel-F-David_Goffin-Roger_Federer,1,F-XC,18,4,1,0,3,9,9
20141026-M-Basel-F-David_Goffin-Roger_Federer,1,F-DTM,11,2,0,0,2,2,9
20141026-M-Basel-F-David_Goffin-Roger_Federer,1,F-DTL,5,0,0,0,0,1,4
20141026-M-Basel-F-David_Goffin-Roger_Federer,1,F-IO,8,3,0,0,3,3,5
20141026-M-Basel-F-David_Goffin-Roger_Federer,1,B-XC,22,5,2,1,2,10,12
20141026-M-Basel-F-David_Goffin-Roger_Federer,1,B-DTM,10,1,0,0,1,2,8
20141026-M-Basel-F-David_Goffin-Roger_Federer,1,B-DTL,3,2,0,1,1,1,2
20141026-M-Basel-F-David_Goffin-Roger_Federer,1,B-IO,2,1,0,0,1,1,1
20141026-M-Basel-F-David_Goffin-Roger_Federer,1,S-XC,1,0,0,0,0,0,1
20141026-M-Basel-F-David_Goffin-Roger_Federer,1,S-DTM,2,0,0,0,0,0,2
20141026-M-Basel-F-David_Goffin-Roger_Federer,1,S-DTL,1,0,0,0,0,1,0
20141026-M-Basel-F-David_Goffin-Roger_Federer,2,F-XC,16,5,2,2,1,11,5
20141026-M-Basel-F-David_Goffin-Roger_Federer,2,F-DTM,11,1,0,0,1,6,5
20141026-M-Basel-F-David_Goffin-Roger_Federer,2,F-DTL,5,3,1,1,1,3,2
20141026-M-Basel-F-David_Goffin-Roger_Federer,2,F-IO,8,3,1,2,0,8,0
20141026-M-Basel-F-David_Goffin-Roger_Federer,2,F-II,2,0,0,0,0,1,1
20141026-M-Basel-F-David_Goffin-Roger_Federer,2,B-XC,8,2,1,0,1,5,3
20141026-M-Basel-F-David_Goffin-Roger_Federer,2,B-DTM,12,2,0,0,2,6,6
20141026-M-Basel-F-David_Goffin-Roger_Federer,2,B-DTL,4,1,1,0,0,3,1
20141026-M-Basel-F-David_Goffin-Roger_Federer,2,S-XC,5,0,0,0,0,3,2
20141026-M-Basel-F-David_Goffin-Roger_Federer,2,S-DTM,4,0,0,0,0,4,0
20141026-M-Basel-F-David_Goffin-Roger_Federer,2,S-DTL,1,0,0,0,0,1,0
20141020-M-Basel-R32-Dominic_Thiem-David_Goffin,1,F-XC,22,10,4,1,5,10,12
20141020-M-Basel-R32-Dominic_Thiem-David_Goffin,1,F-DTM,16,0,0,0,0,7,9
20141020-M-Basel-R32-Dominic_Thiem-David_Goffin,1,F-DTL,4,1,0,1,0,3,1
20141020-M-Basel-R32-Dominic_Thiem-David_Goffin,1,F-IO,19,9,3,1,5,11,8
20141020-M-Basel-R32-Dominic_Thiem-David_Goffin,1,B-XC,18,4,0,0,4,12,6
20141020-M-Basel-R32-Dominic_Thiem-David_Goffin,1,B-DTM,21,6,0,0,6,8,13
20141020-M-Basel-R32-Dominic_Thiem-David_Goffin,1,B-DTL,6,5,2,1,2,4,2
20141020-M-Basel-R32-Dominic_Thiem-David_Goffin,1,B-IO,1,1,0,0,1,0,1
20141020-M-Basel-R32-Dominic_Thiem-David_Goffin,1,S-XC,12,0,0,0,0,5,7
20141020-M-Basel-R32-Dominic_Thiem-David_Goffin,1,S-DTM,9,2,0,1,1,2,7
20141020-M-Basel-R32-Dominic_Thiem-David_Goffin,1,S-DTL,2,1,0,1,0,1,1
20141020-M-Basel-R32-Dominic_Thiem-David_Goffin,2,F-XC,20,6,2,1,3,13,7
20141020-M-Basel-R32-Dominic_Thiem-David_Goffin,2,F-DTM,13,0,0,0,0,7,6
20141020-M-Basel-R32-Dominic_Thiem-David_Goffin,2,F-DTL,4,0,0,0,0,3,1
20141020-M-Basel-R32-Dominic_Thiem-David_Goffin,2,F-IO,12,2,0,0,2,8,4
20141020-M-Basel-R32-Dominic_Thiem-David_Goffin,2,F-II,2,0,0,0,0,1,1
20141020-M-Basel-R32-Dominic_Thiem-David_Goffin,2,B-XC,40,3,1,0,2,19,21
20141020-M-Basel-R32-Dominic_Thiem-David_Goffin,2,B-DTM,13,1,0,0,1,4,9
20141020-M-Basel-R32-Dominic_Thiem-David_Goffin,2,B-DTL,9,5,2,0,3,5,4
20141020-M-Basel-R32-Dominic_Thiem-David_Goffin,2,B-IO,1,0,0,0,0,0,1
20141020-M-Basel-R32-Dominic_Thiem-David_Goffin,2,S-XC,2,1,0,0,1,0,2
20141020-M-Basel-R32-Dominic_Thiem-David_Goffin,2,S-DTM,3,0,0,0,0,0,3
20140711-M-Bastad-QF-Renzo_Olivo-Pablo_Cuevas,1,F-XC,23,7,3,0,4,14,9
20140711-M-Bastad-QF-Renzo_Olivo-Pablo_Cuevas,1,F-DTM,31,5,0,0,5,12,19
20140711-M-Bastad-QF-Renzo_Olivo-Pablo_Cuevas,1,F-DTL,4,0,0,0,0,2,2
20140711-M-Bastad-QF-Renzo_Olivo-Pablo_Cuevas,1,F-IO,22,6,1,1,4,8,14
20140711-M-Bastad-QF-Renzo_Olivo-Pablo_Cuevas,1,F-II,4,2,2,0,0,3,1
20140711-M-Bastad-QF-Renzo_Olivo-Pablo_Cuevas,1,B-XC,24,3,0,2,1,8,16
20140711-M-Bastad-QF-Renzo_Olivo-Pablo_Cuevas,1,B-DTM,29,4,0,0,4,10,19
20140711-M-Bastad-QF-Renzo_Olivo-Pablo_Cuevas,1,B-DTL,1,0,0,0,0,1,0
20140711-M-Bastad-QF-Renzo_Olivo-Pablo_Cuevas,1,S-XC,7,0,0,0,0,3,4
20140711-M-Bastad-QF-Renzo_Olivo-Pablo_Cuevas,1,S-DTM,10,1,0,0,1,4,6
20140711-M-Bastad-QF-Renzo_Olivo-Pablo_Cuevas,1,S-DTL,2,0,0,0,0,1,1
20140711-M-Bastad-QF-Renzo_Olivo-Pablo_Cuevas,2,F-XC,38,11,2,4,5,20,18
20140711-M-Bastad-QF-Renzo_Olivo-Pablo_Cuevas,2,F-DTM,35,6,0,0,6,15,20
20140711-M-Bastad-QF-Renzo_Olivo-Pablo_Cuevas,2,F-DTL,5,1,0,0,1,2,3
20140711-M-Bastad-QF-Renzo_Olivo-Pablo_Cuevas,2,F-IO,51,19,3,6,10,34,17
20140711-M-Bastad-QF-Renzo_Olivo-Pablo_Cuevas,2,F-II,3,2,1,1,0,3,0
20140711-M-Bastad-QF-Renzo_Olivo-Pablo_Cuevas,2,B-XC,29,1,0,0,1,18,11
20140711-M-Bastad-QF-Renzo_Olivo-Pablo_Cuevas,2,B-DTM,9,1,0,0,1,7,2
20140711-M-Bastad-QF-Renzo_Olivo-Pablo_Cuevas,2,B-DTL,2,2,1,0,1,1,1
20140711-M-Bastad-QF-Renzo_Olivo-Pablo_Cuevas,2,B-IO,1,1,0,0,1,0,1
20140711-M-Bastad-QF-Renzo_Olivo-Pablo_Cuevas,2,S-XC,2,1,0,0,1,1,1
20140711-M-Bastad-QF-Renzo_Olivo-Pablo_Cuevas,2,S-DTM,2,0,0,0,0,1,1
20140710-M-Bastad-R16-Victor_Hanescu-David_Ferrer,1,F-XC,13,4,1,1,2,6,7
20140710-M-Bastad-R16-Victor_Hanescu-David_Ferrer,1,F-DTM,17,1,0,0,1,5,12
20140710-M-Bastad-R16-Victor_Hanescu-David_Ferrer,1,F-DTL,10,6,2,1,3,4,6
20140710-M-Bastad-R16-Victor_Hanescu-David_Ferrer,1,F-IO,10,0,0,0,0,9,1
20140710-M-Bastad-R16-Victor_Hanescu-David_Ferrer,1,F-II,2,1,0,0,1,1,1
20140710-M-Bastad-R16-Victor_Hanescu-David_Ferrer,1,B-XC,8,1,0,0,1,2,6
20140710-M-Bastad-R16-Victor_Hanescu-David_Ferrer,1,B-DTM,20,3,0,0,3,5,15
20140710-M-Bastad-R16-Victor_Hanescu-David_Ferrer,1,B-DTL,5,1,0,0,1,2,3
20140710-M-Bastad-R16-Victor_Hanescu-David_Ferrer,1,B-IO,3,0,0,0,0,1,2
20140710-M-Bastad-R16-Victor_Hanescu-David_Ferrer,1,S-XC,6,1,0,0,1,3,3
20140710-M-Bastad-R16-Victor_Hanescu-David_Ferrer,1,S-DTM,11,2,0,0,2,0,11
20140710-M-Bastad-R16-Victor_Hanescu-David_Ferrer,2,F-XC,33,12,4,4,4,22,11
20140710-M-Bastad-R16-Victor_Hanescu-David_Ferrer,2,F-DTM,14,0,0,0,0,8,6
20140710-M-Bastad-R16-Victor_Hanescu-David_Ferrer,2,F-DTL,3,1,0,0,1,2,1
20140710-M-Bastad-R16-Victor_Hanescu-David_Ferrer,2,F-IO,18,7,4,1,2,13,5
20140710-M-Bastad-R16-Victor_Hanescu-David_Ferrer,2,F-II,2,1,0,0,1,1,1
20140710-M-Bastad-R16-Victor_Hanescu-David_Ferrer,2,B-XC,17,4,1,2,1,14,3
20140710-M-Bastad-R16-Victor_Hanescu-David_Ferrer,2,B-DTM,18,4,0,0,4,7,11
20140710-M-Bastad-R16-Victor_Hanescu-David_Ferrer,2,B-DTL,3,1,0,0,1,0,3
20140710-M-Bastad-R16-Victor_Hanescu-David_Ferrer,2,S-DTM,1,0,0,0,0,1,0
20140710-M-Bastad-R16-Victor_Hanescu-David_Ferrer,2,S-DTL,1,0,0,0,0,0,1
20140709-M-Bastad-R16-Joao_Sousa-Elias_Ymer,1,F-XC,41,15,7,2,6,29,12
20140709-M-Bastad-R16-Joao_Sousa-Elias_Ymer,1,F-DTM,29,4,0,0,4,14,15
20140709-M-Bastad-R16-Joao_Sousa-Elias_Ymer,1,F-DTL,8,3,1,1,1,5,3
20140709-M-Bastad-R16-Joao_Sousa-Elias_Ymer,1,F-IO,30,9,2,3,4,21,9
20140709-M-Bastad-R16-Joao_Sousa-Elias_Ymer,1,F-II,4,0,0,0,0,2,2
20140709-M-Bastad-R16-Joao_Sousa-Elias_Ymer,1,B-XC,15,4,0,1,3,9,6
20140709-M-Bastad-R16-Joao_Sousa-Elias_Ymer,1,B-DTM,22,7,1,0,6,8,14
20140709-M-Bastad-R16-Joao_Sousa-Elias_Ymer,1,B-DTL,3,0,0,0,0,1,2
20140709-M-Bastad-R16-Joao_Sousa-Elias_Ymer,1,B-IO,3,0,0,0,0,2,1
20140709-M-Bastad-R16-Joao_Sousa-Elias_Ymer,1,S-XC,3,1,0,0,1,0,3
20140709-M-Bastad-R16-Joao_Sousa-Elias_Ymer,1,S-DTM,2,0,0,0,0,1,1
20140709-M-Bastad-R16-Joao_Sousa-Elias_Ymer,1,S-DTL,1,0,0,0,0,0,1
20140709-M-Bastad-R16-Joao_Sousa-Elias_Ymer,2,F-XC,28,8,3,0,5,12,16
20140709-M-Bastad-R16-Joao_Sousa-Elias_Ymer,2,F-DTM,30,3,0,1,2,16,14
20140709-M-Bastad-R16-Joao_Sousa-Elias_Ymer,2,F-DTL,5,0,0,0,0,2,3
20140709-M-Bastad-R16-Joao_Sousa-Elias_Ymer,2,F-IO,20,7,2,1,4,10,10
20140709-M-Bastad-R16-Joao_Sousa-Elias_Ymer,2,F-II,1,0,0,0,0,0,1
20140709-M-Bastad-R16-Joao_Sousa-Elias_Ymer,2,B-XC,17,1,0,0,1,10,7
20140709-M-Bastad-R16-Joao_Sousa-Elias_Ymer,2,B-DTM,30,4,0,0,4,6,24
20140709-M-Bastad-R16-Joao_Sousa-Elias_Ymer,2,B-DTL,6,2,0,1,1,1,5
20140709-M-Bastad-R16-Joao_Sousa-Elias_Ymer,2,B-IO,6,1,1,0,0,3,3
20140709-M-Bastad-R16-Joao_Sousa-Elias_Ymer,2,S-XC,3,0,0,0,0,2,1
20140709-M-Bastad-R16-Joao_Sousa-Elias_Ymer,2,S-DTM,10,3,0,1,2,2,8
20140709-M-Bastad-R16-Joao_Sousa-Elias_Ymer,2,S-IO,2,0,0,0,0,1,1
20141005-M-Beijing-F-Tomas_Berdych-Novak_Djokovic,1,F-XC,28,2,0,1,1,12,16
20141005-M-Beijing-F-Tomas_Berdych-Novak_Djokovic,1,F-DTM,13,2,0,0,2,3,10
20141005-M-Beijing-F-Tomas_Berdych-Novak_Djokovic,1,F-DTL,8,6,3,2,1,6,2
20141005-M-Beijing-F-Tomas_Berdych-Novak_Djokovic,1,F-IO,14,3,0,0,3,5,9
20141005-M-Beijing-F-Tomas_Berdych-Novak_Djokovic,1,F-II,3,1,1,0,0,2,1
20141005-M-Beijing-F-Tomas_Berdych-Novak_Djokovic,1,B-XC,19,3,0,0,3,5,14
20141005-M-Beijing-F-Tomas_Berdych-Novak_Djokovic,1,B-DTM,28,1,0,0,1,6,22
20141005-M-Beijing-F-Tomas_Berdych-Novak_Djokovic,1,B-DTL,5,1,0,1,0,3,2
20141005-M-Beijing-F-Tomas_Berdych-Novak_Djokovic,1,S-XC,6,1,0,0,1,3,3
20141005-M-Beijing-F-Tomas_Berdych-Novak_Djokovic,1,S-DTM,2,1,0,0,1,0,2
20141005-M-Beijing-F-Tomas_Berdych-Novak_Djokovic,1,S-IO,1,1,0,0,1,0,1
20141005-M-Beijing-F-Tomas_Berdych-Novak_Djokovic,2,F-XC,27,11,2,4,5,14,13
20141005-M-Beijing-F-Tomas_Berdych-Novak_Djokovic,2,F-DTM,21,0,0,0,0,14,7
20141005-M-Beijing-F-Tomas_Berdych-Novak_Djokovic,2,F-DTL,6,0,0,0,0,5,1
20141005-M-Beijing-F-Tomas_Berdych-Novak_Djokovic,2,F-IO,19,8,2,3,3,12,7
20141005-M-Beijing-F-Tomas_Berdych-Novak_Djokovic,2,B-XC,26,5,2,1,2,16,10
20141005-M-Beijing-F-Tomas_Berdych-Novak_Djokovic,2,B-DTM,13,0,0,0,0,7,6
20141005-M-Beijing-F-Tomas_Berdych-Novak_Djokovic,2,B-DTL,6,5,3,1,1,5,1
20141005-M-Beijing-F-Tomas_Berdych-Novak_Djokovic,2,B-IO,1,1,0,1,0,1,0
20141005-M-Beijing-F-Tomas_Berdych-Novak_Djokovic,2,S-XC,3,0,0,0,0,3,0
20141005-M-Beijing-F-Tomas_Berdych-Novak_Djokovic,2,S-DTM,1,0,0,0,0,0,1
20141005-M-Beijing-F-Tomas_Berdych-Novak_Djokovic,2,S-DTL,1,0,0,0,0,0,1
20141005-M-Beijing-F-Tomas_Berdych-Novak_Djokovic,2,S-IO,1,0,0,0,0,1,0
20140714-M-Bogota-QF-Jimmy_Wang-Ivo_Karlovic,1,F-XC,17,11,4,3,4,10,7
20140714-M-Bogota-QF-Jimmy_Wang-Ivo_Karlovic,1,F-DTM,4,1,0,0,1,2,2
20140714-M-Bogota-QF-Jimmy_Wang-Ivo_Karlovic,1,F-DTL,6,1,0,1,0,4,2
20140714-M-Bogota-QF-Jimmy_Wang-Ivo_Karlovic,1,F-IO,20,3,0,1,2,10,10
20140714-M-Bogota-QF-Jimmy_Wang-Ivo_Karlovic,1,B-XC,11,3,3,0,0,8,3
20140714-M-Bogota-QF-Jimmy_Wang-Ivo_Karlovic,1,B-DTM,5,1,0,0,1,3,2
20140714-M-Bogota-QF-Jimmy_Wang-Ivo_Karlovic,1,B-DTL,1,1,1,0,0,1,0
20140714-M-Bogota-QF-Jimmy_Wang-Ivo_Karlovic,1,S-XC,3,0,0,0,0,3,0
20140714-M-Bogota-QF-Jimmy_Wang-Ivo_Karlovic,1,S-DTM,2,0,0,0,0,1,1
20140714-M-Bogota-QF-Jimmy_Wang-Ivo_Karlovic,2,F-XC,4,2,1,0,1,2,2
20140714-M-Bogota-QF-Jimmy_Wang-Ivo_Karlovic,2,F-DTM,4,2,0,0,2,0,4
20140714-M-Bogota-QF-Jimmy_Wang-Ivo_Karlovic,2,F-DTL,3,2,1,0,1,2,1
20140714-M-Bogota-QF-Jimmy_Wang-Ivo_Karlovic,2,F-IO,4,2,1,1,0,2,2
20140714-M-Bogota-QF-Jimmy_Wang-Ivo_Karlovic,2,F-II,3,3,2,1,0,3,0
20140714-M-Bogota-QF-Jimmy_Wang-Ivo_Karlovic,2,B-XC,4,3,1,0,2,1,3
20140714-M-Bogota-QF-Jimmy_Wang-Ivo_Karlovic,2,B-DTL,5,4,1,1,2,3,2
20140714-M-Bogota-QF-Jimmy_Wang-Ivo_Karlovic,2,B-II,1,0,0,0,0,0,1
20140714-M-Bogota-QF-Jimmy_Wang-Ivo_Karlovic,2,S-XC,3,1,1,0,0,2,1
20140714-M-Bogota-QF-Jimmy_Wang-Ivo_Karlovic,2,S-DTM,13,0,0,0,0,3,10
20140714-M-Bogota-QF-Jimmy_Wang-Ivo_Karlovic,2,S-DTL,7,4,1,0,3,2,5
20140719-M-Bogota-SF-Bernard_Tomic-Victor_Estrella,1,F-XC,62,24,4,10,10,40,22
20140719-M-Bogota-SF-Bernard_Tomic-Victor_Estrella,1,F-DTM,23,4,0,0,4,9,14
20140719-M-Bogota-SF-Bernard_Tomic-Victor_Estrella,1,F-DTL,18,6,2,0,4,6,12
20140719-M-Bogota-SF-Bernard_Tomic-Victor_Estrella,1,F-IO,47,10,2,0,8,20,27
20140719-M-Bogota-SF-Bernard_Tomic-Victor_Estrella,1,F-II,4,2,0,2,0,2,2
20140719-M-Bogota-SF-Bernard_Tomic-Victor_Estrella,1,B-XC,23,5,2,0,3,12,11
20140719-M-Bogota-SF-Bernard_Tomic-Victor_Estrella,1,B-DTM,23,2,0,0,2,9,14
20140719-M-Bogota-SF-Bernard_Tomic-Victor_Estrella,1,B-DTL,12,7,1,1,5,4,8
20140719-M-Bogota-SF-Bernard_Tomic-Victor_Estrella,1,B-IO,2,0,0,0,0,1,1
20140719-M-Bogota-SF-Bernard_Tomic-Victor_Estrella,1,S-XC,36,3,0,0,3,20,16
20140719-M-Bogota-SF-Bernard_Tomic-Victor_Estrella,1,S-DTM,17,2,0,0,2,3,14
20140719-M-Bogota-SF-Bernard_Tomic-Victor_Estrella,1,S-DTL,17,1,0,0,1,10,7
20140719-M-Bogota-SF-Bernard_Tomic-Victor_Estrella,1,S-IO,6,1,0,0,1,4,2
20140719-M-Bogota-SF-Bernard_Tomic-Victor_Estrella,2,F-XC,65,18,7,4,7,37,28
20140719-M-Bogota-SF-Bernard_Tomic-Victor_Estrella,2,F-DTM,40,5,0,0,5,16,24
20140719-M-Bogota-SF-Bernard_Tomic-Victor_Estrella,2,F-DTL,15,2,0,0,2,5,10
20140719-M-Bogota-SF-Bernard_Tomic-Victor_Estrella,2,F-IO,61,21,6,7,8,36,25
20140719-M-Bogota-SF-Bernard_Tomic-Victor_Estrella,2,F-II,3,2,2,0,0,2,1
20140719-M-Bogota-SF-Bernard_Tomic-Victor_Estrella,2,B-XC,3,2,0,1,1,2,1
20140719-M-Bogota-SF-Bernard_Tomic-Victor_Estrella,2,B-DTM,1,1,0,1,0,1,0
20140719-M-Bogota-SF-Bernard_Tomic-Victor_Estrella,2,B-DTL,2,0,0,0,0,1,1
20140719-M-Bogota-SF-Bernard_Tomic-Victor_Estrella,2,S-XC,51,2,0,0,2,27,24
20140719-M-Bogota-SF-Bernard_Tomic-Victor_Estrella,2,S-DTM,40,5,0,1,4,16,24
20140719-M-Bogota-SF-Bernard_Tomic-Victor_Estrella,2,S-DTL,9,2,0,0,2,3,6
20140719-M-Bogota-SF-Bernard_Tomic-Victor_Estrella,2,S-II,1,0,0,0,0,1,0
20140720-M-Bogota-F-Bernard_Tomic-Ivo_Karlovic,1,F-XC,21,10,5,0,5,10,11
20140720-M-Bogota-F-Bernard_Tomic-Ivo_Karlovic,1,F-DTM,9,2,1,0,1,6,3
20140720-M-Bogota-F-Bernard_Tomic-Ivo_Karlovic,1,F-DTL,12,5,3,1,1,5,7
20140720-M-Bogota-F-Bernard_Tomic-Ivo_Karlovic,1,F-IO,22,4,3,1,0,14,8
20140720-M-Bogota-F-Bernard_Tomic-Ivo_Karlovic,1,F-II,2,1,0,0,1,0,2
20140720-M-Bogota-F-Bernard_Tomic-Ivo_Karlovic,1,B-XC,5,3,1,2,0,4,1
20140720-M-Bogota-F-Bernard_Tomic-Ivo_Karlovic,1,B-DTM,8,0,0,0,0,3,5
20140720-M-Bogota-F-Bernard_Tomic-Ivo_Karlovic,1,B-DTL,8,5,0,3,2,6,2
20140720-M-Bogota-F-Bernard_Tomic-Ivo_Karlovic,1,B-IO,3,2,2,0,0,3,0
20140720-M-Bogota-F-Bernard_Tomic-Ivo_Karlovic,1,B-II,1,0,0,0,0,0,1
20140720-M-Bogota-F-Bernard_Tomic-Ivo_Karlovic,1,S-XC,2,1,0,1,0,2,0
20140720-M-Bogota-F-Bernard_Tomic-Ivo_Karlovic,1,S-DTM,2,0,0,0,0,0,2
20140720-M-Bogota-F-Bernard_Tomic-Ivo_Karlovic,1,S-DTL,2,0,0,0,0,0,2
20140720-M-Bogota-F-Bernard_Tomic-Ivo_Karlovic,2,F-XC,12,6,3,2,1,8,4
20140720-M-Bogota-F-Bernard_Tomic-Ivo_Karlovic,2,F-DTM,2,1,0,0,1,1,1
20140720-M-Bogota-F-Bernard_Tomic-Ivo_Karlovic,2,F-DTL,6,5,0,0,5,0,6
20140720-M-Bogota-F-Bernard_Tomic-Ivo_Karlovic,2,F-IO,8,5,3,0,2,4,4
20140720-M-Bogota-F-Bernard_Tomic-Ivo_Karlovic,2,F-II,1,0,0,0,0,0,1
20140720-M-Bogota-F-Bernard_Tomic-Ivo_Karlovic,2,S-XC,7,0,0,0,0,5,2
20140720-M-Bogota-F-Bernard_Tomic-Ivo_Karlovic,2,S-DTM,8,1,0,0,1,3,5
20140720-M-Bogota-F-Bernard_Tomic-Ivo_Karlovic,2,S-DTL,7,2,1,0,1,4,3
20140720-M-Bogota-F-Bernard_Tomic-Ivo_Karlovic,2,S-IO,1,0,0,0,0,1,0
20140611-M-Caltanissetta_CH-R16-Marco_Cecchinato-Facundo_Bagnis,1,F-XC,42,10,4,0,6,17,25
20140611-M-Caltanissetta_CH-R16-Marco_Cecchinato-Facundo_Bagnis,1,F-DTM,27,3,0,0,3,12,15
20140611-M-Caltanissetta_CH-R16-Marco_Cecchinato-Facundo_Bagnis,1,F-DTL,1,1,0,0,1,0,1
20140611-M-Caltanissetta_CH-R16-Marco_Cecchinato-Facundo_Bagnis,1,F-IO,27,12,5,1,6,12,15
20140611-M-Caltanissetta_CH-R16-Marco_Cecchinato-Facundo_Bagnis,1,F-II,7,2,0,1,1,3,4
20140611-M-Caltanissetta_CH-R16-Marco_Cecchinato-Facundo_Bagnis,1,B-XC,18,4,1,2,1,13,5
20140611-M-Caltanissetta_CH-R16-Marco_Cecchinato-Facundo_Bagnis,1,B-DTM,27,3,0,1,2,12,15
20140611-M-Caltanissetta_CH-R16-Marco_Cecchinato-Facundo_Bagnis,1,B-DTL,9,0,0,0,0,5,4
20140611-M-Caltanissetta_CH-R16-Marco_Cecchinato-Facundo_Bagnis,1,B-IO,2,0,0,0,0,1,1
20140611-M-Caltanissetta_CH-R16-Marco_Cecchinato-Facundo_Bagnis,1,S-XC,4,2,0,0,2,0,4
20140611-M-Caltanissetta_CH-R16-Marco_Cecchinato-Facundo_Bagnis,1,S-DTM,5,1,0,0,1,2,3
20140611-M-Caltanissetta_CH-R16-Marco_Cecchinato-Facundo_Bagnis,1,S-DTL,6,1,0,0,1,0,6
20140611-M-Caltanissetta_CH-R16-Marco_Cecchinato-Facundo_Bagnis,1,S-IO,1,0,0,0,0,1,0
20140611-M-Caltanissetta_CH-R16-Marco_Cecchinato-Facundo_Bagnis,2,F-XC,53,11,1,3,7,31,22
20140611-M-Caltanissetta_CH-R16-Marco_Cecchinato-Facundo_Bagnis,2,F-DTM,32,5,0,0,5,16,16
20140611-M-Caltanissetta_CH-R16-Marco_Cecchinato-Facundo_Bagnis,2,F-DTL,6,3,1,1,1,3,3
20140611-M-Caltanissetta_CH-R16-Marco_Cecchinato-Facundo_Bagnis,2,F-IO,6,5,0,2,3,2,4
20140611-M-Caltanissetta_CH-R16-Marco_Cecchinato-Facundo_Bagnis,2,F-II,4,0,0,0,0,2,2
20140611-M-Caltanissetta_CH-R16-Marco_Cecchinato-Facundo_Bagnis,2,B-XC,26,14,2,2,10,15,11
20140611-M-Caltanissetta_CH-R16-Marco_Cecchinato-Facundo_Bagnis,2,B-DTM,21,0,0,0,0,13,8
20140611-M-Caltanissetta_CH-R16-Marco_Cecchinato-Facundo_Bagnis,2,B-DTL,14,3,2,0,1,10,4
20140611-M-Caltanissetta_CH-R16-Marco_Cecchinato-Facundo_Bagnis,2,B-IO,11,3,0,0,3,2,9
20140611-M-Caltanissetta_CH-R16-Marco_Cecchinato-Facundo_Bagnis,2,S-DTM,2,0,0,0,0,1,1
20140611-M-Caltanissetta_CH-R16-Marco_Cecchinato-Facundo_Bagnis,2,S-DTL,7,0,0,0,0,3,4
20140611-M-Caltanissetta_CH-R16-Marco_Cecchinato-Facundo_Bagnis,2,S-IO,1,0,0,0,0,1,0
20140804-M-Canada_Masters-R64-Peter_Polansky-Jerzy_Janowicz,1,F-XC,37,3,0,1,2,24,13
20140804-M-Canada_Masters-R64-Peter_Polansky-Jerzy_Janowicz,1,F-DTM,43,2,0,0,2,22,21
20140804-M-Canada_Masters-R64-Peter_Polansky-Jerzy_Janowicz,1,F-DTL,5,2,0,0,2,1,4
20140804-M-Canada_Masters-R64-Peter_Polansky-Jerzy_Janowicz,1,F-IO,14,1,0,0,1,10,4
20140804-M-Canada_Masters-R64-Peter_Polansky-Jerzy_Janowicz,1,F-II,1,0,0,0,0,1,0
20140804-M-Canada_Masters-R64-Peter_Polansky-Jerzy_Janowicz,1,B-XC,18,1,1,0,0,11,7
20140804-M-Canada_Masters-R64-Peter_Polansky-Jerzy_Janowicz,1,B-DTM,26,3,0,0,3,9,17
20140804-M-Canada_Masters-R64-Peter_Polansky-Jerzy_Janowicz,1,B-DTL,1,0,0,0,0,1,0
20140804-M-Canada_Masters-R64-Peter_Polansky-Jerzy_Janowicz,1,B-IO,1,1,1,0,0,1,0
20140804-M-Canada_Masters-R64-Peter_Polansky-Jerzy_Janowicz,1,S-XC,5,0,0,0,0,2,3
20140804-M-Canada_Masters-R64-Peter_Polansky-Jerzy_Janowicz,1,S-DTM,5,0,0,0,0,3,2
20140804-M-Canada_Masters-R64-Peter_Polansky-Jerzy_Janowicz,1,S-DTL,1,0,0,0,0,0,1
20140804-M-Canada_Masters-R64-Peter_Polansky-Jerzy_Janowicz,2,F-XC,43,13,5,0,8,21,22
20140804-M-Canada_Masters-R64-Peter_Polansky-Jerzy_Janowicz,2,F-DTM,23,3,0,0,3,10,13
20140804-M-Canada_Masters-R64-Peter_Polansky-Jerzy_Janowicz,2,F-DTL,9,5,1,1,3,4,5
20140804-M-Canada_Masters-R64-Peter_Polansky-Jerzy_Janowicz,2,F-IO,30,11,2,5,4,18,12
20140804-M-Canada_Masters-R64-Peter_Polansky-Jerzy_Janowicz,2,F-II,2,2,0,1,1,1,1
20140804-M-Canada_Masters-R64-Peter_Polansky-Jerzy_Janowicz,2,B-XC,20,2,0,0,2,8,12
20140804-M-Canada_Masters-R64-Peter_Polansky-Jerzy_Janowicz,2,B-DTM,24,4,0,0,4,8,16
20140804-M-Canada_Masters-R64-Peter_Polansky-Jerzy_Janowicz,2,B-DTL,3,3,2,0,1,2,1
20140804-M-Canada_Masters-R64-Peter_Polansky-Jerzy_Janowicz,2,B-IO,5,2,0,0,2,1,4
20140804-M-Canada_Masters-R64-Peter_Polansky-Jerzy_Janowicz,2,S-XC,3,0,0,0,0,0,3
20140804-M-Canada_Masters-R64-Peter_Polansky-Jerzy_Janowicz,2,S-DTM,1,0,0,0,0,1,0
20140805-M-Canada_Masters-R64-Donald_Young-Frank_Dancevic,1,F-XC,46,9,2,2,5,27,19
20140805-M-Canada_Masters-R64-Donald_Young-Frank_Dancevic,1,F-DTM,31,7,0,0,7,13,18
20140805-M-Canada_Masters-R64-Donald_Young-Frank_Dancevic,1,F-DTL,7,2,1,0,1,5,2
20140805-M-Canada_Masters-R64-Donald_Young-Frank_Dancevic,1,F-IO,22,8,6,0,2,16,6
20140805-M-Canada_Masters-R64-Donald_Young-Frank_Dancevic,1,F-II,1,0,0,0,0,1,0
20140805-M-Canada_Masters-R64-Donald_Young-Frank_Dancevic,1,B-XC,12,4,1,2,1,11,1
20140805-M-Canada_Masters-R64-Donald_Young-Frank_Dancevic,1,B-DTM,24,2,0,0,2,15,9
20140805-M-Canada_Masters-R64-Donald_Young-Frank_Dancevic,1,B-DTL,7,3,0,1,2,5,2
20140805-M-Canada_Masters-R64-Donald_Young-Frank_Dancevic,1,B-IO,8,0,0,0,0,2,6
20140805-M-Canada_Masters-R64-Donald_Young-Frank_Dancevic,1,S-DTM,6,2,0,1,1,3,3
20140805-M-Canada_Masters-R64-Donald_Young-Frank_Dancevic,1,S-DTL,1,0,0,0,0,1,0
20140805-M-Canada_Masters-R64-Donald_Young-Frank_Dancevic,2,F-XC,37,6,1,2,3,11,26
20140805-M-Canada_Masters-R64-Donald_Young-Frank_Dancevic,2,F-DTM,22,4,0,0,4,8,14
20140805-M-Canada_Masters-R64-Donald_Young-Frank_Dancevic,2,F-DTL,4,2,0,0,2,0,4
20140805-M-Canada_Masters-R64-Donald_Young-Frank_Dancevic,2,F-IO,26,11,4,2,5,16,10
20140805-M-Canada_Masters-R64-Donald_Young-Frank_Dancevic,2,F-II,2,1,0,0,1,1,1
20140805-M-Canada_Masters-R64-Donald_Young-Frank_Dancevic,2,B-XC,30,6,0,0,6,10,20
20140805-M-Canada_Masters-R64-Donald_Young-Frank_Dancevic,2,B-DTM,22,1,0,0,1,10,12
20140805-M-Canada_Masters-R64-Donald_Young-Frank_Dancevic,2,B-DTL,6,3,0,1,2,2,4
20140805-M-Canada_Masters-R64-Donald_Young-Frank_Dancevic,2,B-IO,3,2,0,0,2,0,3
20140805-M-Canada_Masters-R64-Donald_Young-Frank_Dancevic,2,S-XC,8,1,0,0,1,1,7
20140805-M-Canada_Masters-R64-Donald_Young-Frank_Dancevic,2,S-DTM,2,0,0,0,0,0,2
20140805-M-Canada_Masters-R64-Donald_Young-Frank_Dancevic,2,S-IO,4,1,0,1,0,1,3
20140805-M-Canada_Masters-R32-Peter_Polansky-Roger_Federer,1,F-XC,26,10,1,2,7,12,14
20140805-M-Canada_Masters-R32-Peter_Polansky-Roger_Federer,1,F-DTM,12,0,0,0,0,5,7
20140805-M-Canada_Masters-R32-Peter_Polansky-Roger_Federer,1,F-DTL,4,0,0,0,0,1,3
20140805-M-Canada_Masters-R32-Peter_Polansky-Roger_Federer,1,F-IO,7,3,1,0,2,3,4
20140805-M-Canada_Masters-R32-Peter_Polansky-Roger_Federer,1,F-II,2,1,0,0,1,0,2
20140805-M-Canada_Masters-R32-Peter_Polansky-Roger_Federer,1,B-XC,13,2,0,0,2,7,6
20140805-M-Canada_Masters-R32-Peter_Polansky-Roger_Federer,1,B-DTM,23,1,0,0,1,7,16
20140805-M-Canada_Masters-R32-Peter_Polansky-Roger_Federer,1,B-DTL,5,2,0,0,2,0,5
20140805-M-Canada_Masters-R32-Peter_Polansky-Roger_Federer,1,B-IO,1,0,0,0,0,1,0
20140805-M-Canada_Masters-R32-Peter_Polansky-Roger_Federer,1,S-XC,1,0,0,0,0,1,0
20140805-M-Canada_Masters-R32-Peter_Polansky-Roger_Federer,2,F-XC,25,8,6,2,0,18,7
20140805-M-Canada_Masters-R32-Peter_Polansky-Roger_Federer,2,F-DTM,14,4,0,0,4,4,10
20140805-M-Canada_Masters-R32-Peter_Polansky-Roger_Federer,2,F-DTL,4,0,0,0,0,1,3
20140805-M-Canada_Masters-R32-Peter_Polansky-Roger_Federer,2,F-IO,15,3,2,0,1,12,3
20140805-M-Canada_Masters-R32-Peter_Polansky-Roger_Federer,2,F-II,1,1,0,0,1,0,1
20140805-M-Canada_Masters-R32-Peter_Polansky-Roger_Federer,2,B-XC,10,4,1,1,2,6,4
20140805-M-Canada_Masters-R32-Peter_Polansky-Roger_Federer,2,B-DTM,6,1,0,0,1,3,3
20140805-M-Canada_Masters-R32-Peter_Polansky-Roger_Federer,2,B-DTL,2,0,0,0,0,0,2
20140805-M-Canada_Masters-R32-Peter_Polansky-Roger_Federer,2,S-XC,3,1,0,0,1,1,2
20140805-M-Canada_Masters-R32-Peter_Polansky-Roger_Federer,2,S-DTM,2,0,0,0,0,1,1
20140805-M-Canada_Masters-R32-Peter_Polansky-Roger_Federer,2,S-IO,1,1,0,0,1,0,1
20140810-M-Canada_Masters-F-Jo_Wilfried_Tsonga-Roger_Federer,1,F-XC,17,6,3,2,1,13,4
20140810-M-Canada_Masters-F-Jo_Wilfried_Tsonga-Roger_Federer,1,F-DTM,11,1,0,0,1,7,4
20140810-M-Canada_Masters-F-Jo_Wilfried_Tsonga-Roger_Federer,1,F-DTL,6,3,1,1,1,5,1
20140810-M-Canada_Masters-F-Jo_Wilfried_Tsonga-Roger_Federer,1,F-IO,18,5,2,1,2,12,6
20140810-M-Canada_Masters-F-Jo_Wilfried_Tsonga-Roger_Federer,1,B-XC,18,2,1,0,1,4,14
20140810-M-Canada_Masters-F-Jo_Wilfried_Tsonga-Roger_Federer,1,B-DTM,16,3,0,2,1,12,4
20140810-M-Canada_Masters-F-Jo_Wilfried_Tsonga-Roger_Federer,1,B-DTL,14,4,1,1,2,7,7
20140810-M-Canada_Masters-F-Jo_Wilfried_Tsonga-Roger_Federer,1,B-IO,2,1,0,0,1,1,1
20140810-M-Canada_Masters-F-Jo_Wilfried_Tsonga-Roger_Federer,1,S-XC,3,0,0,0,0,2,1
20140810-M-Canada_Masters-F-Jo_Wilfried_Tsonga-Roger_Federer,1,S-DTM,4,0,0,0,0,1,3
20140810-M-Canada_Masters-F-Jo_Wilfried_Tsonga-Roger_Federer,1,S-DTL,3,1,0,1,0,1,2
20140810-M-Canada_Masters-F-Jo_Wilfried_Tsonga-Roger_Federer,2,F-XC,32,17,4,4,9,13,19
20140810-M-Canada_Masters-F-Jo_Wilfried_Tsonga-Roger_Federer,2,F-DTM,16,4,1,1,2,3,13
20140810-M-Canada_Masters-F-Jo_Wilfried_Tsonga-Roger_Federer,2,F-DTL,5,2,0,0,2,2,3
20140810-M-Canada_Masters-F-Jo_Wilfried_Tsonga-Roger_Federer,2,F-IO,28,9,3,2,4,15,13
20140810-M-Canada_Masters-F-Jo_Wilfried_Tsonga-Roger_Federer,2,F-II,2,2,1,1,0,2,0
20140810-M-Canada_Masters-F-Jo_Wilfried_Tsonga-Roger_Federer,2,B-XC,16,4,0,1,3,7,9
20140810-M-Canada_Masters-F-Jo_Wilfried_Tsonga-Roger_Federer,2,B-DTM,14,5,0,1,4,5,9
20140810-M-Canada_Masters-F-Jo_Wilfried_Tsonga-Roger_Federer,2,B-DTL,6,5,0,1,4,2,4
20140810-M-Canada_Masters-F-Jo_Wilfried_Tsonga-Roger_Federer,2,B-IO,2,2,0,0,2,0,2
20140810-M-Canada_Masters-F-Jo_Wilfried_Tsonga-Roger_Federer,2,S-XC,2,0,0,0,0,1,1
20140810-M-Canada_Masters-F-Jo_Wilfried_Tsonga-Roger_Federer,2,S-DTM,2,0,0,0,0,0,2
20140807-M-Canada_Masters-R16-Novak_Djokovic-Jo_Wilfried_Tsonga,1,F-XC,20,6,2,1,3,9,11
20140807-M-Canada_Masters-R16-Novak_Djokovic-Jo_Wilfried_Tsonga,1,F-DTM,8,0,0,0,0,4,4
20140807-M-Canada_Masters-R16-Novak_Djokovic-Jo_Wilfried_Tsonga,1,F-DTL,14,1,0,1,0,7,7
20140807-M-Canada_Masters-R16-Novak_Djokovic-Jo_Wilfried_Tsonga,1,F-IO,14,4,1,1,2,8,6
20140807-M-Canada_Masters-R16-Novak_Djokovic-Jo_Wilfried_Tsonga,1,F-II,1,0,0,0,0,1,0
20140807-M-Canada_Masters-R16-Novak_Djokovic-Jo_Wilfried_Tsonga,1,B-XC,19,5,0,0,5,4,15
20140807-M-Canada_Masters-R16-Novak_Djokovic-Jo_Wilfried_Tsonga,1,B-DTM,9,1,0,0,1,4,5
20140807-M-Canada_Masters-R16-Novak_Djokovic-Jo_Wilfried_Tsonga,1,B-DTL,5,2,1,1,0,3,2
20140807-M-Canada_Masters-R16-Novak_Djokovic-Jo_Wilfried_Tsonga,1,B-IO,6,0,0,0,0,3,3
20140807-M-Canada_Masters-R16-Novak_Djokovic-Jo_Wilfried_Tsonga,1,S-XC,2,1,0,0,1,1,1
20140807-M-Canada_Masters-R16-Novak_Djokovic-Jo_Wilfried_Tsonga,1,S-DTM,4,0,0,0,0,2,2
20140807-M-Canada_Masters-R16-Novak_Djokovic-Jo_Wilfried_Tsonga,1,S-DTL,2,1,0,0,1,1,1
20140807-M-Canada_Masters-R16-Novak_Djokovic-Jo_Wilfried_Tsonga,2,F-XC,19,6,2,2,2,11,8
20140807-M-Canada_Masters-R16-Novak_Djokovic-Jo_Wilfried_Tsonga,2,F-DTM,6,0,0,0,0,2,4
20140807-M-Canada_Masters-R16-Novak_Djokovic-Jo_Wilfried_Tsonga,2,F-DTL,6,3,0,1,2,4,2
20140807-M-Canada_Masters-R16-Novak_Djokovic-Jo_Wilfried_Tsonga,2,F-IO,17,5,2,1,2,10,7
20140807-M-Canada_Masters-R16-Novak_Djokovic-Jo_Wilfried_Tsonga,2,F-II,2,0,0,0,0,1,1
20140807-M-Canada_Masters-R16-Novak_Djokovic-Jo_Wilfried_Tsonga,2,B-XC,13,4,1,0,3,7,6
20140807-M-Canada_Masters-R16-Novak_Djokovic-Jo_Wilfried_Tsonga,2,B-DTM,14,2,0,0,2,6,8
20140807-M-Canada_Masters-R16-Novak_Djokovic-Jo_Wilfried_Tsonga,2,B-DTL,3,1,0,0,1,1,2
20140807-M-Canada_Masters-R16-Novak_Djokovic-Jo_Wilfried_Tsonga,2,S-XC,10,0,0,0,0,6,4
20140807-M-Canada_Masters-R16-Novak_Djokovic-Jo_Wilfried_Tsonga,2,S-DTM,6,2,0,0,2,2,4
20140807-M-Canada_Masters-R16-Novak_Djokovic-Jo_Wilfried_Tsonga,2,S-DTL,2,0,0,0,0,1,1
20140807-M-Canada_Masters-R16-Novak_Djokovic-Jo_Wilfried_Tsonga,2,S-IO,1,0,0,0,0,1,0
20141111-M-Champaign_CH-R32-Jared_Donaldson-Alex_Kuznetsov,1,F-XC,23,8,3,3,2,15,8
20141111-M-Champaign_CH-R32-Jared_Donaldson-Alex_Kuznetsov,1,F-DTM,11,0,0,0,0,5,6
20141111-M-Champaign_CH-R32-Jared_Donaldson-Alex_Kuznetsov,1,F-DTL,8,2,0,1,1,5,3
20141111-M-Champaign_CH-R32-Jared_Donaldson-Alex_Kuznetsov,1,F-IO,9,2,2,0,0,9,0
20141111-M-Champaign_CH-R32-Jared_Donaldson-Alex_Kuznetsov,1,F-II,2,0,0,0,0,1,1
20141111-M-Champaign_CH-R32-Jared_Donaldson-Alex_Kuznetsov,1,B-XC,23,3,0,1,2,15,8
20141111-M-Champaign_CH-R32-Jared_Donaldson-Alex_Kuznetsov,1,B-DTM,14,2,0,0,2,5,9
20141111-M-Champaign_CH-R32-Jared_Donaldson-Alex_Kuznetsov,1,B-DTL,6,3,2,1,0,6,0
20141111-M-Champaign_CH-R32-Jared_Donaldson-Alex_Kuznetsov,1,B-IO,3,0,0,0,0,3,0
20141111-M-Champaign_CH-R32-Jared_Donaldson-Alex_Kuznetsov,1,S-DTM,1,0,0,0,0,0,1
20141111-M-Champaign_CH-R32-Jared_Donaldson-Alex_Kuznetsov,2,F-XC,31,13,2,0,11,12,19
20141111-M-Champaign_CH-R32-Jared_Donaldson-Alex_Kuznetsov,2,F-DTM,6,0,0,0,0,3,3
20141111-M-Champaign_CH-R32-Jared_Donaldson-Alex_Kuznetsov,2,F-DTL,9,3,1,0,2,5,4
20141111-M-Champaign_CH-R32-Jared_Donaldson-Alex_Kuznetsov,2,F-IO,15,7,2,0,5,6,9
20141111-M-Champaign_CH-R32-Jared_Donaldson-Alex_Kuznetsov,2,F-II,1,1,0,0,1,0,1
20141111-M-Champaign_CH-R32-Jared_Donaldson-Alex_Kuznetsov,2,B-XC,13,3,0,1,2,4,9
20141111-M-Champaign_CH-R32-Jared_Donaldson-Alex_Kuznetsov,2,B-DTM,11,1,0,0,1,3,8
20141111-M-Champaign_CH-R32-Jared_Donaldson-Alex_Kuznetsov,2,B-DTL,4,2,2,0,0,2,2
20141111-M-Champaign_CH-R32-Jared_Donaldson-Alex_Kuznetsov,2,B-IO,2,2,0,0,2,0,2
20141111-M-Champaign_CH-R32-Jared_Donaldson-Alex_Kuznetsov,2,S-XC,6,1,0,0,1,2,4
20141111-M-Champaign_CH-R32-Jared_Donaldson-Alex_Kuznetsov,2,S-DTM,3,0,0,0,0,1,2
20141111-M-Champaign_CH-R32-Jared_Donaldson-Alex_Kuznetsov,2,S-DTL,2,1,0,0,1,1,1
20141103-M-Charlottesville_CH-F-Liam_Broady-James_Duckworth,1,F-XC,69,11,2,2,7,37,32
20141103-M-Charlottesville_CH-F-Liam_Broady-James_Duckworth,1,F-DTM,47,3,0,0,3,25,22
20141103-M-Charlottesville_CH-F-Liam_Broady-James_Duckworth,1,F-DTL,7,3,2,0,1,4,3
20141103-M-Charlottesville_CH-F-Liam_Broady-James_Duckworth,1,F-IO,14,6,4,1,1,9,5
20141103-M-Charlottesville_CH-F-Liam_Broady-James_Duckworth,1,F-II,1,0,0,0,0,1,0
20141103-M-Charlottesville_CH-F-Liam_Broady-James_Duckworth,1,B-XC,38,6,2,3,1,22,16
20141103-M-Charlottesville_CH-F-Liam_Broady-James_Duckworth,1,B-DTM,23,3,0,0,3,16,7
20141103-M-Charlottesville_CH-F-Liam_Broady-James_Duckworth,1,B-DTL,18,7,1,2,4,9,9
20141103-M-Charlottesville_CH-F-Liam_Broady-James_Duckworth,1,B-IO,15,5,3,0,2,8,7
20141103-M-Charlottesville_CH-F-Liam_Broady-James_Duckworth,1,S-XC,2,1,0,1,0,2,0
20141103-M-Charlottesville_CH-F-Liam_Broady-James_Duckworth,1,S-DTL,2,1,0,1,0,2,0
20141103-M-Charlottesville_CH-F-Liam_Broady-James_Duckworth,1,S-IO,3,0,0,0,0,1,2
20141103-M-Charlottesville_CH-F-Liam_Broady-James_Duckworth,2,F-XC,57,10,2,6,2,28,29
20141103-M-Charlottesville_CH-F-Liam_Broady-James_Duckworth,2,F-DTM,22,2,0,0,2,11,11
20141103-M-Charlottesville_CH-F-Liam_Broady-James_Duckworth,2,F-DTL,13,4,2,1,1,6,7
20141103-M-Charlottesville_CH-F-Liam_Broady-James_Duckworth,2,F-IO,11,5,2,1,2,4,7
20141103-M-Charlottesville_CH-F-Liam_Broady-James_Duckworth,2,B-XC,51,18,6,3,9,24,27
20141103-M-Charlottesville_CH-F-Liam_Broady-James_Duckworth,2,B-DTM,43,3,0,0,3,18,25
20141103-M-Charlottesville_CH-F-Liam_Broady-James_Duckworth,2,B-DTL,7,6,2,0,4,2,5
20141103-M-Charlottesville_CH-F-Liam_Broady-James_Duckworth,2,B-IO,4,2,1,1,0,3,1
20141103-M-Charlottesville_CH-F-Liam_Broady-James_Duckworth,2,S-XC,8,0,0,0,0,7,1
20141103-M-Charlottesville_CH-F-Liam_Broady-James_Duckworth,2,S-DTM,10,3,0,0,3,1,9
20141103-M-Charlottesville_CH-F-Liam_Broady-James_Duckworth,2,S-DTL,6,1,0,0,1,2,4
20141103-M-Charlottesville_CH-F-Liam_Broady-James_Duckworth,2,S-IO,4,0,0,0,0,0,4
20140728-M-Washington-R64-Francis_Tiafoe-Evgeny_Donskoy,1,F-XC,23,11,3,1,7,10,13
20140728-M-Washington-R64-Francis_Tiafoe-Evgeny_Donskoy,1,F-DTM,24,1,0,0,1,11,13
20140728-M-Washington-R64-Francis_Tiafoe-Evgeny_Donskoy,1,F-DTL,5,1,1,0,0,3,2
20140728-M-Washington-R64-Francis_Tiafoe-Evgeny_Donskoy,1,F-IO,23,10,3,0,7,14,9
20140728-M-Washington-R64-Francis_Tiafoe-Evgeny_Donskoy,1,F-II,1,1,0,0,1,0,1
20140728-M-Washington-R64-Francis_Tiafoe-Evgeny_Donskoy,1,B-XC,34,3,1,0,2,21,13
20140728-M-Washington-R64-Francis_Tiafoe-Evgeny_Donskoy,1,B-DTM,11,3,0,1,2,5,6
20140728-M-Washington-R64-Francis_Tiafoe-Evgeny_Donskoy,1,B-DTL,2,2,2,0,0,2,0
20140728-M-Washington-R64-Francis_Tiafoe-Evgeny_Donskoy,1,S-XC,5,0,0,0,0,5,0
20140728-M-Washington-R64-Francis_Tiafoe-Evgeny_Donskoy,1,S-DTM,2,0,0,0,0,1,1
20140728-M-Washington-R64-Francis_Tiafoe-Evgeny_Donskoy,1,S-DTL,1,0,0,0,0,1,0
20140728-M-Washington-R64-Francis_Tiafoe-Evgeny_Donskoy,2,F-XC,23,4,1,2,1,11,12
20140728-M-Washington-R64-Francis_Tiafoe-Evgeny_Donskoy,2,F-DTM,22,1,1,0,0,13,9
20140728-M-Washington-R64-Francis_Tiafoe-Evgeny_Donskoy,2,F-DTL,5,4,1,1,2,2,3
20140728-M-Washington-R64-Francis_Tiafoe-Evgeny_Donskoy,2,F-IO,28,12,6,1,5,13,15
20140728-M-Washington-R64-Francis_Tiafoe-Evgeny_Donskoy,2,F-II,2,1,0,0,1,1,1
20140728-M-Washington-R64-Francis_Tiafoe-Evgeny_Donskoy,2,B-XC,24,2,0,0,2,8,16
20140728-M-Washington-R64-Francis_Tiafoe-Evgeny_Donskoy,2,B-DTM,19,1,0,0,1,8,11
20140728-M-Washington-R64-Francis_Tiafoe-Evgeny_Donskoy,2,B-DTL,4,1,0,0,1,1,3
20140728-M-Washington-R64-Francis_Tiafoe-Evgeny_Donskoy,2,S-XC,5,2,0,0,2,1,4
20140728-M-Washington-R64-Francis_Tiafoe-Evgeny_Donskoy,2,S-DTM,3,0,0,0,0,2,1
20140728-M-Washington-R64-Francis_Tiafoe-Evgeny_Donskoy,2,S-IO,2,2,1,1,0,2,0
20140729-M-Washington-R64-Sam_Querrey-Michael_Russell,1,F-XC,21,10,4,1,5,8,13
20140729-M-Washington-R64-Sam_Querrey-Michael_Russell,1,F-DTM,13,2,1,0,1,8,5
20140729-M-Washington-R64-Sam_Querrey-Michael_Russell,1,F-DTL,2,0,0,0,0,2,0
20140729-M-Washington-R64-Sam_Querrey-Michael_Russell,1,F-IO,10,3,2,0,1,3,7
20140729-M-Washington-R64-Sam_Querrey-Michael_Russell,1,F-II,8,5,2,0,3,4,4
20140729-M-Washington-R64-Sam_Querrey-Michael_Russell,1,B-XC,35,9,4,1,4,16,19
20140729-M-Washington-R64-Sam_Querrey-Michael_Russell,1,B-DTM,17,4,0,1,3,8,9
20140729-M-Washington-R64-Sam_Querrey-Michael_Russell,1,B-DTL,7,6,2,0,4,2,5
20140729-M-Washington-R64-Sam_Querrey-Michael_Russell,1,B-IO,3,0,0,0,0,3,0
20140729-M-Washington-R64-Sam_Querrey-Michael_Russell,1,S-XC,4,0,0,0,0,2,2
20140729-M-Washington-R64-Sam_Querrey-Michael_Russell,1,S-DTM,3,0,0,0,0,3,0
20140729-M-Washington-R64-Sam_Querrey-Michael_Russell,1,S-DTL,1,0,0,0,0,1,0
20140729-M-Washington-R64-Sam_Querrey-Michael_Russell,2,F-XC,21,7,1,1,5,9,12
20140729-M-Washington-R64-Sam_Querrey-Michael_Russell,2,F-DTM,16,0,0,0,0,10,6
20140729-M-Washington-R64-Sam_Querrey-Michael_Russell,2,F-DTL,4,1,1,0,0,2,2
20140729-M-Washington-R64-Sam_Querrey-Michael_Russell,2,F-IO,21,6,1,0,5,11,10
20140729-M-Washington-R64-Sam_Querrey-Michael_Russell,2,F-II,3,2,1,0,1,1,2
20140729-M-Washington-R64-Sam_Querrey-Michael_Russell,2,B-XC,39,4,1,1,2,25,14
20140729-M-Washington-R64-Sam_Querrey-Michael_Russell,2,B-DTM,13,3,0,1,2,7,6
20140729-M-Washington-R64-Sam_Querrey-Michael_Russell,2,B-DTL,3,2,1,0,1,1,2
20140729-M-Washington-R64-Sam_Querrey-Michael_Russell,2,S-XC,7,1,0,1,0,1,6
20140729-M-Washington-R64-Sam_Querrey-Michael_Russell,2,S-DTM,1,0,0,0,0,0,1
20140729-M-Washington-R64-Sam_Querrey-Michael_Russell,2,S-DTL,1,1,1,0,0,1,0
20150106-M-Doha-R16-Tomas_Berdych-Blaz_Kavcic,1,F-XC,33,9,3,3,3,19,14
20150106-M-Doha-R16-Tomas_Berdych-Blaz_Kavcic,1,F-DTM,19,1,0,0,1,11,8
20150106-M-Doha-R16-Tomas_Berdych-Blaz_Kavcic,1,F-DTL,2,0,0,0,0,1,1
20150106-M-Doha-R16-Tomas_Berdych-Blaz_Kavcic,1,F-IO,17,6,2,1,3,7,10
20150106-M-Doha-R16-Tomas_Berdych-Blaz_Kavcic,1,B-XC,21,4,1,2,1,12,9
20150106-M-Doha-R16-Tomas_Berdych-Blaz_Kavcic,1,B-DTM,21,2,0,0,2,11,10
20150106-M-Doha-R16-Tomas_Berdych-Blaz_Kavcic,1,B-DTL,2,2,2,0,0,2,0
20150106-M-Doha-R16-Tomas_Berdych-Blaz_Kavcic,1,B-IO,5,2,1,0,1,2,3
20150106-M-Doha-R16-Tomas_Berdych-Blaz_Kavcic,1,S-XC,4,0,0,0,0,2,2
20150106-M-Doha-R16-Tomas_Berdych-Blaz_Kavcic,1,S-DTM,4,0,0,0,0,1,3
20150106-M-Doha-R16-Tomas_Berdych-Blaz_Kavcic,2,F-XC,19,4,2,1,1,8,11
20150106-M-Doha-R16-Tomas_Berdych-Blaz_Kavcic,2,F-DTM,33,0,0,0,0,15,18
20150106-M-Doha-R16-Tomas_Berdych-Blaz_Kavcic,2,F-DTL,4,1,1,0,0,3,1
20150106-M-Doha-R16-Tomas_Berdych-Blaz_Kavcic,2,F-IO,10,5,0,1,4,2,8
20150106-M-Doha-R16-Tomas_Berdych-Blaz_Kavcic,2,B-XC,12,1,0,0,1,5,7
20150106-M-Doha-R16-Tomas_Berdych-Blaz_Kavcic,2,B-DTM,24,3,0,1,2,14,10
20150106-M-Doha-R16-Tomas_Berdych-Blaz_Kavcic,2,B-DTL,2,0,0,0,0,1,1
20150106-M-Doha-R16-Tomas_Berdych-Blaz_Kavcic,2,B-IO,4,1,0,1,0,2,2
20150106-M-Doha-R16-Tomas_Berdych-Blaz_Kavcic,2,S-XC,1,0,0,0,0,0,1
20150106-M-Doha-R16-Tomas_Berdych-Blaz_Kavcic,2,S-DTM,10,0,0,0,0,7,3
20140611-M-Halle-R16-Robin_Haase-Alejandro_Falla,1,F-XC,28,7,2,2,3,10,18
20140611-M-Halle-R16-Robin_Haase-Alejandro_Falla,1,F-DTM,22,3,0,0,3,8,14
20140611-M-Halle-R16-Robin_Haase-Alejandro_Falla,1,F-DTL,9,6,2,1,3,3,6
20140611-M-Halle-R16-Robin_Haase-Alejandro_Falla,1,F-IO,20,6,1,0,5,11,9
20140611-M-Halle-R16-Robin_Haase-Alejandro_Falla,1,F-II,1,0,0,0,0,1,0
20140611-M-Halle-R16-Robin_Haase-Alejandro_Falla,1,B-XC,4,2,0,0,2,0,4
20140611-M-Halle-R16-Robin_Haase-Alejandro_Falla,1,B-DTM,28,2,0,1,1,6,22
20140611-M-Halle-R16-Robin_Haase-Alejandro_Falla,1,B-DTL,9,5,2,0,3,4,5
20140611-M-Halle-R16-Robin_Haase-Alejandro_Falla,1,B-IO,2,0,0,0,0,1,1
20140611-M-Halle-R16-Robin_Haase-Alejandro_Falla,1,S-XC,23,4,1,0,3,7,16
20140611-M-Halle-R16-Robin_Haase-Alejandro_Falla,1,S-DTM,14,0,0,0,0,2,12
20140611-M-Halle-R16-Robin_Haase-Alejandro_Falla,1,S-DTL,4,0,0,0,0,0,4
20140611-M-Halle-R16-Robin_Haase-Alejandro_Falla,1,S-IO,3,0,0,0,0,1,2
20140611-M-Halle-R16-Robin_Haase-Alejandro_Falla,2,F-XC,57,12,3,4,5,40,17
20140611-M-Halle-R16-Robin_Haase-Alejandro_Falla,2,F-DTM,17,4,1,1,2,7,10
20140611-M-Halle-R16-Robin_Haase-Alejandro_Falla,2,F-DTL,8,4,2,0,2,4,4
20140611-M-Halle-R16-Robin_Haase-Alejandro_Falla,2,F-IO,11,4,1,2,1,9,2
20140611-M-Halle-R16-Robin_Haase-Alejandro_Falla,2,F-II,2,0,0,0,0,2,0
20140611-M-Halle-R16-Robin_Haase-Alejandro_Falla,2,B-XC,30,5,1,3,1,25,5
20140611-M-Halle-R16-Robin_Haase-Alejandro_Falla,2,B-DTM,21,2,0,0,2,11,10
20140611-M-Halle-R16-Robin_Haase-Alejandro_Falla,2,B-DTL,9,3,2,0,1,5,4
20140611-M-Halle-R16-Robin_Haase-Alejandro_Falla,2,B-IO,9,2,1,0,1,7,2
20140611-M-Halle-R16-Robin_Haase-Alejandro_Falla,2,S-XC,3,1,0,1,0,3,0
20140611-M-Halle-R16-Robin_Haase-Alejandro_Falla,2,S-DTM,5,0,0,0,0,3,2
20140611-M-Halle-R16-Robin_Haase-Alejandro_Falla,2,S-IO,3,0,0,0,0,2,1
20140612-M-Halle-R16-Dustin_Brown-Rafael_Nadal,1,F-XC,2,1,0,1,0,2,0
20140612-M-Halle-R16-Dustin_Brown-Rafael_Nadal,1,F-DTM,1,1,0,1,0,1,0
20140612-M-Halle-R16-Dustin_Brown-Rafael_Nadal,1,F-DTL,1,1,0,0,1,0,1
20140612-M-Halle-R16-Dustin_Brown-Rafael_Nadal,1,F-IO,1,1,1,0,0,1,0
20140612-M-Halle-R16-Dustin_Brown-Rafael_Nadal,1,B-XC,1,1,0,0,1,0,1
20140612-M-Halle-R16-Dustin_Brown-Rafael_Nadal,1,B-DTM,1,1,0,1,0,1,0
20140612-M-Halle-R16-Dustin_Brown-Rafael_Nadal,1,B-DTL,1,0,0,0,0,1,0
20140612-M-Halle-R16-Dustin_Brown-Rafael_Nadal,2,F-XC,5,2,0,2,0,2,3
20140612-M-Halle-R16-Dustin_Brown-Rafael_Nadal,2,F-DTM,4,1,1,0,0,1,3
20140612-M-Halle-R16-Dustin_Brown-Rafael_Nadal,2,F-DTL,3,2,2,0,0,2,1
20140612-M-Halle-R16-Dustin_Brown-Rafael_Nadal,2,F-IO,3,2,0,1,1,2,1
20140612-M-Halle-R16-Dustin_Brown-Rafael_Nadal,2,F-II,2,1,0,1,0,1,1
20140612-M-Halle-R16-Dustin_Brown-Rafael_Nadal,2,B-XC,3,2,2,0,0,3,0
20140612-M-Halle-R16-Dustin_Brown-Rafael_Nadal,2,B-DTM,6,0,0,0,0,0,6
20140612-M-Halle-R16-Dustin_Brown-Rafael_Nadal,2,S-DTL,2,1,0,0,1,0,2
20140714-M-Hamburg-R64-Jan_Lennard_Struff-Filip_Krajinovic,1,F-XC,53,13,3,4,6,29,24
20140714-M-Hamburg-R64-Jan_Lennard_Struff-Filip_Krajinovic,1,F-DTM,27,7,0,0,7,10,17
20140714-M-Hamburg-R64-Jan_Lennard_Struff-Filip_Krajinovic,1,F-DTL,7,3,0,1,2,4,3
20140714-M-Hamburg-R64-Jan_Lennard_Struff-Filip_Krajinovic,1,F-IO,30,13,7,1,5,19,11
20140714-M-Hamburg-R64-Jan_Lennard_Struff-Filip_Krajinovic,1,F-II,3,1,0,0,1,2,1
20140714-M-Hamburg-R64-Jan_Lennard_Struff-Filip_Krajinovic,1,B-XC,51,11,3,3,5,20,31
20140714-M-Hamburg-R64-Jan_Lennard_Struff-Filip_Krajinovic,1,B-DTM,21,1,1,0,0,13,8
20140714-M-Hamburg-R64-Jan_Lennard_Struff-Filip_Krajinovic,1,B-DTL,14,8,3,1,4,8,6
20140714-M-Hamburg-R64-Jan_Lennard_Struff-Filip_Krajinovic,1,B-IO,11,8,6,1,1,9,2
20140714-M-Hamburg-R64-Jan_Lennard_Struff-Filip_Krajinovic,1,S-XC,1,0,0,0,0,1,0
20140714-M-Hamburg-R64-Jan_Lennard_Struff-Filip_Krajinovic,1,S-DTM,2,0,0,0,0,0,2
20140714-M-Hamburg-R64-Jan_Lennard_Struff-Filip_Krajinovic,1,S-DTL,1,0,0,0,0,0,1
20140714-M-Hamburg-R64-Jan_Lennard_Struff-Filip_Krajinovic,2,F-XC,34,5,0,2,3,16,18
20140714-M-Hamburg-R64-Jan_Lennard_Struff-Filip_Krajinovic,2,F-DTM,41,3,0,0,3,17,24
20140714-M-Hamburg-R64-Jan_Lennard_Struff-Filip_Krajinovic,2,F-DTL,9,5,2,1,2,4,5
20140714-M-Hamburg-R64-Jan_Lennard_Struff-Filip_Krajinovic,2,F-IO,17,2,1,1,0,10,7
20140714-M-Hamburg-R64-Jan_Lennard_Struff-Filip_Krajinovic,2,F-II,5,1,1,0,0,3,2
20140714-M-Hamburg-R64-Jan_Lennard_Struff-Filip_Krajinovic,2,B-XC,25,2,1,0,1,14,11
20140714-M-Hamburg-R64-Jan_Lennard_Struff-Filip_Krajinovic,2,B-DTM,32,5,0,1,4,16,16
20140714-M-Hamburg-R64-Jan_Lennard_Struff-Filip_Krajinovic,2,B-DTL,9,4,1,0,3,4,5
20140714-M-Hamburg-R64-Jan_Lennard_Struff-Filip_Krajinovic,2,B-IO,6,1,0,0,1,3,3
20140714-M-Hamburg-R64-Jan_Lennard_Struff-Filip_Krajinovic,2,S-XC,10,1,0,0,1,5,5
20140714-M-Hamburg-R64-Jan_Lennard_Struff-Filip_Krajinovic,2,S-DTM,7,0,0,0,0,3,4
20140714-M-Hamburg-R64-Jan_Lennard_Struff-Filip_Krajinovic,2,S-DTL,1,0,0,0,0,0,1
20141104-M-Knoxville_CH-R32-Jared_Donaldson-Daniel_Nguyen,1,F-XC,54,6,4,0,2,40,14
20141104-M-Knoxville_CH-R32-Jared_Donaldson-Daniel_Nguyen,1,F-DTM,22,1,0,0,1,13,9
20141104-M-Knoxville_CH-R32-Jared_Donaldson-Daniel_Nguyen,1,F-DTL,27,9,5,1,3,17,10
20141104-M-Knoxville_CH-R32-Jared_Donaldson-Daniel_Nguyen,1,F-IO,26,9,5,1,3,16,10
20141104-M-Knoxville_CH-R32-Jared_Donaldson-Daniel_Nguyen,1,F-II,2,0,0,0,0,1,1
20141104-M-Knoxville_CH-R32-Jared_Donaldson-Daniel_Nguyen,1,B-XC,32,7,3,1,3,18,14
20141104-M-Knoxville_CH-R32-Jared_Donaldson-Daniel_Nguyen,1,B-DTM,14,0,0,0,0,12,2
20141104-M-Knoxville_CH-R32-Jared_Donaldson-Daniel_Nguyen,1,B-DTL,8,5,1,1,3,5,3
20141104-M-Knoxville_CH-R32-Jared_Donaldson-Daniel_Nguyen,1,B-IO,5,1,0,1,0,4,1
20141104-M-Knoxville_CH-R32-Jared_Donaldson-Daniel_Nguyen,1,S-XC,2,0,0,0,0,1,1
20141104-M-Knoxville_CH-R32-Jared_Donaldson-Daniel_Nguyen,1,S-DTM,4,0,0,0,0,0,4
20141104-M-Knoxville_CH-R32-Jared_Donaldson-Daniel_Nguyen,1,S-DTL,2,0,0,0,0,1,1
20141104-M-Knoxville_CH-R32-Jared_Donaldson-Daniel_Nguyen,2,F-XC,59,12,0,3,9,17,42
20141104-M-Knoxville_CH-R32-Jared_Donaldson-Daniel_Nguyen,2,F-DTM,33,4,0,0,4,8,25
20141104-M-Knoxville_CH-R32-Jared_Donaldson-Daniel_Nguyen,2,F-DTL,4,0,0,0,0,3,1
20141104-M-Knoxville_CH-R32-Jared_Donaldson-Daniel_Nguyen,2,F-IO,26,10,1,3,6,14,12
20141104-M-Knoxville_CH-R32-Jared_Donaldson-Daniel_Nguyen,2,F-II,2,0,0,0,0,1,1
20141104-M-Knoxville_CH-R32-Jared_Donaldson-Daniel_Nguyen,2,B-XC,20,6,1,1,4,10,10
20141104-M-Knoxville_CH-R32-Jared_Donaldson-Daniel_Nguyen,2,B-DTM,12,1,0,0,1,3,9
20141104-M-Knoxville_CH-R32-Jared_Donaldson-Daniel_Nguyen,2,B-DTL,4,3,0,1,2,1,3
20141104-M-Knoxville_CH-R32-Jared_Donaldson-Daniel_Nguyen,2,S-XC,14,2,0,0,2,6,8
20141104-M-Knoxville_CH-R32-Jared_Donaldson-Daniel_Nguyen,2,S-DTM,6,0,0,0,0,1,5
20141104-M-Knoxville_CH-R32-Jared_Donaldson-Daniel_Nguyen,2,S-DTL,2,0,0,0,0,0,2
20141104-M-Knoxville_CH-R32-Jared_Donaldson-Daniel_Nguyen,2,S-IO,2,0,0,0,0,1,1
20141117-M-Lima_CH-F-Jason_Kubler-Guido_Pella,1,F-XC,58,11,3,4,4,30,28
20141117-M-Lima_CH-F-Jason_Kubler-Guido_Pella,1,F-DTM,5,0,0,0,0,1,4
20141117-M-Lima_CH-F-Jason_Kubler-Guido_Pella,1,F-DTL,17,7,3,1,3,8,9
20141117-M-Lima_CH-F-Jason_Kubler-Guido_Pella,1,F-IO,19,9,2,2,5,9,10
20141117-M-Lima_CH-F-Jason_Kubler-Guido_Pella,1,F-II,6,4,1,0,3,2,4
20141117-M-Lima_CH-F-Jason_Kubler-Guido_Pella,1,B-XC,18,6,2,0,4,6,12
20141117-M-Lima_CH-F-Jason_Kubler-Guido_Pella,1,B-DTM,12,0,0,0,0,5,7
20141117-M-Lima_CH-F-Jason_Kubler-Guido_Pella,1,B-DTL,17,4,0,1,3,3,14
20141117-M-Lima_CH-F-Jason_Kubler-Guido_Pella,1,B-IO,11,1,0,1,0,6,5
20141117-M-Lima_CH-F-Jason_Kubler-Guido_Pella,1,S-XC,1,0,0,0,0,0,1
20141117-M-Lima_CH-F-Jason_Kubler-Guido_Pella,1,S-DTM,6,1,0,0,1,1,5
20141117-M-Lima_CH-F-Jason_Kubler-Guido_Pella,1,S-DTL,8,2,0,0,2,2,6
20141117-M-Lima_CH-F-Jason_Kubler-Guido_Pella,1,S-IO,1,0,0,0,0,1,0
20141117-M-Lima_CH-F-Jason_Kubler-Guido_Pella,2,F-XC,30,5,3,0,2,24,6
20141117-M-Lima_CH-F-Jason_Kubler-Guido_Pella,2,F-DTM,13,0,0,0,0,8,5
20141117-M-Lima_CH-F-Jason_Kubler-Guido_Pella,2,F-DTL,17,3,1,0,2,9,8
20141117-M-Lima_CH-F-Jason_Kubler-Guido_Pella,2,F-IO,19,4,2,1,1,15,4
20141117-M-Lima_CH-F-Jason_Kubler-Guido_Pella,2,F-II,10,4,1,1,2,6,4
20141117-M-Lima_CH-F-Jason_Kubler-Guido_Pella,2,B-XC,28,8,0,5,3,15,13
20141117-M-Lima_CH-F-Jason_Kubler-Guido_Pella,2,B-DTM,26,0,0,0,0,9,17
20141117-M-Lima_CH-F-Jason_Kubler-Guido_Pella,2,B-DTL,17,1,0,1,0,12,5
20141117-M-Lima_CH-F-Jason_Kubler-Guido_Pella,2,B-IO,5,2,0,1,1,3,2
20141117-M-Lima_CH-F-Jason_Kubler-Guido_Pella,2,B-II,2,2,0,0,2,0,2
20141117-M-Lima_CH-F-Jason_Kubler-Guido_Pella,2,S-XC,2,1,0,0,1,0,2
20141117-M-Lima_CH-F-Jason_Kubler-Guido_Pella,2,S-DTL,6,1,0,0,1,4,2
20141117-M-Lima_CH-F-Jason_Kubler-Guido_Pella,2,S-II,1,0,0,0,0,1,0
20141019-M-Moscow-F-Roberto_Bautista_Agut-Marin_Cilic,1,F-XC,38,5,4,0,1,17,21
20141019-M-Moscow-F-Roberto_Bautista_Agut-Marin_Cilic,1,F-DTM,14,0,0,0,0,7,7
20141019-M-Moscow-F-Roberto_Bautista_Agut-Marin_Cilic,1,F-DTL,19,5,3,0,2,6,13
20141019-M-Moscow-F-Roberto_Bautista_Agut-Marin_Cilic,1,F-IO,33,5,1,3,1,22,11
20141019-M-Moscow-F-Roberto_Bautista_Agut-Marin_Cilic,1,F-II,4,0,0,0,0,2,2
20141019-M-Moscow-F-Roberto_Bautista_Agut-Marin_Cilic,1,B-XC,34,4,1,1,2,13,21
20141019-M-Moscow-F-Roberto_Bautista_Agut-Marin_Cilic,1,B-DTM,28,4,0,0,4,11,17
20141019-M-Moscow-F-Roberto_Bautista_Agut-Marin_Cilic,1,B-DTL,6,5,0,3,2,4,2
20141019-M-Moscow-F-Roberto_Bautista_Agut-Marin_Cilic,1,B-IO,3,2,1,0,1,1,2
20141019-M-Moscow-F-Roberto_Bautista_Agut-Marin_Cilic,1,S-XC,16,3,0,1,2,7,9
20141019-M-Moscow-F-Roberto_Bautista_Agut-Marin_Cilic,1,S-DTM,4,0,0,0,0,1,3
20141019-M-Moscow-F-Roberto_Bautista_Agut-Marin_Cilic,1,S-DTL,6,1,0,1,0,3,3
20141019-M-Moscow-F-Roberto_Bautista_Agut-Marin_Cilic,2,F-XC,39,7,2,0,5,23,16
20141019-M-Moscow-F-Roberto_Bautista_Agut-Marin_Cilic,2,F-DTM,17,2,1,0,1,12,5
20141019-M-Moscow-F-Roberto_Bautista_Agut-Marin_Cilic,2,F-DTL,8,0,0,0,0,4,4
20141019-M-Moscow-F-Roberto_Bautista_Agut-Marin_Cilic,2,F-IO,36,14,2,7,5,24,12
20141019-M-Moscow-F-Roberto_Bautista_Agut-Marin_Cilic,2,F-II,6,1,1,0,0,4,2
20141019-M-Moscow-F-Roberto_Bautista_Agut-Marin_Cilic,2,B-XC,51,2,0,1,1,28,23
20141019-M-Moscow-F-Roberto_Bautista_Agut-Marin_Cilic,2,B-DTM,25,5,1,1,3,9,16
20141019-M-Moscow-F-Roberto_Bautista_Agut-Marin_Cilic,2,B-DTL,7,4,2,0,2,5,2
20141019-M-Moscow-F-Roberto_Bautista_Agut-Marin_Cilic,2,B-IO,3,2,1,1,0,2,1
20141019-M-Moscow-F-Roberto_Bautista_Agut-Marin_Cilic,2,S-XC,4,0,0,0,0,3,1
20141019-M-Moscow-F-Roberto_Bautista_Agut-Marin_Cilic,2,S-DTM,2,0,0,0,0,1,1
20141019-M-Moscow-F-Roberto_Bautista_Agut-Marin_Cilic,2,S-DTL,1,0,0,0,0,0,1
20141019-M-Moscow-F-Roberto_Bautista_Agut-Marin_Cilic,2,S-IO,2,0,0,0,0,1,1
20141016-M-Moscow-R16-Milos_Raonic-Ricardas_Berankis,1,F-XC,17,9,1,3,5,8,9
20141016-M-Moscow-R16-Milos_Raonic-Ricardas_Berankis,1,F-DTM,19,2,0,0,2,5,14
20141016-M-Moscow-R16-Milos_Raonic-Ricardas_Berankis,1,F-DTL,3,2,1,0,1,2,1
20141016-M-Moscow-R16-Milos_Raonic-Ricardas_Berankis,1,F-IO,46,18,5,1,12,21,25
20141016-M-Moscow-R16-Milos_Raonic-Ricardas_Berankis,1,F-II,5,2,2,0,0,3,2
20141016-M-Moscow-R16-Milos_Raonic-Ricardas_Berankis,1,B-XC,17,4,1,1,2,6,11
20141016-M-Moscow-R16-Milos_Raonic-Ricardas_Berankis,1,B-DTM,13,3,0,0,3,6,7
20141016-M-Moscow-R16-Milos_Raonic-Ricardas_Berankis,1,B-IO,3,2,1,0,1,2,1
20141016-M-Moscow-R16-Milos_Raonic-Ricardas_Berankis,1,S-XC,12,1,0,0,1,1,11
20141016-M-Moscow-R16-Milos_Raonic-Ricardas_Berankis,1,S-DTM,2,1,0,1,0,2,0
20141016-M-Moscow-R16-Milos_Raonic-Ricardas_Berankis,2,F-XC,20,11,6,0,5,12,8
20141016-M-Moscow-R16-Milos_Raonic-Ricardas_Berankis,2,F-DTM,17,0,0,0,0,9,8
20141016-M-Moscow-R16-Milos_Raonic-Ricardas_Berankis,2,F-DTL,4,3,2,0,1,3,1
20141016-M-Moscow-R16-Milos_Raonic-Ricardas_Berankis,2,F-IO,19,3,0,1,2,11,8
20141016-M-Moscow-R16-Milos_Raonic-Ricardas_Berankis,2,F-II,1,0,0,0,0,1,0
20141016-M-Moscow-R16-Milos_Raonic-Ricardas_Berankis,2,B-XC,30,8,3,1,4,15,15
20141016-M-Moscow-R16-Milos_Raonic-Ricardas_Berankis,2,B-DTM,22,7,0,2,5,11,11
20141016-M-Moscow-R16-Milos_Raonic-Ricardas_Berankis,2,B-DTL,6,5,4,0,1,5,1
20141016-M-Moscow-R16-Milos_Raonic-Ricardas_Berankis,2,B-IO,4,3,2,0,1,3,1
20141016-M-Moscow-R16-Milos_Raonic-Ricardas_Berankis,2,S-XC,13,0,0,0,0,9,4
20141016-M-Moscow-R16-Milos_Raonic-Ricardas_Berankis,2,S-DTM,1,0,0,0,0,1,0
20141016-M-Moscow-R16-Milos_Raonic-Ricardas_Berankis,2,S-DTL,4,1,0,0,1,2,2
20141108-M-Mouilleron_CH-QF-Marsel_Ilhan-Borna_Coric,1,F-XC,71,16,6,4,6,41,30
20141108-M-Mouilleron_CH-QF-Marsel_Ilhan-Borna_Coric,1,F-DTM,23,1,0,0,1,17,6
20141108-M-Mouilleron_CH-QF-Marsel_Ilhan-Borna_Coric,1,F-DTL,5,3,0,1,2,1,4
20141108-M-Mouilleron_CH-QF-Marsel_Ilhan-Borna_Coric,1,F-IO,41,13,3,1,9,18,23
20141108-M-Mouilleron_CH-QF-Marsel_Ilhan-Borna_Coric,1,F-II,4,1,0,0,1,0,4
20141108-M-Mouilleron_CH-QF-Marsel_Ilhan-Borna_Coric,1,B-XC,35,2,0,1,1,15,20
20141108-M-Mouilleron_CH-QF-Marsel_Ilhan-Borna_Coric,1,B-DTM,28,2,0,0,2,9,19
20141108-M-Mouilleron_CH-QF-Marsel_Ilhan-Borna_Coric,1,B-DTL,3,1,0,0,1,0,3
20141108-M-Mouilleron_CH-QF-Marsel_Ilhan-Borna_Coric,1,B-IO,1,0,0,0,0,0,1
20141108-M-Mouilleron_CH-QF-Marsel_Ilhan-Borna_Coric,1,S-XC,26,1,0,0,1,14,12
20141108-M-Mouilleron_CH-QF-Marsel_Ilhan-Borna_Coric,1,S-DTM,11,0,0,0,0,7,4
20141108-M-Mouilleron_CH-QF-Marsel_Ilhan-Borna_Coric,1,S-DTL,2,1,1,0,0,1,1
20141108-M-Mouilleron_CH-QF-Marsel_Ilhan-Borna_Coric,2,F-XC,28,3,2,0,1,16,12
20141108-M-Mouilleron_CH-QF-Marsel_Ilhan-Borna_Coric,2,F-DTM,49,4,0,0,4,17,32
20141108-M-Mouilleron_CH-QF-Marsel_Ilhan-Borna_Coric,2,F-DTL,22,8,2,1,5,11,11
20141108-M-Mouilleron_CH-QF-Marsel_Ilhan-Borna_Coric,2,F-IO,41,5,1,0,4,21,20
20141108-M-Mouilleron_CH-QF-Marsel_Ilhan-Borna_Coric,2,F-II,4,0,0,0,0,3,1
20141108-M-Mouilleron_CH-QF-Marsel_Ilhan-Borna_Coric,2,B-XC,42,7,1,2,4,22,20
20141108-M-Mouilleron_CH-QF-Marsel_Ilhan-Borna_Coric,2,B-DTM,18,2,0,0,2,8,10
20141108-M-Mouilleron_CH-QF-Marsel_Ilhan-Borna_Coric,2,B-DTL,8,5,1,1,3,4,4
20141108-M-Mouilleron_CH-QF-Marsel_Ilhan-Borna_Coric,2,B-IO,2,2,0,0,2,0,2
20141108-M-Mouilleron_CH-QF-Marsel_Ilhan-Borna_Coric,2,S-XC,15,1,0,0,1,7,8
20141108-M-Mouilleron_CH-QF-Marsel_Ilhan-Borna_Coric,2,S-DTM,3,1,0,0,1,2,1
20141108-M-Mouilleron_CH-QF-Marsel_Ilhan-Borna_Coric,2,S-IO,2,0,0,0,0,1,1
20140710-M-Newport-QF-Samuel_Groth-Nicolas_Mahut,1,F-XC,1,0,0,0,0,1,0
20140710-M-Newport-QF-Samuel_Groth-Nicolas_Mahut,1,F-DTM,5,1,0,0,1,3,2
20140710-M-Newport-QF-Samuel_Groth-Nicolas_Mahut,1,F-DTL,1,1,0,1,0,1,0
20140710-M-Newport-QF-Samuel_Groth-Nicolas_Mahut,1,F-IO,2,1,1,0,0,1,1
20140710-M-Newport-QF-Samuel_Groth-Nicolas_Mahut,1,B-XC,9,5,2,1,2,6,3
20140710-M-Newport-QF-Samuel_Groth-Nicolas_Mahut,1,B-DTM,2,0,0,0,0,2,0
20140710-M-Newport-QF-Samuel_Groth-Nicolas_Mahut,1,B-DTL,1,0,0,0,0,1,0
20140710-M-Newport-QF-Samuel_Groth-Nicolas_Mahut,1,S-XC,1,1,1,0,0,1,0
20140710-M-Newport-QF-Samuel_Groth-Nicolas_Mahut,1,S-DTM,1,0,0,0,0,1,0
20140710-M-Newport-QF-Samuel_Groth-Nicolas_Mahut,1,S-DTL,1,0,0,0,0,1,0
20140710-M-Newport-QF-Samuel_Groth-Nicolas_Mahut,2,F-XC,3,0,0,0,0,1,2
20140710-M-Newport-QF-Samuel_Groth-Nicolas_Mahut,2,F-DTM,6,0,0,0,0,1,5
20140710-M-Newport-QF-Samuel_Groth-Nicolas_Mahut,2,F-IO,6,2,1,0,1,1,5
20140710-M-Newport-QF-Samuel_Groth-Nicolas_Mahut,2,F-II,1,1,0,0,1,0,1
20140710-M-Newport-QF-Samuel_Groth-Nicolas_Mahut,2,B-XC,3,1,0,0,1,0,3
20140710-M-Newport-QF-Samuel_Groth-Nicolas_Mahut,2,B-DTM,3,1,1,0,0,2,1
20140710-M-Newport-QF-Samuel_Groth-Nicolas_Mahut,2,B-DTL,1,1,1,0,0,1,0
20140710-M-Newport-QF-Samuel_Groth-Nicolas_Mahut,2,B-IO,1,1,0,1,0,1,0
20140710-M-Newport-QF-Samuel_Groth-Nicolas_Mahut,2,S-XC,2,0,0,0,0,0,2
20140710-M-Newport-QF-Samuel_Groth-Nicolas_Mahut,2,S-DTL,1,0,0,0,0,0,1
20140710-M-Newport-QF-Samuel_Groth-Nicolas_Mahut,2,S-IO,1,0,0,0,0,0,1
20141006-M-Ortisei_CH-R16-Austin_Krajicek-Nikoloz_Basilashvili,1,F-XC,39,9,0,2,7,12,27
20141006-M-Ortisei_CH-R16-Austin_Krajicek-Nikoloz_Basilashvili,1,F-DTM,23,3,0,0,3,7,16
20141006-M-Ortisei_CH-R16-Austin_Krajicek-Nikoloz_Basilashvili,1,F-DTL,2,1,0,0,1,0,2
20141006-M-Ortisei_CH-R16-Austin_Krajicek-Nikoloz_Basilashvili,1,F-IO,13,5,2,0,3,8,5
20141006-M-Ortisei_CH-R16-Austin_Krajicek-Nikoloz_Basilashvili,1,B-XC,4,0,0,0,0,1,3
20141006-M-Ortisei_CH-R16-Austin_Krajicek-Nikoloz_Basilashvili,1,B-DTM,21,2,0,0,2,10,11
20141006-M-Ortisei_CH-R16-Austin_Krajicek-Nikoloz_Basilashvili,1,B-DTL,3,0,0,0,0,1,2
20141006-M-Ortisei_CH-R16-Austin_Krajicek-Nikoloz_Basilashvili,1,B-IO,10,2,0,0,2,0,10
20141006-M-Ortisei_CH-R16-Austin_Krajicek-Nikoloz_Basilashvili,1,S-XC,6,2,0,1,1,2,4
20141006-M-Ortisei_CH-R16-Austin_Krajicek-Nikoloz_Basilashvili,1,S-DTM,10,2,0,0,2,3,7
20141006-M-Ortisei_CH-R16-Austin_Krajicek-Nikoloz_Basilashvili,1,S-DTL,6,2,0,0,2,2,4
20141006-M-Ortisei_CH-R16-Austin_Krajicek-Nikoloz_Basilashvili,1,S-IO,3,0,0,0,0,2,1
20141006-M-Ortisei_CH-R16-Austin_Krajicek-Nikoloz_Basilashvili,2,F-XC,52,20,7,4,9,31,21
20141006-M-Ortisei_CH-R16-Austin_Krajicek-Nikoloz_Basilashvili,2,F-DTM,19,6,0,0,6,10,9
20141006-M-Ortisei_CH-R16-Austin_Krajicek-Nikoloz_Basilashvili,2,F-DTL,2,0,0,0,0,0,2
20141006-M-Ortisei_CH-R16-Austin_Krajicek-Nikoloz_Basilashvili,2,F-IO,27,13,7,1,5,19,8
20141006-M-Ortisei_CH-R16-Austin_Krajicek-Nikoloz_Basilashvili,2,F-II,1,1,1,0,0,1,0
20141006-M-Ortisei_CH-R16-Austin_Krajicek-Nikoloz_Basilashvili,2,B-XC,27,9,2,1,6,16,11
20141006-M-Ortisei_CH-R16-Austin_Krajicek-Nikoloz_Basilashvili,2,B-DTM,40,6,0,2,4,21,19
20141006-M-Ortisei_CH-R16-Austin_Krajicek-Nikoloz_Basilashvili,2,B-DTL,6,2,1,0,1,5,1
20141006-M-Ortisei_CH-R16-Austin_Krajicek-Nikoloz_Basilashvili,2,B-IO,7,2,0,1,1,6,1
20141006-M-Ortisei_CH-R16-Austin_Krajicek-Nikoloz_Basilashvili,2,S-DTM,1,0,0,0,0,0,1
20140628-M-Padova_CH-SF-Nikola_Cacic-Maximo_Gonzalez,1,F-XC,24,8,2,2,4,14,10
20140628-M-Padova_CH-SF-Nikola_Cacic-Maximo_Gonzalez,1,F-DTM,6,2,0,0,2,0,6
20140628-M-Padova_CH-SF-Nikola_Cacic-Maximo_Gonzalez,1,F-DTL,9,2,0,0,2,5,4
20140628-M-Padova_CH-SF-Nikola_Cacic-Maximo_Gonzalez,1,F-IO,26,6,1,2,3,13,13
20140628-M-Padova_CH-SF-Nikola_Cacic-Maximo_Gonzalez,1,F-II,3,0,0,0,0,0,3
20140628-M-Padova_CH-SF-Nikola_Cacic-Maximo_Gonzalez,1,B-XC,25,5,0,1,4,5,20
20140628-M-Padova_CH-SF-Nikola_Cacic-Maximo_Gonzalez,1,B-DTM,13,3,0,0,3,2,11
20140628-M-Padova_CH-SF-Nikola_Cacic-Maximo_Gonzalez,1,B-DTL,9,3,0,1,2,7,2
20140628-M-Padova_CH-SF-Nikola_Cacic-Maximo_Gonzalez,1,B-IO,1,0,0,0,0,0,1
20140628-M-Padova_CH-SF-Nikola_Cacic-Maximo_Gonzalez,1,S-XC,3,1,0,0,1,0,3
20140628-M-Padova_CH-SF-Nikola_Cacic-Maximo_Gonzalez,1,S-DTM,4,2,0,0,2,0,4
20140628-M-Padova_CH-SF-Nikola_Cacic-Maximo_Gonzalez,1,S-DTL,4,3,1,0,2,1,3
20140628-M-Padova_CH-SF-Nikola_Cacic-Maximo_Gonzalez,2,F-XC,28,8,4,4,0,16,12
20140628-M-Padova_CH-SF-Nikola_Cacic-Maximo_Gonzalez,2,F-DTM,3,1,1,0,0,3,0
20140628-M-Padova_CH-SF-Nikola_Cacic-Maximo_Gonzalez,2,F-DTL,9,1,0,0,1,2,7
20140628-M-Padova_CH-SF-Nikola_Cacic-Maximo_Gonzalez,2,F-IO,21,2,1,0,1,19,2
20140628-M-Padova_CH-SF-Nikola_Cacic-Maximo_Gonzalez,2,F-II,3,1,0,1,0,2,1
20140628-M-Padova_CH-SF-Nikola_Cacic-Maximo_Gonzalez,2,B-XC,39,9,1,4,4,24,15
20140628-M-Padova_CH-SF-Nikola_Cacic-Maximo_Gonzalez,2,B-DTM,6,0,0,0,0,2,4
20140628-M-Padova_CH-SF-Nikola_Cacic-Maximo_Gonzalez,2,B-DTL,13,4,2,1,1,7,6
20140628-M-Padova_CH-SF-Nikola_Cacic-Maximo_Gonzalez,2,S-XC,5,1,1,0,0,3,2
20140628-M-Padova_CH-SF-Nikola_Cacic-Maximo_Gonzalez,2,S-DTM,2,0,0,0,0,0,2
20140628-M-Padova_CH-SF-Nikola_Cacic-Maximo_Gonzalez,2,S-DTL,1,0,0,0,0,0,1
20141029-M-Paris_Masters-R32-Lucas_Pouille-Fabio_Fognini,1,F-XC,40,14,3,6,5,25,15
20141029-M-Paris_Masters-R32-Lucas_Pouille-Fabio_Fognini,1,F-DTM,33,4,2,0,2,20,13
20141029-M-Paris_Masters-R32-Lucas_Pouille-Fabio_Fognini,1,F-DTL,5,2,0,1,1,2,3
20141029-M-Paris_Masters-R32-Lucas_Pouille-Fabio_Fognini,1,F-IO,23,6,1,0,5,11,12
20141029-M-Paris_Masters-R32-Lucas_Pouille-Fabio_Fognini,1,F-II,7,3,1,1,1,5,2
20141029-M-Paris_Masters-R32-Lucas_Pouille-Fabio_Fognini,1,B-XC,65,11,3,3,5,33,32
20141029-M-Paris_Masters-R32-Lucas_Pouille-Fabio_Fognini,1,B-DTM,30,5,0,0,5,14,16
20141029-M-Paris_Masters-R32-Lucas_Pouille-Fabio_Fognini,1,B-DTL,5,1,1,0,0,2,3
20141029-M-Paris_Masters-R32-Lucas_Pouille-Fabio_Fognini,1,B-IO,5,3,0,0,3,0,5
20141029-M-Paris_Masters-R32-Lucas_Pouille-Fabio_Fognini,1,S-XC,5,0,0,0,0,3,2
20141029-M-Paris_Masters-R32-Lucas_Pouille-Fabio_Fognini,1,S-DTM,4,0,0,0,0,1,3
20141029-M-Paris_Masters-R32-Lucas_Pouille-Fabio_Fognini,1,S-DTL,1,0,0,0,0,1,0
20141029-M-Paris_Masters-R32-Lucas_Pouille-Fabio_Fognini,1,S-IO,1,0,0,0,0,0,1
20141029-M-Paris_Masters-R32-Lucas_Pouille-Fabio_Fognini,2,F-XC,32,15,5,4,6,17,15
20141029-M-Paris_Masters-R32-Lucas_Pouille-Fabio_Fognini,2,F-DTM,34,2,0,0,2,19,15
20141029-M-Paris_Masters-R32-Lucas_Pouille-Fabio_Fognini,2,F-DTL,8,3,2,0,1,3,5
20141029-M-Paris_Masters-R32-Lucas_Pouille-Fabio_Fognini,2,F-IO,29,7,2,2,3,14,15
20141029-M-Paris_Masters-R32-Lucas_Pouille-Fabio_Fognini,2,F-II,5,3,0,2,1,2,3
20141029-M-Paris_Masters-R32-Lucas_Pouille-Fabio_Fognini,2,B-XC,35,8,0,3,5,20,15
20141029-M-Paris_Masters-R32-Lucas_Pouille-Fabio_Fognini,2,B-DTM,26,3,0,0,3,13,13
20141029-M-Paris_Masters-R32-Lucas_Pouille-Fabio_Fognini,2,B-DTL,6,5,0,0,5,0,6
20141029-M-Paris_Masters-R32-Lucas_Pouille-Fabio_Fognini,2,B-IO,6,3,1,0,2,1,5
20141029-M-Paris_Masters-R32-Lucas_Pouille-Fabio_Fognini,2,S-XC,15,2,0,0,2,5,10
20141029-M-Paris_Masters-R32-Lucas_Pouille-Fabio_Fognini,2,S-DTM,14,1,0,0,1,5,9
20141029-M-Paris_Masters-R32-Lucas_Pouille-Fabio_Fognini,2,S-IO,1,0,0,0,0,0,1
20141030-M-Paris_Masters-R16-Jo_Wilfried_Tsonga-Kei_Nishikori,1,F-XC,26,10,4,3,3,17,9
20141030-M-Paris_Masters-R16-Jo_Wilfried_Tsonga-Kei_Nishikori,1,F-DTM,14,4,0,0,4,7,7
20141030-M-Paris_Masters-R16-Jo_Wilfried_Tsonga-Kei_Nishikori,1,F-DTL,8,4,3,0,1,6,2
20141030-M-Paris_Masters-R16-Jo_Wilfried_Tsonga-Kei_Nishikori,1,F-IO,18,6,1,2,3,7,11
20141030-M-Paris_Masters-R16-Jo_Wilfried_Tsonga-Kei_Nishikori,1,F-II,1,1,1,0,0,1,0
20141030-M-Paris_Masters-R16-Jo_Wilfried_Tsonga-Kei_Nishikori,1,B-XC,26,6,1,0,5,12,14
20141030-M-Paris_Masters-R16-Jo_Wilfried_Tsonga-Kei_Nishikori,1,B-DTM,26,4,0,0,4,11,15
20141030-M-Paris_Masters-R16-Jo_Wilfried_Tsonga-Kei_Nishikori,1,B-DTL,11,6,3,0,3,7,4
20141030-M-Paris_Masters-R16-Jo_Wilfried_Tsonga-Kei_Nishikori,1,B-IO,1,1,0,0,1,0,1
20141030-M-Paris_Masters-R16-Jo_Wilfried_Tsonga-Kei_Nishikori,1,S-XC,22,4,0,0,4,9,13
20141030-M-Paris_Masters-R16-Jo_Wilfried_Tsonga-Kei_Nishikori,1,S-DTM,13,1,0,0,1,6,7
20141030-M-Paris_Masters-R16-Jo_Wilfried_Tsonga-Kei_Nishikori,1,S-DTL,2,0,0,0,0,1,1
20141030-M-Paris_Masters-R16-Jo_Wilfried_Tsonga-Kei_Nishikori,1,S-IO,1,1,0,0,1,0,1
20141030-M-Paris_Masters-R16-Jo_Wilfried_Tsonga-Kei_Nishikori,2,F-XC,29,10,5,1,4,12,17
20141030-M-Paris_Masters-R16-Jo_Wilfried_Tsonga-Kei_Nishikori,2,F-DTM,16,4,0,1,3,7,9
20141030-M-Paris_Masters-R16-Jo_Wilfried_Tsonga-Kei_Nishikori,2,F-DTL,9,6,2,1,3,4,5
20141030-M-Paris_Masters-R16-Jo_Wilfried_Tsonga-Kei_Nishikori,2,F-IO,32,13,5,2,6,17,15
20141030-M-Paris_Masters-R16-Jo_Wilfried_Tsonga-Kei_Nishikori,2,F-II,4,0,0,0,0,4,0
20141030-M-Paris_Masters-R16-Jo_Wilfried_Tsonga-Kei_Nishikori,2,B-XC,50,9,2,2,5,25,25
20141030-M-Paris_Masters-R16-Jo_Wilfried_Tsonga-Kei_Nishikori,2,B-DTM,13,1,0,0,1,6,7
20141030-M-Paris_Masters-R16-Jo_Wilfried_Tsonga-Kei_Nishikori,2,B-DTL,8,7,3,2,2,5,3
20141030-M-Paris_Masters-R16-Jo_Wilfried_Tsonga-Kei_Nishikori,2,B-IO,5,1,1,0,0,3,2
20141030-M-Paris_Masters-R16-Jo_Wilfried_Tsonga-Kei_Nishikori,2,S-XC,4,0,0,0,0,1,3
20141030-M-Paris_Masters-R16-Jo_Wilfried_Tsonga-Kei_Nishikori,2,S-DTM,1,0,0,0,0,0,1
20141030-M-Paris_Masters-R16-Jo_Wilfried_Tsonga-Kei_Nishikori,2,S-DTL,1,0,0,0,0,0,1
20141030-M-Paris_Masters-R16-Novak_Djokovic-Gael_Monfils,1,F-XC,40,9,6,2,1,23,17
20141030-M-Paris_Masters-R16-Novak_Djokovic-Gael_Monfils,1,F-DTM,20,2,0,1,1,11,9
20141030-M-Paris_Masters-R16-Novak_Djokovic-Gael_Monfils,1,F-DTL,6,2,0,2,0,5,1
20141030-M-Paris_Masters-R16-Novak_Djokovic-Gael_Monfils,1,F-IO,22,3,1,2,0,18,4
20141030-M-Paris_Masters-R16-Novak_Djokovic-Gael_Monfils,1,F-II,2,1,0,1,0,2,0
20141030-M-Paris_Masters-R16-Novak_Djokovic-Gael_Monfils,1,B-XC,39,3,1,0,2,20,19
20141030-M-Paris_Masters-R16-Novak_Djokovic-Gael_Monfils,1,B-DTM,26,3,0,0,3,15,11
20141030-M-Paris_Masters-R16-Novak_Djokovic-Gael_Monfils,1,B-DTL,9,2,1,0,1,3,6
20141030-M-Paris_Masters-R16-Novak_Djokovic-Gael_Monfils,1,B-IO,4,0,0,0,0,2,2
20141030-M-Paris_Masters-R16-Novak_Djokovic-Gael_Monfils,1,S-XC,2,1,0,0,1,1,1
20141030-M-Paris_Masters-R16-Novak_Djokovic-Gael_Monfils,1,S-DTM,3,0,0,0,0,1,2
20141030-M-Paris_Masters-R16-Novak_Djokovic-Gael_Monfils,2,F-XC,35,9,4,2,3,20,15
20141030-M-Paris_Masters-R16-Novak_Djokovic-Gael_Monfils,2,F-DTM,21,3,0,1,2,9,12
20141030-M-Paris_Masters-R16-Novak_Djokovic-Gael_Monfils,2,F-DTL,6,3,0,1,2,4,2
20141030-M-Paris_Masters-R16-Novak_Djokovic-Gael_Monfils,2,F-IO,16,3,1,1,1,10,6
20141030-M-Paris_Masters-R16-Novak_Djokovic-Gael_Monfils,2,F-II,2,2,2,0,0,2,0
20141030-M-Paris_Masters-R16-Novak_Djokovic-Gael_Monfils,2,B-XC,43,10,3,0,7,18,25
20141030-M-Paris_Masters-R16-Novak_Djokovic-Gael_Monfils,2,B-DTM,27,6,0,1,5,7,20
20141030-M-Paris_Masters-R16-Novak_Djokovic-Gael_Monfils,2,B-DTL,6,3,0,0,3,2,4
20141030-M-Paris_Masters-R16-Novak_Djokovic-Gael_Monfils,2,B-IO,3,2,1,0,1,1,2
20141030-M-Paris_Masters-R16-Novak_Djokovic-Gael_Monfils,2,S-XC,3,0,0,0,0,2,1
20141030-M-Paris_Masters-R16-Novak_Djokovic-Gael_Monfils,2,S-DTM,3,0,0,0,0,1,2
20141027-M-Paris_Masters-R64-Pierre_Hugues_Herbert-Adrian_Mannarino,1,F-XC,21,3,0,1,2,8,13
20141027-M-Paris_Masters-R64-Pierre_Hugues_Herbert-Adrian_Mannarino,1,F-DTM,23,2,0,0,2,9,14
20141027-M-Paris_Masters-R64-Pierre_Hugues_Herbert-Adrian_Mannarino,1,F-DTL,5,2,1,0,1,2,3
20141027-M-Paris_Masters-R64-Pierre_Hugues_Herbert-Adrian_Mannarino,1,F-IO,19,9,4,3,2,12,7
20141027-M-Paris_Masters-R64-Pierre_Hugues_Herbert-Adrian_Mannarino,1,F-II,3,1,0,0,1,0,3
20141027-M-Paris_Masters-R64-Pierre_Hugues_Herbert-Adrian_Mannarino,1,B-XC,13,3,1,0,2,7,6
20141027-M-Paris_Masters-R64-Pierre_Hugues_Herbert-Adrian_Mannarino,1,B-DTM,18,4,0,0,4,9,9
20141027-M-Paris_Masters-R64-Pierre_Hugues_Herbert-Adrian_Mannarino,1,B-DTL,6,3,0,1,2,2,4
20141027-M-Paris_Masters-R64-Pierre_Hugues_Herbert-Adrian_Mannarino,1,B-IO,1,0,0,0,0,0,1
20141027-M-Paris_Masters-R64-Pierre_Hugues_Herbert-Adrian_Mannarino,1,S-XC,12,2,0,1,1,6,6
20141027-M-Paris_Masters-R64-Pierre_Hugues_Herbert-Adrian_Mannarino,1,S-DTM,14,1,0,0,1,8,6
20141027-M-Paris_Masters-R64-Pierre_Hugues_Herbert-Adrian_Mannarino,1,S-DTL,2,1,0,0,1,0,2
20141027-M-Paris_Masters-R64-Pierre_Hugues_Herbert-Adrian_Mannarino,1,S-IO,2,1,0,0,1,0,2
20141027-M-Paris_Masters-R64-Pierre_Hugues_Herbert-Adrian_Mannarino,2,F-XC,59,6,1,2,3,31,28
20141027-M-Paris_Masters-R64-Pierre_Hugues_Herbert-Adrian_Mannarino,2,F-DTM,16,3,0,0,3,8,8
20141027-M-Paris_Masters-R64-Pierre_Hugues_Herbert-Adrian_Mannarino,2,F-DTL,3,1,0,0,1,2,1
20141027-M-Paris_Masters-R64-Pierre_Hugues_Herbert-Adrian_Mannarino,2,F-IO,7,4,2,1,1,3,4
20141027-M-Paris_Masters-R64-Pierre_Hugues_Herbert-Adrian_Mannarino,2,B-XC,31,9,2,3,4,21,10
20141027-M-Paris_Masters-R64-Pierre_Hugues_Herbert-Adrian_Mannarino,2,B-DTM,19,0,0,0,0,12,7
20141027-M-Paris_Masters-R64-Pierre_Hugues_Herbert-Adrian_Mannarino,2,B-DTL,6,0,0,0,0,4,2
20141027-M-Paris_Masters-R64-Pierre_Hugues_Herbert-Adrian_Mannarino,2,B-IO,3,1,0,1,0,2,1
20141027-M-Paris_Masters-R64-Pierre_Hugues_Herbert-Adrian_Mannarino,2,S-DTM,2,0,0,0,0,0,2
20141027-M-Paris_Masters-R64-Pierre_Hugues_Herbert-Adrian_Mannarino,2,S-DTL,3,0,0,0,0,1,2
20141027-M-Paris_Masters-R64-Pierre_Hugues_Herbert-Adrian_Mannarino,2,S-IO,2,0,0,0,0,1,1
20141029-M-Paris_Masters-R32-Stanislas_Wawrinka-Dominic_Thiem,1,F-XC,32,10,3,2,5,18,14
20141029-M-Paris_Masters-R32-Stanislas_Wawrinka-Dominic_Thiem,1,F-DTM,24,5,1,1,3,15,9
20141029-M-Paris_Masters-R32-Stanislas_Wawrinka-Dominic_Thiem,1,F-DTL,4,3,1,0,2,1,3
20141029-M-Paris_Masters-R32-Stanislas_Wawrinka-Dominic_Thiem,1,F-IO,15,4,2,1,1,9,6
20141029-M-Paris_Masters-R32-Stanislas_Wawrinka-Dominic_Thiem,1,F-II,1,0,0,0,0,1,0
20141029-M-Paris_Masters-R32-Stanislas_Wawrinka-Dominic_Thiem,1,B-XC,36,7,2,1,4,21,15
20141029-M-Paris_Masters-R32-Stanislas_Wawrinka-Dominic_Thiem,1,B-DTM,14,2,0,0,2,5,9
20141029-M-Paris_Masters-R32-Stanislas_Wawrinka-Dominic_Thiem,1,B-DTL,11,10,6,0,4,6,5
20141029-M-Paris_Masters-R32-Stanislas_Wawrinka-Dominic_Thiem,1,B-IO,3,2,1,0,1,2,1
20141029-M-Paris_Masters-R32-Stanislas_Wawrinka-Dominic_Thiem,1,S-XC,5,1,0,1,0,3,2
20141029-M-Paris_Masters-R32-Stanislas_Wawrinka-Dominic_Thiem,1,S-DTM,5,1,0,0,1,1,4
20141029-M-Paris_Masters-R32-Stanislas_Wawrinka-Dominic_Thiem,1,S-DTL,2,0,0,0,0,0,2
20141029-M-Paris_Masters-R32-Stanislas_Wawrinka-Dominic_Thiem,2,F-XC,26,7,1,1,5,12,14
20141029-M-Paris_Masters-R32-Stanislas_Wawrinka-Dominic_Thiem,2,F-DTM,21,2,0,0,2,13,8
20141029-M-Paris_Masters-R32-Stanislas_Wawrinka-Dominic_Thiem,2,F-DTL,6,3,0,0,3,2,4
20141029-M-Paris_Masters-R32-Stanislas_Wawrinka-Dominic_Thiem,2,F-IO,28,10,2,2,6,13,15
20141029-M-Paris_Masters-R32-Stanislas_Wawrinka-Dominic_Thiem,2,F-II,4,0,0,0,0,1,3
20141029-M-Paris_Masters-R32-Stanislas_Wawrinka-Dominic_Thiem,2,B-XC,23,5,1,2,2,10,13
20141029-M-Paris_Masters-R32-Stanislas_Wawrinka-Dominic_Thiem,2,B-DTM,19,2,0,1,1,9,10
20141029-M-Paris_Masters-R32-Stanislas_Wawrinka-Dominic_Thiem,2,B-DTL,3,2,0,0,2,0,3
20141029-M-Paris_Masters-R32-Stanislas_Wawrinka-Dominic_Thiem,2,B-IO,1,0,0,0,0,1,0
20141029-M-Paris_Masters-R32-Stanislas_Wawrinka-Dominic_Thiem,2,S-XC,10,2,0,1,1,6,4
20141029-M-Paris_Masters-R32-Stanislas_Wawrinka-Dominic_Thiem,2,S-DTM,6,2,0,1,1,2,4
20141029-M-Paris_Masters-R32-Stanislas_Wawrinka-Dominic_Thiem,2,S-DTL,2,1,0,1,0,1,1
20141029-M-Paris_Masters-R32-Stanislas_Wawrinka-Dominic_Thiem,2,S-IO,1,0,0,0,0,0,1
20141028-M-Paris_Masters-R64-Vasek_Pospisil-Tommy_Robredo,1,F-XC,62,19,11,4,4,39,23
20141028-M-Paris_Masters-R64-Vasek_Pospisil-Tommy_Robredo,1,F-DTM,35,3,0,0,3,13,22
20141028-M-Paris_Masters-R64-Vasek_Pospisil-Tommy_Robredo,1,F-DTL,7,3,1,1,1,5,2
20141028-M-Paris_Masters-R64-Vasek_Pospisil-Tommy_Robredo,1,F-IO,62,17,5,7,5,32,30
20141028-M-Paris_Masters-R64-Vasek_Pospisil-Tommy_Robredo,1,F-II,15,8,1,4,3,9,6
20141028-M-Paris_Masters-R64-Vasek_Pospisil-Tommy_Robredo,1,B-XC,27,2,0,0,2,12,15
20141028-M-Paris_Masters-R64-Vasek_Pospisil-Tommy_Robredo,1,B-DTM,14,2,0,0,2,7,7
20141028-M-Paris_Masters-R64-Vasek_Pospisil-Tommy_Robredo,1,B-DTL,2,2,0,1,1,1,1
20141028-M-Paris_Masters-R64-Vasek_Pospisil-Tommy_Robredo,1,B-IO,1,1,0,0,1,0,1
20141028-M-Paris_Masters-R64-Vasek_Pospisil-Tommy_Robredo,1,S-XC,33,4,1,0,3,13,20
20141028-M-Paris_Masters-R64-Vasek_Pospisil-Tommy_Robredo,1,S-DTM,10,1,0,0,1,4,6
20141028-M-Paris_Masters-R64-Vasek_Pospisil-Tommy_Robredo,1,S-DTL,5,0,0,0,0,2,3
20141028-M-Paris_Masters-R64-Vasek_Pospisil-Tommy_Robredo,2,F-XC,42,9,1,2,6,25,17
20141028-M-Paris_Masters-R64-Vasek_Pospisil-Tommy_Robredo,2,F-DTM,52,3,0,0,3,24,28
20141028-M-Paris_Masters-R64-Vasek_Pospisil-Tommy_Robredo,2,F-DTL,18,2,0,1,1,9,9
20141028-M-Paris_Masters-R64-Vasek_Pospisil-Tommy_Robredo,2,F-IO,71,5,0,3,2,44,27
20141028-M-Paris_Masters-R64-Vasek_Pospisil-Tommy_Robredo,2,F-II,15,4,1,3,0,9,6
20141028-M-Paris_Masters-R64-Vasek_Pospisil-Tommy_Robredo,2,B-XC,24,5,2,1,2,12,12
20141028-M-Paris_Masters-R64-Vasek_Pospisil-Tommy_Robredo,2,B-DTM,16,0,0,0,0,8,8
20141028-M-Paris_Masters-R64-Vasek_Pospisil-Tommy_Robredo,2,B-DTL,3,3,3,0,0,3,0
20141028-M-Paris_Masters-R64-Vasek_Pospisil-Tommy_Robredo,2,S-XC,12,1,0,0,1,5,7
20141028-M-Paris_Masters-R64-Vasek_Pospisil-Tommy_Robredo,2,S-DTM,15,2,0,0,2,4,11
20141028-M-Paris_Masters-R64-Vasek_Pospisil-Tommy_Robredo,2,S-DTL,3,1,0,0,1,2,1
20141028-M-Paris_Masters-R64-Vasek_Pospisil-Tommy_Robredo,2,S-IO,3,1,0,1,0,1,2
20140713-M-Portoroz_CH-F-Gilles_Muller-Blaz_Kavcic,1,F-XC,46,11,4,4,3,23,23
20140713-M-Portoroz_CH-F-Gilles_Muller-Blaz_Kavcic,1,F-DTM,13,0,0,0,0,3,10
20140713-M-Portoroz_CH-F-Gilles_Muller-Blaz_Kavcic,1,F-DTL,10,4,2,0,2,7,3
20140713-M-Portoroz_CH-F-Gilles_Muller-Blaz_Kavcic,1,F-IO,18,10,2,2,6,10,8
20140713-M-Portoroz_CH-F-Gilles_Muller-Blaz_Kavcic,1,F-II,3,1,0,0,1,0,3
20140713-M-Portoroz_CH-F-Gilles_Muller-Blaz_Kavcic,1,B-XC,19,6,1,1,4,11,8
20140713-M-Portoroz_CH-F-Gilles_Muller-Blaz_Kavcic,1,B-DTM,28,1,0,0,1,16,12
20140713-M-Portoroz_CH-F-Gilles_Muller-Blaz_Kavcic,1,B-DTL,8,4,1,0,3,3,5
20140713-M-Portoroz_CH-F-Gilles_Muller-Blaz_Kavcic,1,B-IO,8,2,1,0,1,2,6
20140713-M-Portoroz_CH-F-Gilles_Muller-Blaz_Kavcic,1,S-XC,10,2,1,0,1,5,5
20140713-M-Portoroz_CH-F-Gilles_Muller-Blaz_Kavcic,1,S-DTM,11,0,0,0,0,6,5
20140713-M-Portoroz_CH-F-Gilles_Muller-Blaz_Kavcic,1,S-DTL,14,4,1,0,3,3,11
20140713-M-Portoroz_CH-F-Gilles_Muller-Blaz_Kavcic,1,S-IO,12,4,0,0,4,3,9
20140713-M-Portoroz_CH-F-Gilles_Muller-Blaz_Kavcic,1,S-II,1,0,0,0,0,0,1
20140713-M-Portoroz_CH-F-Gilles_Muller-Blaz_Kavcic,2,F-XC,66,10,5,2,3,36,30
20140713-M-Portoroz_CH-F-Gilles_Muller-Blaz_Kavcic,2,F-DTM,23,1,0,0,1,9,14
20140713-M-Portoroz_CH-F-Gilles_Muller-Blaz_Kavcic,2,F-DTL,7,4,3,0,1,3,4
20140713-M-Portoroz_CH-F-Gilles_Muller-Blaz_Kavcic,2,F-IO,11,7,3,2,2,5,6
20140713-M-Portoroz_CH-F-Gilles_Muller-Blaz_Kavcic,2,F-II,5,1,0,0,1,4,1
20140713-M-Portoroz_CH-F-Gilles_Muller-Blaz_Kavcic,2,B-XC,29,5,2,1,2,20,9
20140713-M-Portoroz_CH-F-Gilles_Muller-Blaz_Kavcic,2,B-DTM,40,2,0,1,1,25,15
20140713-M-Portoroz_CH-F-Gilles_Muller-Blaz_Kavcic,2,B-DTL,8,1,0,0,1,3,5
20140713-M-Portoroz_CH-F-Gilles_Muller-Blaz_Kavcic,2,B-IO,9,1,0,0,1,4,5
20140713-M-Portoroz_CH-F-Gilles_Muller-Blaz_Kavcic,2,S-XC,7,1,0,1,0,5,2
20140713-M-Portoroz_CH-F-Gilles_Muller-Blaz_Kavcic,2,S-DTM,13,1,0,1,0,8,5
20140713-M-Portoroz_CH-F-Gilles_Muller-Blaz_Kavcic,2,S-DTL,6,1,0,0,1,1,5
20140713-M-Portoroz_CH-F-Gilles_Muller-Blaz_Kavcic,2,S-II,1,0,0,0,0,0,1
20140715-M-Poznan_CH-R32-Andreas_Haider_Maurer-Christian_Garin,1,F-XC,18,5,2,2,1,10,8
20140715-M-Poznan_CH-R32-Andreas_Haider_Maurer-Christian_Garin,1,F-DTM,19,1,0,0,1,11,8
20140715-M-Poznan_CH-R32-Andreas_Haider_Maurer-Christian_Garin,1,F-DTL,19,4,3,1,0,13,6
20140715-M-Poznan_CH-R32-Andreas_Haider_Maurer-Christian_Garin,1,F-IO,36,10,3,4,3,23,13
20140715-M-Poznan_CH-R32-Andreas_Haider_Maurer-Christian_Garin,1,F-II,2,1,0,0,1,1,1
20140715-M-Poznan_CH-R32-Andreas_Haider_Maurer-Christian_Garin,1,B-XC,23,5,0,2,3,14,9
20140715-M-Poznan_CH-R32-Andreas_Haider_Maurer-Christian_Garin,1,B-DTM,10,1,0,0,1,4,6
20140715-M-Poznan_CH-R32-Andreas_Haider_Maurer-Christian_Garin,1,B-DTL,5,4,1,0,3,2,3
20140715-M-Poznan_CH-R32-Andreas_Haider_Maurer-Christian_Garin,1,B-IO,1,0,0,0,0,1,0
20140715-M-Poznan_CH-R32-Andreas_Haider_Maurer-Christian_Garin,1,S-XC,18,0,0,0,0,12,6
20140715-M-Poznan_CH-R32-Andreas_Haider_Maurer-Christian_Garin,1,S-DTM,4,0,0,0,0,2,2
20140715-M-Poznan_CH-R32-Andreas_Haider_Maurer-Christian_Garin,2,F-XC,29,8,3,0,5,13,16
20140715-M-Poznan_CH-R32-Andreas_Haider_Maurer-Christian_Garin,2,F-DTM,16,0,0,0,0,5,11
20140715-M-Poznan_CH-R32-Andreas_Haider_Maurer-Christian_Garin,2,F-DTL,3,3,1,0,2,1,2
20140715-M-Poznan_CH-R32-Andreas_Haider_Maurer-Christian_Garin,2,F-IO,14,6,1,4,1,10,4
20140715-M-Poznan_CH-R32-Andreas_Haider_Maurer-Christian_Garin,2,F-II,5,1,0,1,0,1,4
20140715-M-Poznan_CH-R32-Andreas_Haider_Maurer-Christian_Garin,2,B-XC,53,8,0,3,5,23,30
20140715-M-Poznan_CH-R32-Andreas_Haider_Maurer-Christian_Garin,2,B-DTM,14,2,0,0,2,4,10
20140715-M-Poznan_CH-R32-Andreas_Haider_Maurer-Christian_Garin,2,B-DTL,16,7,2,2,3,6,10
20140715-M-Poznan_CH-R32-Andreas_Haider_Maurer-Christian_Garin,2,B-IO,3,2,0,0,2,0,3
20140715-M-Poznan_CH-R32-Andreas_Haider_Maurer-Christian_Garin,2,S-XC,2,0,0,0,0,2,0
20140715-M-Poznan_CH-R32-Andreas_Haider_Maurer-Christian_Garin,2,S-DTM,9,2,0,0,2,0,9
20140715-M-Poznan_CH-R32-Andreas_Haider_Maurer-Christian_Garin,2,S-DTL,4,0,0,0,0,2,2
20140719-M-Poznan_CH-SF-Adam_Pavlasek-David_Goffin,1,F-XC,22,2,0,0,2,11,11
20140719-M-Poznan_CH-SF-Adam_Pavlasek-David_Goffin,1,F-DTM,14,2,0,0,2,5,9
20140719-M-Poznan_CH-SF-Adam_Pavlasek-David_Goffin,1,F-DTL,4,1,0,1,0,3,1
20140719-M-Poznan_CH-SF-Adam_Pavlasek-David_Goffin,1,F-IO,8,2,1,0,1,3,5
20140719-M-Poznan_CH-SF-Adam_Pavlasek-David_Goffin,1,F-II,2,1,0,0,1,1,1
20140719-M-Poznan_CH-SF-Adam_Pavlasek-David_Goffin,1,B-XC,19,2,0,0,2,7,12
20140719-M-Poznan_CH-SF-Adam_Pavlasek-David_Goffin,1,B-DTM,21,2,0,0,2,7,14
20140719-M-Poznan_CH-SF-Adam_Pavlasek-David_Goffin,1,B-DTL,5,2,1,0,1,3,2
20140719-M-Poznan_CH-SF-Adam_Pavlasek-David_Goffin,1,B-IO,4,1,0,0,1,3,1
20140719-M-Poznan_CH-SF-Adam_Pavlasek-David_Goffin,1,S-XC,8,2,0,0,2,1,7
20140719-M-Poznan_CH-SF-Adam_Pavlasek-David_Goffin,1,S-DTM,2,0,0,0,0,0,2
20140719-M-Poznan_CH-SF-Adam_Pavlasek-David_Goffin,2,F-XC,24,7,4,3,0,17,7
20140719-M-Poznan_CH-SF-Adam_Pavlasek-David_Goffin,2,F-DTM,18,1,0,0,1,7,11
20140719-M-Poznan_CH-SF-Adam_Pavlasek-David_Goffin,2,F-DTL,12,4,1,1,2,7,5
20140719-M-Poznan_CH-SF-Adam_Pavlasek-David_Goffin,2,F-IO,15,5,2,1,2,12,3
20140719-M-Poznan_CH-SF-Adam_Pavlasek-David_Goffin,2,F-II,4,1,0,1,0,4,0
20140719-M-Poznan_CH-SF-Adam_Pavlasek-David_Goffin,2,B-XC,15,0,0,0,0,8,7
20140719-M-Poznan_CH-SF-Adam_Pavlasek-David_Goffin,2,B-DTM,6,0,0,0,0,2,4
20140719-M-Poznan_CH-SF-Adam_Pavlasek-David_Goffin,2,B-DTL,4,3,2,1,0,3,1
20140719-M-Poznan_CH-SF-Adam_Pavlasek-David_Goffin,2,B-IO,1,1,0,0,1,0,1
20140719-M-Poznan_CH-SF-Adam_Pavlasek-David_Goffin,2,S-XC,2,0,0,0,0,1,1
20140719-M-Poznan_CH-SF-Adam_Pavlasek-David_Goffin,2,S-DTM,4,0,0,0,0,3,1
20140719-M-Poznan_CH-SF-Adam_Pavlasek-David_Goffin,2,S-IO,1,0,0,0,0,0,1
20140609-M-Prague_CH-R32-Steven_Diez-Renzo_Olivo,1,F-XC,30,10,3,2,5,13,17
20140609-M-Prague_CH-R32-Steven_Diez-Renzo_Olivo,1,F-DTM,23,1,0,0,1,13,10
20140609-M-Prague_CH-R32-Steven_Diez-Renzo_Olivo,1,F-DTL,12,6,1,2,3,5,7
20140609-M-Prague_CH-R32-Steven_Diez-Renzo_Olivo,1,F-IO,37,9,1,4,4,21,16
20140609-M-Prague_CH-R32-Steven_Diez-Renzo_Olivo,1,F-II,3,2,2,0,0,2,1
20140609-M-Prague_CH-R32-Steven_Diez-Renzo_Olivo,1,B-XC,83,10,1,3,6,51,32
20140609-M-Prague_CH-R32-Steven_Diez-Renzo_Olivo,1,B-DTM,19,2,0,0,2,9,10
20140609-M-Prague_CH-R32-Steven_Diez-Renzo_Olivo,1,B-DTL,12,4,1,2,1,9,3
20140609-M-Prague_CH-R32-Steven_Diez-Renzo_Olivo,1,B-IO,5,2,1,0,1,3,2
20140609-M-Prague_CH-R32-Steven_Diez-Renzo_Olivo,1,B-II,1,0,0,0,0,0,1
20140609-M-Prague_CH-R32-Steven_Diez-Renzo_Olivo,1,S-XC,2,1,0,1,0,2,0
20140609-M-Prague_CH-R32-Steven_Diez-Renzo_Olivo,1,S-DTM,1,0,0,0,0,1,0
20140609-M-Prague_CH-R32-Steven_Diez-Renzo_Olivo,1,S-DTL,1,0,0,0,0,0,1
20140609-M-Prague_CH-R32-Steven_Diez-Renzo_Olivo,2,F-XC,28,3,1,1,1,16,12
20140609-M-Prague_CH-R32-Steven_Diez-Renzo_Olivo,2,F-DTM,25,1,0,0,1,12,13
20140609-M-Prague_CH-R32-Steven_Diez-Renzo_Olivo,2,F-DTL,13,3,0,1,2,7,6
20140609-M-Prague_CH-R32-Steven_Diez-Renzo_Olivo,2,F-IO,51,14,1,2,11,14,37
20140609-M-Prague_CH-R32-Steven_Diez-Renzo_Olivo,2,F-II,10,3,0,0,3,5,5
20140609-M-Prague_CH-R32-Steven_Diez-Renzo_Olivo,2,B-XC,46,9,0,1,8,17,29
20140609-M-Prague_CH-R32-Steven_Diez-Renzo_Olivo,2,B-DTM,23,2,0,0,2,8,15
20140609-M-Prague_CH-R32-Steven_Diez-Renzo_Olivo,2,B-DTL,3,3,1,1,1,2,1
20140609-M-Prague_CH-R32-Steven_Diez-Renzo_Olivo,2,S-XC,12,1,0,0,1,4,8
20140609-M-Prague_CH-R32-Steven_Diez-Renzo_Olivo,2,S-DTM,5,0,0,0,0,3,2
20140609-M-Prague_CH-R32-Steven_Diez-Renzo_Olivo,2,S-DTL,3,1,0,0,1,0,3
20140509-M-Rome_CH-QF-Mate_Delic-Julian_Reister,1,F-XC,45,15,5,1,9,20,25
20140509-M-Rome_CH-QF-Mate_Delic-Julian_Reister,1,F-DTM,18,3,0,0,3,4,14
20140509-M-Rome_CH-QF-Mate_Delic-Julian_Reister,1,F-DTL,8,4,2,0,2,3,5
20140509-M-Rome_CH-QF-Mate_Delic-Julian_Reister,1,F-IO,14,4,1,0,3,9,5
20140509-M-Rome_CH-QF-Mate_Delic-Julian_Reister,1,F-II,5,2,0,0,2,0,5
20140509-M-Rome_CH-QF-Mate_Delic-Julian_Reister,1,B-XC,35,5,0,1,4,12,23
20140509-M-Rome_CH-QF-Mate_Delic-Julian_Reister,1,B-DTM,13,2,0,0,2,3,10
20140509-M-Rome_CH-QF-Mate_Delic-Julian_Reister,1,B-DTL,4,2,0,0,2,0,4
20140509-M-Rome_CH-QF-Mate_Delic-Julian_Reister,1,S-XC,3,0,0,0,0,0,3
20140509-M-Rome_CH-QF-Mate_Delic-Julian_Reister,1,S-DTM,2,0,0,0,0,0,2
20140509-M-Rome_CH-QF-Mate_Delic-Julian_Reister,1,S-DTL,1,0,0,0,0,0,1
20140509-M-Rome_CH-QF-Mate_Delic-Julian_Reister,1,S-IO,1,0,0,0,0,0,1
20140509-M-Rome_CH-QF-Mate_Delic-Julian_Reister,2,F-XC,28,9,3,3,3,20,8
20140509-M-Rome_CH-QF-Mate_Delic-Julian_Reister,2,F-DTM,19,0,0,0,0,11,8
20140509-M-Rome_CH-QF-Mate_Delic-Julian_Reister,2,F-DTL,10,1,1,0,0,8,2
20140509-M-Rome_CH-QF-Mate_Delic-Julian_Reister,2,F-IO,21,5,3,1,1,18,3
20140509-M-Rome_CH-QF-Mate_Delic-Julian_Reister,2,F-II,6,3,0,3,0,6,0
20140509-M-Rome_CH-QF-Mate_Delic-Julian_Reister,2,B-XC,17,1,0,0,1,9,8
20140509-M-Rome_CH-QF-Mate_Delic-Julian_Reister,2,B-DTM,14,2,0,0,2,5,9
20140509-M-Rome_CH-QF-Mate_Delic-Julian_Reister,2,B-DTL,2,1,1,0,0,1,1
20140509-M-Rome_CH-QF-Mate_Delic-Julian_Reister,2,S-XC,8,0,0,0,0,5,3
20140509-M-Rome_CH-QF-Mate_Delic-Julian_Reister,2,S-DTM,2,0,0,0,0,1,1
20140929-M-Sacramento_CH-R16-Jared_Donaldson-Luca_Vanni,1,F-XC,57,12,5,2,5,28,29
20140929-M-Sacramento_CH-R16-Jared_Donaldson-Luca_Vanni,1,F-DTM,27,2,0,0,2,12,15
20140929-M-Sacramento_CH-R16-Jared_Donaldson-Luca_Vanni,1,F-DTL,9,0,0,0,0,1,8
20140929-M-Sacramento_CH-R16-Jared_Donaldson-Luca_Vanni,1,F-IO,24,6,1,0,5,8,16
20140929-M-Sacramento_CH-R16-Jared_Donaldson-Luca_Vanni,1,F-II,1,1,0,0,1,0,1
20140929-M-Sacramento_CH-R16-Jared_Donaldson-Luca_Vanni,1,B-XC,60,12,4,1,7,24,36
20140929-M-Sacramento_CH-R16-Jared_Donaldson-Luca_Vanni,1,B-DTM,24,2,0,0,2,7,17
20140929-M-Sacramento_CH-R16-Jared_Donaldson-Luca_Vanni,1,B-DTL,10,3,1,1,1,7,3
20140929-M-Sacramento_CH-R16-Jared_Donaldson-Luca_Vanni,1,B-IO,5,3,1,0,2,3,2
20140929-M-Sacramento_CH-R16-Jared_Donaldson-Luca_Vanni,1,S-XC,10,0,0,0,0,4,6
20140929-M-Sacramento_CH-R16-Jared_Donaldson-Luca_Vanni,1,S-DTM,5,0,0,0,0,4,1
20140929-M-Sacramento_CH-R16-Jared_Donaldson-Luca_Vanni,1,S-DTL,2,1,0,0,1,0,2
20140929-M-Sacramento_CH-R16-Jared_Donaldson-Luca_Vanni,1,S-IO,2,0,0,0,0,0,2
20140929-M-Sacramento_CH-R16-Jared_Donaldson-Luca_Vanni,2,F-XC,54,19,5,2,12,32,22
20140929-M-Sacramento_CH-R16-Jared_Donaldson-Luca_Vanni,2,F-DTM,18,3,0,0,3,7,11
20140929-M-Sacramento_CH-R16-Jared_Donaldson-Luca_Vanni,2,F-DTL,18,5,2,2,1,12,6
20140929-M-Sacramento_CH-R16-Jared_Donaldson-Luca_Vanni,2,F-IO,41,8,1,1,6,20,21
20140929-M-Sacramento_CH-R16-Jared_Donaldson-Luca_Vanni,2,F-II,6,2,0,1,1,4,2
20140929-M-Sacramento_CH-R16-Jared_Donaldson-Luca_Vanni,2,B-XC,13,3,1,0,2,5,8
20140929-M-Sacramento_CH-R16-Jared_Donaldson-Luca_Vanni,2,B-DTM,14,2,1,0,1,7,7
20140929-M-Sacramento_CH-R16-Jared_Donaldson-Luca_Vanni,2,B-DTL,9,2,0,1,1,4,5
20140929-M-Sacramento_CH-R16-Jared_Donaldson-Luca_Vanni,2,B-IO,2,1,0,0,1,1,1
20140929-M-Sacramento_CH-R16-Jared_Donaldson-Luca_Vanni,2,S-XC,26,0,0,0,0,20,6
20140929-M-Sacramento_CH-R16-Jared_Donaldson-Luca_Vanni,2,S-DTM,25,0,0,0,0,18,7
20140929-M-Sacramento_CH-R16-Jared_Donaldson-Luca_Vanni,2,S-DTL,1,0,0,0,0,0,1
20140713-M-Scheveningen_CH-F-David_Goffin-Andreas_Beck,1,F-XC,27,5,1,2,2,18,9
20140713-M-Scheveningen_CH-F-David_Goffin-Andreas_Beck,1,F-DTM,22,1,0,1,0,16,6
20140713-M-Scheveningen_CH-F-David_Goffin-Andreas_Beck,1,F-DTL,10,7,3,1,3,6,4
20140713-M-Scheveningen_CH-F-David_Goffin-Andreas_Beck,1,F-IO,15,8,3,1,4,8,7
20140713-M-Scheveningen_CH-F-David_Goffin-Andreas_Beck,1,B-XC,13,4,0,1,3,8,5
20140713-M-Scheveningen_CH-F-David_Goffin-Andreas_Beck,1,B-DTM,28,2,0,1,1,17,11
20140713-M-Scheveningen_CH-F-David_Goffin-Andreas_Beck,1,B-DTL,7,2,2,0,0,5,2
20140713-M-Scheveningen_CH-F-David_Goffin-Andreas_Beck,1,B-IO,4,0,0,0,0,3,1
20140713-M-Scheveningen_CH-F-David_Goffin-Andreas_Beck,1,S-XC,1,0,0,0,0,0,1
20140713-M-Scheveningen_CH-F-David_Goffin-Andreas_Beck,1,S-DTM,5,0,0,0,0,1,4
20140713-M-Scheveningen_CH-F-David_Goffin-Andreas_Beck,1,S-DTL,3,0,0,0,0,1,2
20140713-M-Scheveningen_CH-F-David_Goffin-Andreas_Beck,2,F-XC,28,5,3,0,2,12,16
20140713-M-Scheveningen_CH-F-David_Goffin-Andreas_Beck,2,F-DTM,31,5,1,0,4,8,23
20140713-M-Scheveningen_CH-F-David_Goffin-Andreas_Beck,2,F-DTL,7,5,2,0,3,3,4
20140713-M-Scheveningen_CH-F-David_Goffin-Andreas_Beck,2,F-IO,14,6,2,2,2,6,8
20140713-M-Scheveningen_CH-F-David_Goffin-Andreas_Beck,2,B-XC,29,12,6,1,5,15,14
20140713-M-Scheveningen_CH-F-David_Goffin-Andreas_Beck,2,B-DTM,26,9,0,0,9,5,21
20140713-M-Scheveningen_CH-F-David_Goffin-Andreas_Beck,2,B-DTL,10,5,1,0,4,4,6
20140713-M-Scheveningen_CH-F-David_Goffin-Andreas_Beck,2,B-IO,9,4,0,2,2,4,5
20140713-M-Scheveningen_CH-F-David_Goffin-Andreas_Beck,2,S-DTM,1,1,0,0,1,0,1
20140713-M-Scheveningen_CH-F-David_Goffin-Andreas_Beck,2,S-DTL,1,1,0,0,1,0,1
20140802-M-Segovia_CH-SF-Alexander_Kudryavtsev-Adrian_Menendez_Maceiras,1,F-XC,9,6,1,2,3,3,6
20140802-M-Segovia_CH-SF-Alexander_Kudryavtsev-Adrian_Menendez_Maceiras,1,F-DTM,12,2,0,0,2,1,11
20140802-M-Segovia_CH-SF-Alexander_Kudryavtsev-Adrian_Menendez_Maceiras,1,F-DTL,7,4,1,1,2,3,4
20140802-M-Segovia_CH-SF-Alexander_Kudryavtsev-Adrian_Menendez_Maceiras,1,F-IO,6,2,1,0,1,4,2
20140802-M-Segovia_CH-SF-Alexander_Kudryavtsev-Adrian_Menendez_Maceiras,1,B-XC,7,3,1,0,2,2,5
20140802-M-Segovia_CH-SF-Alexander_Kudryavtsev-Adrian_Menendez_Maceiras,1,B-DTM,21,8,0,0,8,2,19
20140802-M-Segovia_CH-SF-Alexander_Kudryavtsev-Adrian_Menendez_Maceiras,1,B-DTL,4,1,0,0,1,1,3
20140802-M-Segovia_CH-SF-Alexander_Kudryavtsev-Adrian_Menendez_Maceiras,1,S-XC,2,1,0,0,1,0,2
20140802-M-Segovia_CH-SF-Alexander_Kudryavtsev-Adrian_Menendez_Maceiras,1,S-DTM,2,1,0,0,1,0,2
20140802-M-Segovia_CH-SF-Alexander_Kudryavtsev-Adrian_Menendez_Maceiras,1,S-DTL,1,0,0,0,0,0,1
20140802-M-Segovia_CH-SF-Alexander_Kudryavtsev-Adrian_Menendez_Maceiras,2,F-XC,12,4,3,1,0,12,0
20140802-M-Segovia_CH-SF-Alexander_Kudryavtsev-Adrian_Menendez_Maceiras,2,F-DTM,5,1,0,1,0,3,2
20140802-M-Segovia_CH-SF-Alexander_Kudryavtsev-Adrian_Menendez_Maceiras,2,F-DTL,2,0,0,0,0,1,1
20140802-M-Segovia_CH-SF-Alexander_Kudryavtsev-Adrian_Menendez_Maceiras,2,F-IO,15,5,1,2,2,13,2
20140802-M-Segovia_CH-SF-Alexander_Kudryavtsev-Adrian_Menendez_Maceiras,2,F-II,1,0,0,0,0,1,0
20140802-M-Segovia_CH-SF-Alexander_Kudryavtsev-Adrian_Menendez_Maceiras,2,B-XC,8,4,2,1,1,7,1
20140802-M-Segovia_CH-SF-Alexander_Kudryavtsev-Adrian_Menendez_Maceiras,2,B-DTM,7,1,1,0,0,6,1
20140802-M-Segovia_CH-SF-Alexander_Kudryavtsev-Adrian_Menendez_Maceiras,2,B-IO,3,1,0,0,1,2,1
20140802-M-Segovia_CH-SF-Alexander_Kudryavtsev-Adrian_Menendez_Maceiras,2,S-XC,3,1,0,0,1,1,2
20140802-M-Segovia_CH-SF-Alexander_Kudryavtsev-Adrian_Menendez_Maceiras,2,S-DTM,7,1,0,0,1,4,3
20131012-M-Shanghai_Masters-SF-Novak_Djokovic-Jo_Wilfried_Tsonga,1,F-XC,22,3,2,0,1,14,8
20131012-M-Shanghai_Masters-SF-Novak_Djokovic-Jo_Wilfried_Tsonga,1,F-DTM,27,2,0,0,2,12,15
20131012-M-Shanghai_Masters-SF-Novak_Djokovic-Jo_Wilfried_Tsonga,1,F-DTL,8,4,3,1,0,5,3
20131012-M-Shanghai_Masters-SF-Novak_Djokovic-Jo_Wilfried_Tsonga,1,F-IO,20,4,2,1,1,14,6
20131012-M-Shanghai_Masters-SF-Novak_Djokovic-Jo_Wilfried_Tsonga,1,F-II,2,1,0,0,1,0,2
20131012-M-Shanghai_Masters-SF-Novak_Djokovic-Jo_Wilfried_Tsonga,1,B-XC,43,9,3,3,3,22,21
20131012-M-Shanghai_Masters-SF-Novak_Djokovic-Jo_Wilfried_Tsonga,1,B-DTM,30,4,0,1,3,16,14
20131012-M-Shanghai_Masters-SF-Novak_Djokovic-Jo_Wilfried_Tsonga,1,B-DTL,4,2,0,2,0,4,0
20131012-M-Shanghai_Masters-SF-Novak_Djokovic-Jo_Wilfried_Tsonga,1,B-IO,6,4,2,1,1,5,1
20131012-M-Shanghai_Masters-SF-Novak_Djokovic-Jo_Wilfried_Tsonga,1,S-XC,4,1,0,0,1,2,2
20131012-M-Shanghai_Masters-SF-Novak_Djokovic-Jo_Wilfried_Tsonga,1,S-DTM,7,0,0,0,0,3,4
20131012-M-Shanghai_Masters-SF-Novak_Djokovic-Jo_Wilfried_Tsonga,1,S-DTL,1,0,0,0,0,1,0
20131012-M-Shanghai_Masters-SF-Novak_Djokovic-Jo_Wilfried_Tsonga,2,F-XC,35,10,3,2,5,16,19
20131012-M-Shanghai_Masters-SF-Novak_Djokovic-Jo_Wilfried_Tsonga,2,F-DTM,21,1,0,0,1,5,16
20131012-M-Shanghai_Masters-SF-Novak_Djokovic-Jo_Wilfried_Tsonga,2,F-DTL,4,2,0,1,1,2,2
20131012-M-Shanghai_Masters-SF-Novak_Djokovic-Jo_Wilfried_Tsonga,2,F-IO,28,6,1,1,4,15,13
20131012-M-Shanghai_Masters-SF-Novak_Djokovic-Jo_Wilfried_Tsonga,2,F-II,4,0,0,0,0,2,2
20131012-M-Shanghai_Masters-SF-Novak_Djokovic-Jo_Wilfried_Tsonga,2,B-XC,29,3,1,0,2,12,17
20131012-M-Shanghai_Masters-SF-Novak_Djokovic-Jo_Wilfried_Tsonga,2,B-DTM,15,0,0,0,0,6,9
20131012-M-Shanghai_Masters-SF-Novak_Djokovic-Jo_Wilfried_Tsonga,2,B-DTL,8,5,1,1,3,3,5
20131012-M-Shanghai_Masters-SF-Novak_Djokovic-Jo_Wilfried_Tsonga,2,B-IO,5,4,1,0,3,1,4
20131012-M-Shanghai_Masters-SF-Novak_Djokovic-Jo_Wilfried_Tsonga,2,S-XC,15,3,0,0,3,6,9
20131012-M-Shanghai_Masters-SF-Novak_Djokovic-Jo_Wilfried_Tsonga,2,S-DTM,7,1,0,0,1,3,4
20131012-M-Shanghai_Masters-SF-Novak_Djokovic-Jo_Wilfried_Tsonga,2,S-DTL,1,0,0,0,0,1,0
20131010-M-Shanghai_Masters-R16-Roger_Federer-Gael_Monfils,1,F-XC,36,12,4,5,3,21,15
20131010-M-Shanghai_Masters-R16-Roger_Federer-Gael_Monfils,1,F-DTM,11,1,0,0,1,2,9
20131010-M-Shanghai_Masters-R16-Roger_Federer-Gael_Monfils,1,F-DTL,6,2,0,2,0,3,3
20131010-M-Shanghai_Masters-R16-Roger_Federer-Gael_Monfils,1,F-IO,63,27,14,6,7,38,25
20131010-M-Shanghai_Masters-R16-Roger_Federer-Gael_Monfils,1,F-II,8,3,1,0,2,5,3
20131010-M-Shanghai_Masters-R16-Roger_Federer-Gael_Monfils,1,B-DTM,21,2,0,0,2,11,10
20131010-M-Shanghai_Masters-R16-Roger_Federer-Gael_Monfils,1,B-IO,39,6,0,0,6,17,22
20131010-M-Shanghai_Masters-R16-Roger_Federer-Gael_Monfils,1,B-II,11,5,1,1,3,7,4
20131010-M-Shanghai_Masters-R16-Roger_Federer-Gael_Monfils,1,S-DTM,1,0,0,0,0,1,0
20131010-M-Shanghai_Masters-R16-Roger_Federer-Gael_Monfils,1,S-IO,22,2,0,1,1,13,9
20131010-M-Shanghai_Masters-R16-Roger_Federer-Gael_Monfils,1,S-II,5,1,0,0,1,1,4
20131010-M-Shanghai_Masters-R16-Roger_Federer-Gael_Monfils,2,F-XC,36,4,1,2,1,21,15
20131010-M-Shanghai_Masters-R16-Roger_Federer-Gael_Monfils,2,F-DTM,19,4,0,0,4,10,9
20131010-M-Shanghai_Masters-R16-Roger_Federer-Gael_Monfils,2,F-DTL,3,1,1,0,0,1,2
20131010-M-Shanghai_Masters-R16-Roger_Federer-Gael_Monfils,2,F-IO,35,14,8,3,3,21,14
20131010-M-Shanghai_Masters-R16-Roger_Federer-Gael_Monfils,2,F-II,13,2,0,0,2,4,9
20131010-M-Shanghai_Masters-R16-Roger_Federer-Gael_Monfils,2,B-XC,3,3,2,1,0,3,0
20131010-M-Shanghai_Masters-R16-Roger_Federer-Gael_Monfils,2,B-DTM,25,2,0,1,1,9,16
20131010-M-Shanghai_Masters-R16-Roger_Federer-Gael_Monfils,2,B-IO,54,4,1,1,2,29,25
20131010-M-Shanghai_Masters-R16-Roger_Federer-Gael_Monfils,2,B-II,14,7,2,3,2,8,6
20131010-M-Shanghai_Masters-R16-Roger_Federer-Gael_Monfils,2,S-DTM,3,0,0,0,0,1,2
20131010-M-Shanghai_Masters-R16-Roger_Federer-Gael_Monfils,2,S-IO,2,0,0,0,0,0,2
20141010-M-Shanghai_Masters-SF-Novak_Djokovic-Roger_Federer,1,F-XC,37,13,4,1,8,19,18
20141010-M-Shanghai_Masters-SF-Novak_Djokovic-Roger_Federer,1,F-DTM,28,4,1,0,3,10,18
20141010-M-Shanghai_Masters-SF-Novak_Djokovic-Roger_Federer,1,F-DTL,7,3,1,1,1,4,3
20141010-M-Shanghai_Masters-SF-Novak_Djokovic-Roger_Federer,1,F-IO,19,7,4,1,2,10,9
20141010-M-Shanghai_Masters-SF-Novak_Djokovic-Roger_Federer,1,F-II,1,1,0,0,1,0,1
20141010-M-Shanghai_Masters-SF-Novak_Djokovic-Roger_Federer,1,B-XC,62,12,3,4,5,27,35
20141010-M-Shanghai_Masters-SF-Novak_Djokovic-Roger_Federer,1,B-DTM,39,0,0,0,0,15,24
20141010-M-Shanghai_Masters-SF-Novak_Djokovic-Roger_Federer,1,B-DTL,9,6,2,1,3,5,4
20141010-M-Shanghai_Masters-SF-Novak_Djokovic-Roger_Federer,1,B-IO,10,4,2,1,1,8,2
20141010-M-Shanghai_Masters-SF-Novak_Djokovic-Roger_Federer,1,S-XC,5,1,0,0,1,3,2
20141010-M-Shanghai_Masters-SF-Novak_Djokovic-Roger_Federer,1,S-DTM,1,0,0,0,0,1,0
20141010-M-Shanghai_Masters-SF-Novak_Djokovic-Roger_Federer,2,F-XC,42,12,2,4,6,23,19
20141010-M-Shanghai_Masters-SF-Novak_Djokovic-Roger_Federer,2,F-DTM,22,0,0,0,0,8,14
20141010-M-Shanghai_Masters-SF-Novak_Djokovic-Roger_Federer,2,F-DTL,9,3,1,0,2,3,6
20141010-M-Shanghai_Masters-SF-Novak_Djokovic-Roger_Federer,2,F-IO,29,11,6,3,2,20,9
20141010-M-Shanghai_Masters-SF-Novak_Djokovic-Roger_Federer,2,F-II,2,0,0,0,0,1,1
20141010-M-Shanghai_Masters-SF-Novak_Djokovic-Roger_Federer,2,B-XC,26,2,0,0,2,15,11
20141010-M-Shanghai_Masters-SF-Novak_Djokovic-Roger_Federer,2,B-DTM,29,2,0,0,2,17,12
20141010-M-Shanghai_Masters-SF-Novak_Djokovic-Roger_Federer,2,B-DTL,4,2,0,1,1,3,1
20141010-M-Shanghai_Masters-SF-Novak_Djokovic-Roger_Federer,2,B-IO,1,0,0,0,0,0,1
20141010-M-Shanghai_Masters-SF-Novak_Djokovic-Roger_Federer,2,S-XC,17,2,0,1,1,10,7
20141010-M-Shanghai_Masters-SF-Novak_Djokovic-Roger_Federer,2,S-DTM,6,0,0,0,0,1,5
20141010-M-Shanghai_Masters-SF-Novak_Djokovic-Roger_Federer,2,S-DTL,4,1,0,1,0,2,2
20131007-M-Shanghai_Masters-R32-Roger_Federer-Andreas_Seppi,1,F-XC,31,10,3,4,3,19,12
20131007-M-Shanghai_Masters-R32-Roger_Federer-Andreas_Seppi,1,F-DTM,10,0,0,0,0,7,3
20131007-M-Shanghai_Masters-R32-Roger_Federer-Andreas_Seppi,1,F-DTL,9,3,1,1,1,4,5
20131007-M-Shanghai_Masters-R32-Roger_Federer-Andreas_Seppi,1,F-IO,19,7,1,3,3,11,8
20131007-M-Shanghai_Masters-R32-Roger_Federer-Andreas_Seppi,1,B-XC,10,2,0,1,1,7,3
20131007-M-Shanghai_Masters-R32-Roger_Federer-Andreas_Seppi,1,B-DTM,18,2,0,0,2,10,8
20131007-M-Shanghai_Masters-R32-Roger_Federer-Andreas_Seppi,1,B-DTL,4,3,0,2,1,3,1
20131007-M-Shanghai_Masters-R32-Roger_Federer-Andreas_Seppi,1,B-IO,1,0,0,0,0,1,0
20131007-M-Shanghai_Masters-R32-Roger_Federer-Andreas_Seppi,1,S-XC,16,3,0,0,3,10,6
20131007-M-Shanghai_Masters-R32-Roger_Federer-Andreas_Seppi,1,S-DTM,4,0,0,0,0,3,1
20131007-M-Shanghai_Masters-R32-Roger_Federer-Andreas_Seppi,1,S-DTL,2,0,0,0,0,2,0
20131007-M-Shanghai_Masters-R32-Roger_Federer-Andreas_Seppi,1,S-IO,1,0,0,0,0,0,1
20131007-M-Shanghai_Masters-R32-Roger_Federer-Andreas_Seppi,2,F-XC,26,8,0,2,6,9,17
20131007-M-Shanghai_Masters-R32-Roger_Federer-Andreas_Seppi,2,F-DTM,11,1,0,1,0,6,5
20131007-M-Shanghai_Masters-R32-Roger_Federer-Andreas_Seppi,2,F-DTL,8,2,0,0,2,2,6
20131007-M-Shanghai_Masters-R32-Roger_Federer-Andreas_Seppi,2,F-IO,23,7,4,0,3,10,13
20131007-M-Shanghai_Masters-R32-Roger_Federer-Andreas_Seppi,2,F-II,1,0,0,0,0,0,1
20131007-M-Shanghai_Masters-R32-Roger_Federer-Andreas_Seppi,2,B-XC,19,4,2,1,1,10,9
20131007-M-Shanghai_Masters-R32-Roger_Federer-Andreas_Seppi,2,B-DTM,24,1,0,0,1,4,20
20131007-M-Shanghai_Masters-R32-Roger_Federer-Andreas_Seppi,2,B-DTL,3,2,1,0,1,1,2
20131007-M-Shanghai_Masters-R32-Roger_Federer-Andreas_Seppi,2,S-XC,4,1,0,0,1,1,3
20131007-M-Shanghai_Masters-R32-Roger_Federer-Andreas_Seppi,2,S-DTM,4,0,0,0,0,3,1
20131007-M-Shanghai_Masters-R32-Roger_Federer-Andreas_Seppi,2,S-DTL,2,2,0,0,2,0,2
20141011-M-Shanghai_Masters-F-Roger_Federer-Gilles_Simon,1,F-XC,45,6,2,1,3,21,24
20141011-M-Shanghai_Masters-F-Roger_Federer-Gilles_Simon,1,F-DTM,42,4,1,0,3,26,16
20141011-M-Shanghai_Masters-F-Roger_Federer-Gilles_Simon,1,F-DTL,14,4,0,1,3,5,9
20141011-M-Shanghai_Masters-F-Roger_Federer-Gilles_Simon,1,F-IO,27,5,1,2,2,20,7
20141011-M-Shanghai_Masters-F-Roger_Federer-Gilles_Simon,1,F-II,8,2,0,1,1,3,5
20141011-M-Shanghai_Masters-F-Roger_Federer-Gilles_Simon,1,B-XC,41,3,0,0,3,17,24
20141011-M-Shanghai_Masters-F-Roger_Federer-Gilles_Simon,1,B-DTM,23,4,0,1,3,11,12
20141011-M-Shanghai_Masters-F-Roger_Federer-Gilles_Simon,1,B-DTL,7,3,1,0,2,3,4
20141011-M-Shanghai_Masters-F-Roger_Federer-Gilles_Simon,1,B-IO,2,1,0,0,1,0,2
20141011-M-Shanghai_Masters-F-Roger_Federer-Gilles_Simon,1,S-XC,29,1,0,0,1,13,16
20141011-M-Shanghai_Masters-F-Roger_Federer-Gilles_Simon,1,S-DTM,5,2,0,0,2,3,2
20141011-M-Shanghai_Masters-F-Roger_Federer-Gilles_Simon,1,S-DTL,6,0,0,0,0,3,3
20141011-M-Shanghai_Masters-F-Roger_Federer-Gilles_Simon,1,S-IO,1,0,0,0,0,1,0
20141011-M-Shanghai_Masters-F-Roger_Federer-Gilles_Simon,2,F-XC,56,12,3,1,8,30,26
20141011-M-Shanghai_Masters-F-Roger_Federer-Gilles_Simon,2,F-DTM,21,1,0,0,1,9,12
20141011-M-Shanghai_Masters-F-Roger_Federer-Gilles_Simon,2,F-DTL,13,3,1,0,2,9,4
20141011-M-Shanghai_Masters-F-Roger_Federer-Gilles_Simon,2,F-IO,23,9,1,4,4,14,9
20141011-M-Shanghai_Masters-F-Roger_Federer-Gilles_Simon,2,F-II,3,1,1,0,0,2,1
20141011-M-Shanghai_Masters-F-Roger_Federer-Gilles_Simon,2,B-XC,103,15,5,4,6,50,53
20141011-M-Shanghai_Masters-F-Roger_Federer-Gilles_Simon,2,B-DTM,36,3,0,0,3,12,24
20141011-M-Shanghai_Masters-F-Roger_Federer-Gilles_Simon,2,B-DTL,14,5,2,1,2,7,7
20141011-M-Shanghai_Masters-F-Roger_Federer-Gilles_Simon,2,B-IO,3,2,0,0,2,1,2
20141011-M-Shanghai_Masters-F-Roger_Federer-Gilles_Simon,2,S-XC,3,0,0,0,0,1,2
20141011-M-Shanghai_Masters-F-Roger_Federer-Gilles_Simon,2,S-DTM,3,1,0,1,0,3,0
20131008-M-Shanghai_Masters-R64-Vasek_Pospisil-Richard_Gasquet,1,F-XC,28,12,10,1,1,23,5
20131008-M-Shanghai_Masters-R64-Vasek_Pospisil-Richard_Gasquet,1,F-DTM,23,3,0,0,3,13,10
20131008-M-Shanghai_Masters-R64-Vasek_Pospisil-Richard_Gasquet,1,F-DTL,2,1,1,0,0,2,0
20131008-M-Shanghai_Masters-R64-Vasek_Pospisil-Richard_Gasquet,1,F-IO,22,9,4,1,4,14,8
20131008-M-Shanghai_Masters-R64-Vasek_Pospisil-Richard_Gasquet,1,F-II,7,6,2,2,2,5,2
20131008-M-Shanghai_Masters-R64-Vasek_Pospisil-Richard_Gasquet,1,B-XC,4,1,0,0,1,0,4
20131008-M-Shanghai_Masters-R64-Vasek_Pospisil-Richard_Gasquet,1,B-DTM,15,4,0,0,4,6,9
20131008-M-Shanghai_Masters-R64-Vasek_Pospisil-Richard_Gasquet,1,B-DTL,1,0,0,0,0,1,0
20131008-M-Shanghai_Masters-R64-Vasek_Pospisil-Richard_Gasquet,1,B-IO,1,1,0,0,1,0,1
20131008-M-Shanghai_Masters-R64-Vasek_Pospisil-Richard_Gasquet,1,S-XC,2,0,0,0,0,1,1
20131008-M-Shanghai_Masters-R64-Vasek_Pospisil-Richard_Gasquet,1,S-DTM,3,0,0,0,0,1,2
20131008-M-Shanghai_Masters-R64-Vasek_Pospisil-Richard_Gasquet,1,S-DTL,2,0,0,0,0,2,0
20131008-M-Shanghai_Masters-R64-Vasek_Pospisil-Richard_Gasquet,2,F-XC,11,1,1,0,0,3,8
20131008-M-Shanghai_Masters-R64-Vasek_Pospisil-Richard_Gasquet,2,F-DTM,28,3,0,0,3,11,17
20131008-M-Shanghai_Masters-R64-Vasek_Pospisil-Richard_Gasquet,2,F-DTL,4,0,0,0,0,2,2
20131008-M-Shanghai_Masters-R64-Vasek_Pospisil-Richard_Gasquet,2,F-IO,6,3,1,1,1,4,2
20131008-M-Shanghai_Masters-R64-Vasek_Pospisil-Richard_Gasquet,2,F-II,1,1,0,0,1,0,1
20131008-M-Shanghai_Masters-R64-Vasek_Pospisil-Richard_Gasquet,2,B-XC,14,2,1,0,1,7,7
20131008-M-Shanghai_Masters-R64-Vasek_Pospisil-Richard_Gasquet,2,B-DTM,9,1,0,0,1,2,7
20131008-M-Shanghai_Masters-R64-Vasek_Pospisil-Richard_Gasquet,2,B-DTL,3,2,1,0,1,1,2
20131008-M-Shanghai_Masters-R64-Vasek_Pospisil-Richard_Gasquet,2,B-IO,3,1,1,0,0,3,0
20131008-M-Shanghai_Masters-R64-Vasek_Pospisil-Richard_Gasquet,2,S-XC,5,1,0,0,1,1,4
20131008-M-Shanghai_Masters-R64-Vasek_Pospisil-Richard_Gasquet,2,S-DTM,4,0,0,0,0,1,3
20131007-M-Shanghai_Masters-R64-Gilles_Simon-Benoit_Paire,1,F-XC,30,6,2,1,3,17,13
20131007-M-Shanghai_Masters-R64-Gilles_Simon-Benoit_Paire,1,F-DTM,25,2,0,0,2,12,13
20131007-M-Shanghai_Masters-R64-Gilles_Simon-Benoit_Paire,1,F-DTL,3,3,0,1,2,1,2
20131007-M-Shanghai_Masters-R64-Gilles_Simon-Benoit_Paire,1,F-IO,8,2,1,0,1,4,4
20131007-M-Shanghai_Masters-R64-Gilles_Simon-Benoit_Paire,1,F-II,2,1,0,1,0,2,0
20131007-M-Shanghai_Masters-R64-Gilles_Simon-Benoit_Paire,1,B-XC,31,8,0,4,4,14,17
20131007-M-Shanghai_Masters-R64-Gilles_Simon-Benoit_Paire,1,B-DTM,28,3,0,0,3,14,14
20131007-M-Shanghai_Masters-R64-Gilles_Simon-Benoit_Paire,1,B-DTL,5,1,0,0,1,2,3
20131007-M-Shanghai_Masters-R64-Gilles_Simon-Benoit_Paire,1,B-IO,1,0,0,0,0,1,0
20131007-M-Shanghai_Masters-R64-Gilles_Simon-Benoit_Paire,1,S-DTM,2,0,0,0,0,2,0
20131007-M-Shanghai_Masters-R64-Gilles_Simon-Benoit_Paire,1,S-DTL,1,0,0,0,0,0,1
20131007-M-Shanghai_Masters-R64-Gilles_Simon-Benoit_Paire,2,F-XC,26,9,2,0,7,11,15
20131007-M-Shanghai_Masters-R64-Gilles_Simon-Benoit_Paire,2,F-DTM,22,3,0,0,3,8,14
20131007-M-Shanghai_Masters-R64-Gilles_Simon-Benoit_Paire,2,F-DTL,4,1,0,0,1,1,3
20131007-M-Shanghai_Masters-R64-Gilles_Simon-Benoit_Paire,2,F-IO,9,3,1,0,2,3,6
20131007-M-Shanghai_Masters-R64-Gilles_Simon-Benoit_Paire,2,B-XC,36,7,3,1,3,25,11
20131007-M-Shanghai_Masters-R64-Gilles_Simon-Benoit_Paire,2,B-DTM,11,1,0,0,1,6,5
20131007-M-Shanghai_Masters-R64-Gilles_Simon-Benoit_Paire,2,B-DTL,3,2,1,1,0,3,0
20131007-M-Shanghai_Masters-R64-Gilles_Simon-Benoit_Paire,2,B-IO,4,1,0,0,1,2,2
20131007-M-Shanghai_Masters-R64-Gilles_Simon-Benoit_Paire,2,B-II,1,0,0,0,0,0,1
20131007-M-Shanghai_Masters-R64-Gilles_Simon-Benoit_Paire,2,S-XC,5,0,0,0,0,1,4
20131007-M-Shanghai_Masters-R64-Gilles_Simon-Benoit_Paire,2,S-DTM,2,0,0,0,0,0,2
20131007-M-Shanghai_Masters-R64-Gilles_Simon-Benoit_Paire,2,S-DTL,1,1,0,0,1,0,1
20140902-M-Shanghai_CH-R32-John_Millman-Ze_Zhang,1,F-XC,38,5,1,3,1,24,14
20140902-M-Shanghai_CH-R32-John_Millman-Ze_Zhang,1,F-DTM,12,0,0,0,0,4,8
20140902-M-Shanghai_CH-R32-John_Millman-Ze_Zhang,1,F-DTL,6,3,2,0,1,4,2
20140902-M-Shanghai_CH-R32-John_Millman-Ze_Zhang,1,F-IO,9,5,1,1,3,4,5
20140902-M-Shanghai_CH-R32-John_Millman-Ze_Zhang,1,F-II,2,1,1,0,0,2,0
20140902-M-Shanghai_CH-R32-John_Millman-Ze_Zhang,1,B-XC,34,5,2,0,3,20,14
20140902-M-Shanghai_CH-R32-John_Millman-Ze_Zhang,1,B-DTM,17,1,0,0,1,9,8
20140902-M-Shanghai_CH-R32-John_Millman-Ze_Zhang,1,B-DTL,11,2,1,1,0,8,3
20140902-M-Shanghai_CH-R32-John_Millman-Ze_Zhang,1,B-IO,1,0,0,0,0,1,0
20140902-M-Shanghai_CH-R32-John_Millman-Ze_Zhang,1,S-XC,2,0,0,0,0,0,2
20140902-M-Shanghai_CH-R32-John_Millman-Ze_Zhang,1,S-DTM,2,0,0,0,0,1,1
20140902-M-Shanghai_CH-R32-John_Millman-Ze_Zhang,2,F-XC,37,10,2,1,7,14,23
20140902-M-Shanghai_CH-R32-John_Millman-Ze_Zhang,2,F-DTM,15,3,0,1,2,6,9
20140902-M-Shanghai_CH-R32-John_Millman-Ze_Zhang,2,F-DTL,13,4,1,0,3,4,9
20140902-M-Shanghai_CH-R32-John_Millman-Ze_Zhang,2,F-IO,22,8,4,1,3,14,8
20140902-M-Shanghai_CH-R32-John_Millman-Ze_Zhang,2,F-II,3,2,0,0,2,0,3
20140902-M-Shanghai_CH-R32-John_Millman-Ze_Zhang,2,B-XC,20,2,1,0,1,9,11
20140902-M-Shanghai_CH-R32-John_Millman-Ze_Zhang,2,B-DTM,17,3,0,0,3,4,13
20140902-M-Shanghai_CH-R32-John_Millman-Ze_Zhang,2,B-DTL,7,2,1,0,1,5,2
20140902-M-Shanghai_CH-R32-John_Millman-Ze_Zhang,2,B-IO,3,3,0,1,2,1,2
20140902-M-Shanghai_CH-R32-John_Millman-Ze_Zhang,2,S-XC,2,0,0,0,0,0,2
20140902-M-Shanghai_CH-R32-John_Millman-Ze_Zhang,2,S-DTM,1,0,0,0,0,1,0
20131013-M-Shanghai_Masters-F-Novak_Djokovic-Juan_Martin_Del_Potro,1,F-XC,40,13,6,3,4,27,13
20131013-M-Shanghai_Masters-F-Novak_Djokovic-Juan_Martin_Del_Potro,1,F-DTM,44,3,0,0,3,16,28
20131013-M-Shanghai_Masters-F-Novak_Djokovic-Juan_Martin_Del_Potro,1,F-DTL,18,5,1,0,4,7,11
20131013-M-Shanghai_Masters-F-Novak_Djokovic-Juan_Martin_Del_Potro,1,F-IO,47,15,5,5,5,31,16
20131013-M-Shanghai_Masters-F-Novak_Djokovic-Juan_Martin_Del_Potro,1,F-II,1,0,0,0,0,0,1
20131013-M-Shanghai_Masters-F-Novak_Djokovic-Juan_Martin_Del_Potro,1,B-XC,35,2,1,0,1,20,15
20131013-M-Shanghai_Masters-F-Novak_Djokovic-Juan_Martin_Del_Potro,1,B-DTM,66,3,1,0,2,36,30
20131013-M-Shanghai_Masters-F-Novak_Djokovic-Juan_Martin_Del_Potro,1,B-DTL,12,8,3,2,3,8,4
20131013-M-Shanghai_Masters-F-Novak_Djokovic-Juan_Martin_Del_Potro,1,B-IO,11,6,4,1,1,8,3
20131013-M-Shanghai_Masters-F-Novak_Djokovic-Juan_Martin_Del_Potro,1,S-XC,13,1,1,0,0,7,6
20131013-M-Shanghai_Masters-F-Novak_Djokovic-Juan_Martin_Del_Potro,1,S-DTM,9,0,0,0,0,6,3
20131013-M-Shanghai_Masters-F-Novak_Djokovic-Juan_Martin_Del_Potro,1,S-DTL,1,0,0,0,0,0,1
20131013-M-Shanghai_Masters-F-Novak_Djokovic-Juan_Martin_Del_Potro,1,S-IO,3,2,0,2,0,3,0
20131013-M-Shanghai_Masters-F-Novak_Djokovic-Juan_Martin_Del_Potro,2,F-XC,58,13,7,2,4,31,27
20131013-M-Shanghai_Masters-F-Novak_Djokovic-Juan_Martin_Del_Potro,2,F-DTM,46,2,0,0,2,19,27
20131013-M-Shanghai_Masters-F-Novak_Djokovic-Juan_Martin_Del_Potro,2,F-DTL,9,5,2,1,2,3,6
20131013-M-Shanghai_Masters-F-Novak_Djokovic-Juan_Martin_Del_Potro,2,F-IO,48,15,5,5,5,27,21
20131013-M-Shanghai_Masters-F-Novak_Djokovic-Juan_Martin_Del_Potro,2,F-II,2,0,0,0,0,2,0
20131013-M-Shanghai_Masters-F-Novak_Djokovic-Juan_Martin_Del_Potro,2,B-XC,44,6,1,1,4,25,19
20131013-M-Shanghai_Masters-F-Novak_Djokovic-Juan_Martin_Del_Potro,2,B-DTM,69,2,0,0,2,28,41
20131013-M-Shanghai_Masters-F-Novak_Djokovic-Juan_Martin_Del_Potro,2,B-DTL,6,2,0,2,0,3,3
20131013-M-Shanghai_Masters-F-Novak_Djokovic-Juan_Martin_Del_Potro,2,B-IO,6,2,1,0,1,4,2
20131013-M-Shanghai_Masters-F-Novak_Djokovic-Juan_Martin_Del_Potro,2,S-XC,8,0,0,0,0,3,5
20131013-M-Shanghai_Masters-F-Novak_Djokovic-Juan_Martin_Del_Potro,2,S-DTM,17,0,0,0,0,2,15
20131013-M-Shanghai_Masters-F-Novak_Djokovic-Juan_Martin_Del_Potro,2,S-DTL,2,0,0,0,0,0,2
20140415-M-San_Luis_Potosi_CH-R32-Paolo_Lorenzi-Mauricio_Echazu,1,F-XC,17,2,0,1,1,11,6
20140415-M-San_Luis_Potosi_CH-R32-Paolo_Lorenzi-Mauricio_Echazu,1,F-DTM,23,2,0,0,2,17,6
20140415-M-San_Luis_Potosi_CH-R32-Paolo_Lorenzi-Mauricio_Echazu,1,F-DTL,7,0,0,0,0,5,2
20140415-M-San_Luis_Potosi_CH-R32-Paolo_Lorenzi-Mauricio_Echazu,1,F-IO,20,8,2,2,4,14,6
20140415-M-San_Luis_Potosi_CH-R32-Paolo_Lorenzi-Mauricio_Echazu,1,B-XC,22,3,0,0,3,14,8
20140415-M-San_Luis_Potosi_CH-R32-Paolo_Lorenzi-Mauricio_Echazu,1,B-DTM,22,2,0,0,2,10,12
20140415-M-San_Luis_Potosi_CH-R32-Paolo_Lorenzi-Mauricio_Echazu,1,B-DTL,7,3,0,0,3,4,3
20140415-M-San_Luis_Potosi_CH-R32-Paolo_Lorenzi-Mauricio_Echazu,1,B-IO,5,0,0,0,0,4,1
20140415-M-San_Luis_Potosi_CH-R32-Paolo_Lorenzi-Mauricio_Echazu,1,S-XC,5,0,0,0,0,3,2
20140415-M-San_Luis_Potosi_CH-R32-Paolo_Lorenzi-Mauricio_Echazu,1,S-DTM,4,0,0,0,0,3,1
20140415-M-San_Luis_Potosi_CH-R32-Paolo_Lorenzi-Mauricio_Echazu,1,S-DTL,1,0,0,0,0,0,1
20140415-M-San_Luis_Potosi_CH-R32-Paolo_Lorenzi-Mauricio_Echazu,2,F-XC,37,11,2,2,7,11,26
20140415-M-San_Luis_Potosi_CH-R32-Paolo_Lorenzi-Mauricio_Echazu,2,F-DTM,35,8,0,0,8,9,26
20140415-M-San_Luis_Potosi_CH-R32-Paolo_Lorenzi-Mauricio_Echazu,2,F-DTL,8,3,0,0,3,3,5
20140415-M-San_Luis_Potosi_CH-R32-Paolo_Lorenzi-Mauricio_Echazu,2,F-IO,28,8,4,0,4,13,15
20140415-M-San_Luis_Potosi_CH-R32-Paolo_Lorenzi-Mauricio_Echazu,2,F-II,1,1,0,1,0,1,0
20140415-M-San_Luis_Potosi_CH-R32-Paolo_Lorenzi-Mauricio_Echazu,2,B-XC,27,6,0,0,6,5,22
20140415-M-San_Luis_Potosi_CH-R32-Paolo_Lorenzi-Mauricio_Echazu,2,B-DTM,14,2,0,0,2,4,10
20140415-M-San_Luis_Potosi_CH-R32-Paolo_Lorenzi-Mauricio_Echazu,2,B-DTL,1,0,0,0,0,0,1
20140415-M-San_Luis_Potosi_CH-R32-Paolo_Lorenzi-Mauricio_Echazu,2,B-IO,3,2,1,0,1,2,1
20140415-M-San_Luis_Potosi_CH-R32-Paolo_Lorenzi-Mauricio_Echazu,2,S-DTM,1,0,0,0,0,0,1
20140414-M-Sao_Paulo_CH-R32-Horacio_Zeballos-Ricardo_Hocevar,1,F-XC,29,5,3,1,1,20,9
20140414-M-Sao_Paulo_CH-R32-Horacio_Zeballos-Ricardo_Hocevar,1,F-DTM,21,6,1,0,5,11,10
20140414-M-Sao_Paulo_CH-R32-Horacio_Zeballos-Ricardo_Hocevar,1,F-DTL,3,2,1,0,1,2,1
20140414-M-Sao_Paulo_CH-R32-Horacio_Zeballos-Ricardo_Hocevar,1,F-IO,13,8,3,3,2,7,6
20140414-M-Sao_Paulo_CH-R32-Horacio_Zeballos-Ricardo_Hocevar,1,F-II,3,0,0,0,0,0,3
20140414-M-Sao_Paulo_CH-R32-Horacio_Zeballos-Ricardo_Hocevar,1,B-XC,8,2,0,0,2,4,4
20140414-M-Sao_Paulo_CH-R32-Horacio_Zeballos-Ricardo_Hocevar,1,B-DTM,5,1,0,0,1,2,3
20140414-M-Sao_Paulo_CH-R32-Horacio_Zeballos-Ricardo_Hocevar,1,B-DTL,7,3,0,0,3,4,3
20140414-M-Sao_Paulo_CH-R32-Horacio_Zeballos-Ricardo_Hocevar,1,S-XC,2,0,0,0,0,1,1
20140414-M-Sao_Paulo_CH-R32-Horacio_Zeballos-Ricardo_Hocevar,1,S-DTM,2,1,0,1,0,2,0
20140414-M-Sao_Paulo_CH-R32-Horacio_Zeballos-Ricardo_Hocevar,1,S-DTL,2,1,0,0,1,0,2
20140414-M-Sao_Paulo_CH-R32-Horacio_Zeballos-Ricardo_Hocevar,2,F-XC,14,2,1,0,1,8,6
20140414-M-Sao_Paulo_CH-R32-Horacio_Zeballos-Ricardo_Hocevar,2,F-DTM,13,3,0,0,3,5,8
20140414-M-Sao_Paulo_CH-R32-Horacio_Zeballos-Ricardo_Hocevar,2,F-DTL,2,2,2,0,0,2,0
20140414-M-Sao_Paulo_CH-R32-Horacio_Zeballos-Ricardo_Hocevar,2,F-IO,11,4,0,1,3,3,8
20140414-M-Sao_Paulo_CH-R32-Horacio_Zeballos-Ricardo_Hocevar,2,F-II,2,1,0,0,1,0,2
20140414-M-Sao_Paulo_CH-R32-Horacio_Zeballos-Ricardo_Hocevar,2,B-XC,11,2,2,0,0,8,3
20140414-M-Sao_Paulo_CH-R32-Horacio_Zeballos-Ricardo_Hocevar,2,B-DTM,17,2,0,0,2,5,12
20140414-M-Sao_Paulo_CH-R32-Horacio_Zeballos-Ricardo_Hocevar,2,B-DTL,9,3,0,1,2,5,4
20140414-M-Sao_Paulo_CH-R32-Horacio_Zeballos-Ricardo_Hocevar,2,B-IO,3,0,0,0,0,2,1
20140414-M-Sao_Paulo_CH-R32-Horacio_Zeballos-Ricardo_Hocevar,2,S-XC,2,1,1,0,0,1,1
20140414-M-Sao_Paulo_CH-R32-Horacio_Zeballos-Ricardo_Hocevar,2,S-DTM,1,1,0,0,1,0,1
20140414-M-Sao_Paulo_CH-R32-Horacio_Zeballos-Ricardo_Hocevar,2,S-DTL,1,1,0,0,1,0,1
20141018-M-Stockholm-SF-Tomas_Berdych-Matthias_Bachinger,1,F-XC,35,9,3,3,3,26,9
20141018-M-Stockholm-SF-Tomas_Berdych-Matthias_Bachinger,1,F-DTM,13,1,0,0,1,7,6
20141018-M-Stockholm-SF-Tomas_Berdych-Matthias_Bachinger,1,F-DTL,7,5,2,1,2,4,3
20141018-M-Stockholm-SF-Tomas_Berdych-Matthias_Bachinger,1,F-IO,28,11,3,3,5,20,8
20141018-M-Stockholm-SF-Tomas_Berdych-Matthias_Bachinger,1,F-II,5,2,2,0,0,3,2
20141018-M-Stockholm-SF-Tomas_Berdych-Matthias_Bachinger,1,B-XC,10,4,1,0,3,5,5
20141018-M-Stockholm-SF-Tomas_Berdych-Matthias_Bachinger,1,B-DTM,9,1,0,0,1,4,5
20141018-M-Stockholm-SF-Tomas_Berdych-Matthias_Bachinger,1,B-IO,1,0,0,0,0,1,0
20141018-M-Stockholm-SF-Tomas_Berdych-Matthias_Bachinger,1,S-XC,4,1,0,1,0,4,0
20141018-M-Stockholm-SF-Tomas_Berdych-Matthias_Bachinger,1,S-DTM,1,0,0,0,0,0,1
20141018-M-Stockholm-SF-Tomas_Berdych-Matthias_Bachinger,1,S-DTL,1,0,0,0,0,1,0
20141018-M-Stockholm-SF-Tomas_Berdych-Matthias_Bachinger,2,F-XC,11,5,2,0,3,5,6
20141018-M-Stockholm-SF-Tomas_Berdych-Matthias_Bachinger,2,F-DTM,23,4,0,2,2,7,16
20141018-M-Stockholm-SF-Tomas_Berdych-Matthias_Bachinger,2,F-DTL,3,2,0,0,2,0,3
20141018-M-Stockholm-SF-Tomas_Berdych-Matthias_Bachinger,2,F-IO,8,5,1,1,3,4,4
20141018-M-Stockholm-SF-Tomas_Berdych-Matthias_Bachinger,2,B-XC,12,3,0,2,1,6,6
20141018-M-Stockholm-SF-Tomas_Berdych-Matthias_Bachinger,2,B-DTM,8,0,0,0,0,3,5
20141018-M-Stockholm-SF-Tomas_Berdych-Matthias_Bachinger,2,B-DTL,4,1,0,0,1,0,4
20141018-M-Stockholm-SF-Tomas_Berdych-Matthias_Bachinger,2,B-IO,3,1,0,0,1,0,3
20141018-M-Stockholm-SF-Tomas_Berdych-Matthias_Bachinger,2,S-XC,9,1,0,0,1,1,8
20141018-M-Stockholm-SF-Tomas_Berdych-Matthias_Bachinger,2,S-DTM,8,0,0,0,0,0,8
20141018-M-Stockholm-SF-Tomas_Berdych-Matthias_Bachinger,2,S-DTL,2,0,0,0,0,1,1
20141018-M-Stockholm-SF-Tomas_Berdych-Matthias_Bachinger,2,S-IO,2,0,0,0,0,1,1
20140709-M-Stuttgart-R32-Alexander_Zverev-Lukas_Rosol,1,F-XC,31,5,3,0,2,19,12
20140709-M-Stuttgart-R32-Alexander_Zverev-Lukas_Rosol,1,F-DTM,29,7,0,0,7,12,17
20140709-M-Stuttgart-R32-Alexander_Zverev-Lukas_Rosol,1,F-DTL,8,2,1,1,0,7,1
20140709-M-Stuttgart-R32-Alexander_Zverev-Lukas_Rosol,1,F-IO,8,3,1,0,2,2,6
20140709-M-Stuttgart-R32-Alexander_Zverev-Lukas_Rosol,1,F-II,1,1,1,0,0,1,0
20140709-M-Stuttgart-R32-Alexander_Zverev-Lukas_Rosol,1,B-XC,46,7,1,1,5,23,23
20140709-M-Stuttgart-R32-Alexander_Zverev-Lukas_Rosol,1,B-DTM,31,4,1,0,3,12,19
20140709-M-Stuttgart-R32-Alexander_Zverev-Lukas_Rosol,1,B-DTL,5,5,3,0,2,3,2
20140709-M-Stuttgart-R32-Alexander_Zverev-Lukas_Rosol,1,B-IO,7,2,0,1,1,5,2
20140709-M-Stuttgart-R32-Alexander_Zverev-Lukas_Rosol,1,S-XC,4,2,0,0,2,0,4
20140709-M-Stuttgart-R32-Alexander_Zverev-Lukas_Rosol,1,S-DTM,8,0,0,0,0,4,4
20140709-M-Stuttgart-R32-Alexander_Zverev-Lukas_Rosol,1,S-IO,1,1,0,0,1,0,1
20140709-M-Stuttgart-R32-Alexander_Zverev-Lukas_Rosol,2,F-XC,37,12,3,3,6,17,20
20140709-M-Stuttgart-R32-Alexander_Zverev-Lukas_Rosol,2,F-DTM,25,9,0,2,7,10,15
20140709-M-Stuttgart-R32-Alexander_Zverev-Lukas_Rosol,2,F-DTL,6,2,0,0,2,2,4
20140709-M-Stuttgart-R32-Alexander_Zverev-Lukas_Rosol,2,F-IO,34,15,5,1,9,20,14
20140709-M-Stuttgart-R32-Alexander_Zverev-Lukas_Rosol,2,F-II,2,2,1,0,1,1,1
20140709-M-Stuttgart-R32-Alexander_Zverev-Lukas_Rosol,2,B-XC,29,2,0,0,2,16,13
20140709-M-Stuttgart-R32-Alexander_Zverev-Lukas_Rosol,2,B-DTM,27,2,0,0,2,13,14
20140709-M-Stuttgart-R32-Alexander_Zverev-Lukas_Rosol,2,B-DTL,3,1,0,1,0,2,1
20140709-M-Stuttgart-R32-Alexander_Zverev-Lukas_Rosol,2,B-IO,4,2,2,0,0,3,1
20140709-M-Stuttgart-R32-Alexander_Zverev-Lukas_Rosol,2,S-XC,8,0,0,0,0,4,4
20140709-M-Stuttgart-R32-Alexander_Zverev-Lukas_Rosol,2,S-DTM,8,2,0,0,2,3,5
20140709-M-Stuttgart-R32-Alexander_Zverev-Lukas_Rosol,2,S-DTL,3,1,0,0,1,1,2
20140709-M-Stuttgart-R32-Alexander_Zverev-Lukas_Rosol,2,S-IO,1,0,0,0,0,1,0
20140111-M-Sydney-F-Bernard_Tomic-Juan_Martin_Del_Potro,1,F-XC,26,4,0,1,3,11,15
20140111-M-Sydney-F-Bernard_Tomic-Juan_Martin_Del_Potro,1,F-DTM,8,2,0,1,1,5,3
20140111-M-Sydney-F-Bernard_Tomic-Juan_Martin_Del_Potro,1,F-DTL,8,1,1,0,0,2,6
20140111-M-Sydney-F-Bernard_Tomic-Juan_Martin_Del_Potro,1,F-IO,24,11,4,1,6,9,15
20140111-M-Sydney-F-Bernard_Tomic-Juan_Martin_Del_Potro,1,F-II,1,0,0,0,0,0,1
20140111-M-Sydney-F-Bernard_Tomic-Juan_Martin_Del_Potro,1,B-XC,10,0,0,0,0,6,4
20140111-M-Sydney-F-Bernard_Tomic-Juan_Martin_Del_Potro,1,B-DTM,14,2,0,0,2,2,12
20140111-M-Sydney-F-Bernard_Tomic-Juan_Martin_Del_Potro,1,B-DTL,11,7,1,1,5,3,8
20140111-M-Sydney-F-Bernard_Tomic-Juan_Martin_Del_Potro,1,B-IO,3,1,0,0,1,0,3
20140111-M-Sydney-F-Bernard_Tomic-Juan_Martin_Del_Potro,1,B-II,1,0,0,0,0,0,1
20140111-M-Sydney-F-Bernard_Tomic-Juan_Martin_Del_Potro,1,S-XC,13,0,0,0,0,4,9
20140111-M-Sydney-F-Bernard_Tomic-Juan_Martin_Del_Potro,1,S-DTM,8,0,0,0,0,4,4
20140111-M-Sydney-F-Bernard_Tomic-Juan_Martin_Del_Potro,1,S-DTL,2,0,0,0,0,1,1
20140111-M-Sydney-F-Bernard_Tomic-Juan_Martin_Del_Potro,1,S-IO,3,0,0,0,0,0,3
20140111-M-Sydney-F-Bernard_Tomic-Juan_Martin_Del_Potro,2,F-XC,34,10,3,5,2,25,9
20140111-M-Sydney-F-Bernard_Tomic-Juan_Martin_Del_Potro,2,F-DTM,11,2,0,0,2,5,6
20140111-M-Sydney-F-Bernard_Tomic-Juan_Martin_Del_Potro,2,F-DTL,8,5,3,2,0,8,0
20140111-M-Sydney-F-Bernard_Tomic-Juan_Martin_Del_Potro,2,F-IO,24,3,3,0,0,12,12
20140111-M-Sydney-F-Bernard_Tomic-Juan_Martin_Del_Potro,2,F-II,3,2,1,1,0,3,0
20140111-M-Sydney-F-Bernard_Tomic-Juan_Martin_Del_Potro,2,B-XC,8,0,0,0,0,8,0
20140111-M-Sydney-F-Bernard_Tomic-Juan_Martin_Del_Potro,2,B-DTM,13,1,0,0,1,7,6
20140111-M-Sydney-F-Bernard_Tomic-Juan_Martin_Del_Potro,2,S-XC,13,1,0,0,1,9,4
20140111-M-Sydney-F-Bernard_Tomic-Juan_Martin_Del_Potro,2,S-DTM,10,0,0,0,0,8,2
20140111-M-Sydney-F-Bernard_Tomic-Juan_Martin_Del_Potro,2,S-DTL,1,1,0,1,0,1,0
20130109-M-Sydney-R16-Bernard_Tomic-Florian_Mayer,1,F-XC,13,4,3,0,1,10,3
20130109-M-Sydney-R16-Bernard_Tomic-Florian_Mayer,1,F-DTM,15,0,0,0,0,12,3
20130109-M-Sydney-R16-Bernard_Tomic-Florian_Mayer,1,F-DTL,11,3,2,0,1,9,2
20130109-M-Sydney-R16-Bernard_Tomic-Florian_Mayer,1,F-IO,16,9,5,3,1,13,3
20130109-M-Sydney-R16-Bernard_Tomic-Florian_Mayer,1,F-II,1,1,1,0,0,1,0
20130109-M-Sydney-R16-Bernard_Tomic-Florian_Mayer,1,B-XC,11,2,0,1,1,6,5
20130109-M-Sydney-R16-Bernard_Tomic-Florian_Mayer,1,B-DTM,10,2,0,0,2,6,4
20130109-M-Sydney-R16-Bernard_Tomic-Florian_Mayer,1,B-DTL,7,4,2,0,2,3,4
20130109-M-Sydney-R16-Bernard_Tomic-Florian_Mayer,1,B-IO,5,5,5,0,0,5,0
20130109-M-Sydney-R16-Bernard_Tomic-Florian_Mayer,1,S-XC,11,1,0,0,1,9,2
20130109-M-Sydney-R16-Bernard_Tomic-Florian_Mayer,1,S-DTM,24,2,0,1,1,17,7
20130109-M-Sydney-R16-Bernard_Tomic-Florian_Mayer,1,S-DTL,9,0,0,0,0,6,3
20130109-M-Sydney-R16-Bernard_Tomic-Florian_Mayer,1,S-IO,5,0,0,0,0,4,1
20130109-M-Sydney-R16-Bernard_Tomic-Florian_Mayer,1,S-II,1,0,0,0,0,1,0
20130109-M-Sydney-R16-Bernard_Tomic-Florian_Mayer,2,F-XC,24,11,3,2,6,8,16
20130109-M-Sydney-R16-Bernard_Tomic-Florian_Mayer,2,F-DTM,15,0,0,0,0,4,11
20130109-M-Sydney-R16-Bernard_Tomic-Florian_Mayer,2,F-DTL,12,3,2,0,1,5,7
20130109-M-Sydney-R16-Bernard_Tomic-Florian_Mayer,2,F-IO,9,4,0,0,4,1,8
20130109-M-Sydney-R16-Bernard_Tomic-Florian_Mayer,2,B-XC,27,5,1,3,1,11,16
20130109-M-Sydney-R16-Bernard_Tomic-Florian_Mayer,2,B-DTM,15,3,0,1,2,3,12
20130109-M-Sydney-R16-Bernard_Tomic-Florian_Mayer,2,B-DTL,5,2,1,0,1,1,4
20130109-M-Sydney-R16-Bernard_Tomic-Florian_Mayer,2,B-IO,6,3,0,2,1,3,3
20130109-M-Sydney-R16-Bernard_Tomic-Florian_Mayer,2,S-XC,11,0,0,0,0,1,10
20130109-M-Sydney-R16-Bernard_Tomic-Florian_Mayer,2,S-DTM,10,0,0,0,0,4,6
20130109-M-Sydney-R16-Bernard_Tomic-Florian_Mayer,2,S-DTL,1,0,0,0,0,0,1
20130109-M-Sydney-R16-Bernard_Tomic-Florian_Mayer,2,S-IO,1,0,0,0,0,0,1
20130108-M-Sydney-R32-Bernard_Tomic-Marinko_Matosevic,1,F-XC,26,10,4,1,5,15,11
20130108-M-Sydney-R32-Bernard_Tomic-Marinko_Matosevic,1,F-DTM,13,2,0,1,1,10,3
20130108-M-Sydney-R32-Bernard_Tomic-Marinko_Matosevic,1,F-DTL,7,3,2,0,1,3,4
20130108-M-Sydney-R32-Bernard_Tomic-Marinko_Matosevic,1,F-IO,16,6,4,1,1,11,5
20130108-M-Sydney-R32-Bernard_Tomic-Marinko_Matosevic,1,F-II,1,1,1,0,0,1,0
20130108-M-Sydney-R32-Bernard_Tomic-Marinko_Matosevic,1,B-XC,19,1,1,0,0,12,7
20130108-M-Sydney-R32-Bernard_Tomic-Marinko_Matosevic,1,B-DTM,8,1,0,0,1,3,5
20130108-M-Sydney-R32-Bernard_Tomic-Marinko_Matosevic,1,B-DTL,6,3,1,0,2,3,3
20130108-M-Sydney-R32-Bernard_Tomic-Marinko_Matosevic,1,B-IO,3,2,0,0,2,1,2
20130108-M-Sydney-R32-Bernard_Tomic-Marinko_Matosevic,1,S-XC,15,2,1,0,1,10,5
20130108-M-Sydney-R32-Bernard_Tomic-Marinko_Matosevic,1,S-DTM,10,0,0,0,0,5,5
20130108-M-Sydney-R32-Bernard_Tomic-Marinko_Matosevic,1,S-DTL,1,1,0,0,1,0,1
20130108-M-Sydney-R32-Bernard_Tomic-Marinko_Matosevic,1,S-IO,1,1,0,0,1,0,1
20130108-M-Sydney-R32-Bernard_Tomic-Marinko_Matosevic,2,F-XC,21,8,2,1,5,12,9
20130108-M-Sydney-R32-Bernard_Tomic-Marinko_Matosevic,2,F-DTM,18,1,0,0,1,6,12
20130108-M-Sydney-R32-Bernard_Tomic-Marinko_Matosevic,2,F-DTL,1,0,0,0,0,1,0
20130108-M-Sydney-R32-Bernard_Tomic-Marinko_Matosevic,2,F-IO,14,5,2,3,0,7,7
20130108-M-Sydney-R32-Bernard_Tomic-Marinko_Matosevic,2,F-II,1,0,0,0,0,0,1
20130108-M-Sydney-R32-Bernard_Tomic-Marinko_Matosevic,2,B-XC,29,4,1,1,2,12,17
20130108-M-Sydney-R32-Bernard_Tomic-Marinko_Matosevic,2,B-DTM,26,3,0,0,3,9,17
20130108-M-Sydney-R32-Bernard_Tomic-Marinko_Matosevic,2,B-DTL,4,3,1,1,1,3,1
20130108-M-Sydney-R32-Bernard_Tomic-Marinko_Matosevic,2,B-IO,3,1,0,0,1,1,2
20130108-M-Sydney-R32-Bernard_Tomic-Marinko_Matosevic,2,S-XC,6,1,0,0,1,3,3
20130108-M-Sydney-R32-Bernard_Tomic-Marinko_Matosevic,2,S-DTM,3,0,0,0,0,2,1
20130108-M-Sydney-R32-Bernard_Tomic-Marinko_Matosevic,2,S-DTL,2,2,0,0,2,0,2
20140109-M-Sydney-QF-Marinko_Matosevic-Sergiy_Stakhovsky,1,F-XC,27,10,1,3,6,11,16
20140109-M-Sydney-QF-Marinko_Matosevic-Sergiy_Stakhovsky,1,F-DTM,15,1,0,0,1,5,10
20140109-M-Sydney-QF-Marinko_Matosevic-Sergiy_Stakhovsky,1,F-DTL,7,4,0,0,4,3,4
20140109-M-Sydney-QF-Marinko_Matosevic-Sergiy_Stakhovsky,1,F-IO,17,7,1,2,4,8,9
20140109-M-Sydney-QF-Marinko_Matosevic-Sergiy_Stakhovsky,1,F-II,3,1,0,1,0,2,1
20140109-M-Sydney-QF-Marinko_Matosevic-Sergiy_Stakhovsky,1,B-XC,22,4,1,0,3,10,12
20140109-M-Sydney-QF-Marinko_Matosevic-Sergiy_Stakhovsky,1,B-DTM,19,1,0,0,1,7,12
20140109-M-Sydney-QF-Marinko_Matosevic-Sergiy_Stakhovsky,1,B-DTL,8,6,2,1,3,3,5
20140109-M-Sydney-QF-Marinko_Matosevic-Sergiy_Stakhovsky,1,B-IO,3,0,0,0,0,2,1
20140109-M-Sydney-QF-Marinko_Matosevic-Sergiy_Stakhovsky,1,S-XC,4,1,0,0,1,1,3
20140109-M-Sydney-QF-Marinko_Matosevic-Sergiy_Stakhovsky,1,S-DTM,6,0,0,0,0,0,6
20140109-M-Sydney-QF-Marinko_Matosevic-Sergiy_Stakhovsky,1,S-DTL,2,0,0,0,0,0,2
20140109-M-Sydney-QF-Marinko_Matosevic-Sergiy_Stakhovsky,1,S-IO,2,1,0,0,1,0,2
20140109-M-Sydney-QF-Marinko_Matosevic-Sergiy_Stakhovsky,1,S-II,1,0,0,0,0,1,0
20140109-M-Sydney-QF-Marinko_Matosevic-Sergiy_Stakhovsky,2,F-XC,15,4,1,0,3,9,6
20140109-M-Sydney-QF-Marinko_Matosevic-Sergiy_Stakhovsky,2,F-DTM,16,3,0,0,3,10,6
20140109-M-Sydney-QF-Marinko_Matosevic-Sergiy_Stakhovsky,2,F-DTL,10,4,1,1,2,6,4
20140109-M-Sydney-QF-Marinko_Matosevic-Sergiy_Stakhovsky,2,F-IO,14,5,1,0,4,7,7
20140109-M-Sydney-QF-Marinko_Matosevic-Sergiy_Stakhovsky,2,F-II,3,1,0,0,1,1,2
20140109-M-Sydney-QF-Marinko_Matosevic-Sergiy_Stakhovsky,2,B-XC,7,3,1,0,2,4,3
20140109-M-Sydney-QF-Marinko_Matosevic-Sergiy_Stakhovsky,2,B-DTM,12,1,0,0,1,8,4
20140109-M-Sydney-QF-Marinko_Matosevic-Sergiy_Stakhovsky,2,B-DTL,8,1,0,0,1,4,4
20140109-M-Sydney-QF-Marinko_Matosevic-Sergiy_Stakhovsky,2,B-IO,1,0,0,0,0,0,1
20140109-M-Sydney-QF-Marinko_Matosevic-Sergiy_Stakhovsky,2,S-XC,8,1,0,0,1,4,4
20140109-M-Sydney-QF-Marinko_Matosevic-Sergiy_Stakhovsky,2,S-DTM,12,4,0,0,4,7,5
20140109-M-Sydney-QF-Marinko_Matosevic-Sergiy_Stakhovsky,2,S-DTL,5,0,0,0,0,2,3
20140109-M-Sydney-QF-Marinko_Matosevic-Sergiy_Stakhovsky,2,S-IO,1,0,0,0,0,0,1
20131006-M-Tokyo-F-Juan_Martin_Del_Potro-Milos_Raonic,1,F-XC,26,8,4,3,1,15,11
20131006-M-Tokyo-F-Juan_Martin_Del_Potro-Milos_Raonic,1,F-DTM,8,1,0,0,1,4,4
20131006-M-Tokyo-F-Juan_Martin_Del_Potro-Milos_Raonic,1,F-DTL,7,2,2,0,0,5,2
20131006-M-Tokyo-F-Juan_Martin_Del_Potro-Milos_Raonic,1,F-IO,22,6,4,2,0,12,10
20131006-M-Tokyo-F-Juan_Martin_Del_Potro-Milos_Raonic,1,F-II,6,3,0,2,1,5,1
20131006-M-Tokyo-F-Juan_Martin_Del_Potro-Milos_Raonic,1,B-XC,20,1,0,0,1,16,4
20131006-M-Tokyo-F-Juan_Martin_Del_Potro-Milos_Raonic,1,B-DTM,14,0,0,0,0,7,7
20131006-M-Tokyo-F-Juan_Martin_Del_Potro-Milos_Raonic,1,B-DTL,5,3,2,1,0,3,2
20131006-M-Tokyo-F-Juan_Martin_Del_Potro-Milos_Raonic,1,B-IO,2,1,1,0,0,2,0
20131006-M-Tokyo-F-Juan_Martin_Del_Potro-Milos_Raonic,1,B-II,1,0,0,0,0,0,1
20131006-M-Tokyo-F-Juan_Martin_Del_Potro-Milos_Raonic,1,S-XC,7,1,0,0,1,3,4
20131006-M-Tokyo-F-Juan_Martin_Del_Potro-Milos_Raonic,1,S-DTM,1,0,0,0,0,1,0
20131006-M-Tokyo-F-Juan_Martin_Del_Potro-Milos_Raonic,1,S-DTL,1,1,0,0,1,0,1
20131006-M-Tokyo-F-Juan_Martin_Del_Potro-Milos_Raonic,2,F-XC,21,6,1,1,4,10,11
20131006-M-Tokyo-F-Juan_Martin_Del_Potro-Milos_Raonic,2,F-DTM,4,0,0,0,0,0,4
20131006-M-Tokyo-F-Juan_Martin_Del_Potro-Milos_Raonic,2,F-DTL,11,4,1,2,1,8,3
20131006-M-Tokyo-F-Juan_Martin_Del_Potro-Milos_Raonic,2,F-IO,30,12,2,5,5,12,18
20131006-M-Tokyo-F-Juan_Martin_Del_Potro-Milos_Raonic,2,F-II,4,3,2,0,1,2,2
20131006-M-Tokyo-F-Juan_Martin_Del_Potro-Milos_Raonic,2,B-XC,7,3,2,0,1,3,4
20131006-M-Tokyo-F-Juan_Martin_Del_Potro-Milos_Raonic,2,B-DTM,7,1,0,1,0,3,4
20131006-M-Tokyo-F-Juan_Martin_Del_Potro-Milos_Raonic,2,B-DTL,7,7,3,1,3,4,3
20131006-M-Tokyo-F-Juan_Martin_Del_Potro-Milos_Raonic,2,B-IO,1,0,0,0,0,1,0
20131006-M-Tokyo-F-Juan_Martin_Del_Potro-Milos_Raonic,2,S-XC,14,0,0,0,0,9,5
20131006-M-Tokyo-F-Juan_Martin_Del_Potro-Milos_Raonic,2,S-DTM,5,2,0,0,2,1,4
20131006-M-Tokyo-F-Juan_Martin_Del_Potro-Milos_Raonic,2,S-DTL,4,1,0,1,0,3,1
20131006-M-Tokyo-F-Juan_Martin_Del_Potro-Milos_Raonic,2,S-IO,1,1,0,1,0,1,0
20140930-M-Tokyo-R32-Stanislas_Wawrinka-Tatsuma_Ito,1,F-XC,35,7,0,1,6,14,21
20140930-M-Tokyo-R32-Stanislas_Wawrinka-Tatsuma_Ito,1,F-DTM,34,2,0,0,2,15,19
20140930-M-Tokyo-R32-Stanislas_Wawrinka-Tatsuma_Ito,1,F-DTL,10,7,1,1,5,3,7
20140930-M-Tokyo-R32-Stanislas_Wawrinka-Tatsuma_Ito,1,F-IO,15,8,1,1,6,7,8
20140930-M-Tokyo-R32-Stanislas_Wawrinka-Tatsuma_Ito,1,B-XC,32,3,0,0,3,19,13
20140930-M-Tokyo-R32-Stanislas_Wawrinka-Tatsuma_Ito,1,B-DTM,16,4,0,0,4,6,10
20140930-M-Tokyo-R32-Stanislas_Wawrinka-Tatsuma_Ito,1,B-DTL,6,5,2,1,2,3,3
20140930-M-Tokyo-R32-Stanislas_Wawrinka-Tatsuma_Ito,1,B-IO,2,2,1,1,0,2,0
20140930-M-Tokyo-R32-Stanislas_Wawrinka-Tatsuma_Ito,1,S-XC,4,2,0,1,1,2,2
20140930-M-Tokyo-R32-Stanislas_Wawrinka-Tatsuma_Ito,1,S-DTM,5,1,0,0,1,0,5
20140930-M-Tokyo-R32-Stanislas_Wawrinka-Tatsuma_Ito,1,S-IO,1,0,0,0,0,1,0
20140930-M-Tokyo-R32-Stanislas_Wawrinka-Tatsuma_Ito,2,F-XC,48,12,2,2,8,27,21
20140930-M-Tokyo-R32-Stanislas_Wawrinka-Tatsuma_Ito,2,F-DTM,19,1,0,0,1,8,11
20140930-M-Tokyo-R32-Stanislas_Wawrinka-Tatsuma_Ito,2,F-DTL,4,2,1,0,1,3,1
20140930-M-Tokyo-R32-Stanislas_Wawrinka-Tatsuma_Ito,2,F-IO,18,6,1,4,1,12,6
20140930-M-Tokyo-R32-Stanislas_Wawrinka-Tatsuma_Ito,2,B-XC,28,3,0,1,2,11,17
20140930-M-Tokyo-R32-Stanislas_Wawrinka-Tatsuma_Ito,2,B-DTM,22,2,0,0,2,8,14
20140930-M-Tokyo-R32-Stanislas_Wawrinka-Tatsuma_Ito,2,B-DTL,10,7,3,0,4,4,6
20140930-M-Tokyo-R32-Stanislas_Wawrinka-Tatsuma_Ito,2,B-IO,6,0,0,0,0,4,2
20140930-M-Tokyo-R32-Stanislas_Wawrinka-Tatsuma_Ito,2,S-XC,3,0,0,0,0,3,0
20140930-M-Tokyo-R32-Stanislas_Wawrinka-Tatsuma_Ito,2,S-DTM,6,1,0,0,1,1,5
20140930-M-Tokyo-R32-Stanislas_Wawrinka-Tatsuma_Ito,2,S-DTL,1,1,0,0,1,0,1
20140930-M-Tokyo-R32-Stanislas_Wawrinka-Tatsuma_Ito,2,S-IO,1,0,0,0,0,1,0
20141022-M-Toyota_CH-SF-Yuichi_Sugita-Go_Soeda,1,F-XC,32,14,3,5,6,16,16
20141022-M-Toyota_CH-SF-Yuichi_Sugita-Go_Soeda,1,F-DTM,29,5,0,1,4,13,16
20141022-M-Toyota_CH-SF-Yuichi_Sugita-Go_Soeda,1,F-DTL,5,4,1,0,3,2,3
20141022-M-Toyota_CH-SF-Yuichi_Sugita-Go_Soeda,1,F-IO,24,10,3,1,6,12,12
20141022-M-Toyota_CH-SF-Yuichi_Sugita-Go_Soeda,1,F-II,1,1,0,0,1,0,1
20141022-M-Toyota_CH-SF-Yuichi_Sugita-Go_Soeda,1,B-XC,31,12,3,2,7,13,18
20141022-M-Toyota_CH-SF-Yuichi_Sugita-Go_Soeda,1,B-DTM,28,3,0,1,2,10,18
20141022-M-Toyota_CH-SF-Yuichi_Sugita-Go_Soeda,1,B-DTL,3,1,1,0,0,1,2
20141022-M-Toyota_CH-SF-Yuichi_Sugita-Go_Soeda,1,B-IO,5,4,2,1,1,4,1
20141022-M-Toyota_CH-SF-Yuichi_Sugita-Go_Soeda,1,S-XC,6,2,0,0,2,2,4
20141022-M-Toyota_CH-SF-Yuichi_Sugita-Go_Soeda,1,S-DTM,10,1,0,0,1,3,7
20141022-M-Toyota_CH-SF-Yuichi_Sugita-Go_Soeda,2,F-XC,23,9,4,1,4,16,7
20141022-M-Toyota_CH-SF-Yuichi_Sugita-Go_Soeda,2,F-DTM,24,2,0,0,2,12,12
20141022-M-Toyota_CH-SF-Yuichi_Sugita-Go_Soeda,2,F-DTL,6,3,1,0,2,2,4
20141022-M-Toyota_CH-SF-Yuichi_Sugita-Go_Soeda,2,F-IO,28,11,4,3,4,20,8
20141022-M-Toyota_CH-SF-Yuichi_Sugita-Go_Soeda,2,B-XC,22,3,0,1,2,10,12
20141022-M-Toyota_CH-SF-Yuichi_Sugita-Go_Soeda,2,B-DTM,32,3,0,0,3,19,13
20141022-M-Toyota_CH-SF-Yuichi_Sugita-Go_Soeda,2,B-DTL,6,4,0,1,3,3,3
20141022-M-Toyota_CH-SF-Yuichi_Sugita-Go_Soeda,2,B-IO,4,2,0,1,1,1,3
20141022-M-Toyota_CH-SF-Yuichi_Sugita-Go_Soeda,2,S-XC,1,0,0,0,0,0,1
20141022-M-Toyota_CH-SF-Yuichi_Sugita-Go_Soeda,2,S-DTM,2,0,0,0,0,1,1
20141022-M-Toyota_CH-SF-Yuichi_Sugita-Go_Soeda,2,S-DTL,3,0,0,0,0,0,3
20140502-M-Tunis_CH-SF-Mate_Delic-Simone_Bolelli,1,F-XC,49,12,0,2,10,25,24
20140502-M-Tunis_CH-SF-Mate_Delic-Simone_Bolelli,1,F-DTM,31,6,0,0,6,13,18
20140502-M-Tunis_CH-SF-Mate_Delic-Simone_Bolelli,1,F-DTL,8,5,1,1,3,3,5
20140502-M-Tunis_CH-SF-Mate_Delic-Simone_Bolelli,1,F-IO,7,0,0,0,0,4,3
20140502-M-Tunis_CH-SF-Mate_Delic-Simone_Bolelli,1,F-II,1,1,1,0,0,1,0
20140502-M-Tunis_CH-SF-Mate_Delic-Simone_Bolelli,1,B-XC,55,8,0,0,8,31,24
20140502-M-Tunis_CH-SF-Mate_Delic-Simone_Bolelli,1,B-DTM,22,2,0,0,2,8,14
20140502-M-Tunis_CH-SF-Mate_Delic-Simone_Bolelli,1,B-DTL,3,3,1,1,1,2,1
20140502-M-Tunis_CH-SF-Mate_Delic-Simone_Bolelli,1,B-IO,3,0,0,0,0,3,0
20140502-M-Tunis_CH-SF-Mate_Delic-Simone_Bolelli,1,S-XC,4,0,0,0,0,3,1
20140502-M-Tunis_CH-SF-Mate_Delic-Simone_Bolelli,1,S-DTM,1,0,0,0,0,1,0
20140502-M-Tunis_CH-SF-Mate_Delic-Simone_Bolelli,2,F-XC,58,17,5,2,10,33,25
20140502-M-Tunis_CH-SF-Mate_Delic-Simone_Bolelli,2,F-DTM,30,4,0,0,4,12,18
20140502-M-Tunis_CH-SF-Mate_Delic-Simone_Bolelli,2,F-DTL,9,4,0,1,3,3,6
20140502-M-Tunis_CH-SF-Mate_Delic-Simone_Bolelli,2,F-IO,36,8,6,0,2,17,19
20140502-M-Tunis_CH-SF-Mate_Delic-Simone_Bolelli,2,F-II,7,3,2,0,1,4,3
20140502-M-Tunis_CH-SF-Mate_Delic-Simone_Bolelli,2,B-XC,15,0,0,0,0,8,7
20140502-M-Tunis_CH-SF-Mate_Delic-Simone_Bolelli,2,B-DTM,20,4,0,0,4,6,14
20140502-M-Tunis_CH-SF-Mate_Delic-Simone_Bolelli,2,B-DTL,3,2,1,0,1,1,2
20140502-M-Tunis_CH-SF-Mate_Delic-Simone_Bolelli,2,S-XC,6,0,0,0,0,2,4
20140502-M-Tunis_CH-SF-Mate_Delic-Simone_Bolelli,2,S-DTM,5,0,0,0,0,2,3
20140721-M-Umag-R32-Ante_Pavic-Horacio_Zeballos,1,F-XC,16,6,0,0,6,5,11
20140721-M-Umag-R32-Ante_Pavic-Horacio_Zeballos,1,F-DTM,21,1,0,0,1,10,11
20140721-M-Umag-R32-Ante_Pavic-Horacio_Zeballos,1,F-DTL,5,3,1,0,2,2,3
20140721-M-Umag-R32-Ante_Pavic-Horacio_Zeballos,1,F-IO,17,4,1,0,3,5,12
20140721-M-Umag-R32-Ante_Pavic-Horacio_Zeballos,1,F-II,2,2,0,1,1,1,1
20140721-M-Umag-R32-Ante_Pavic-Horacio_Zeballos,1,B-XC,13,6,2,0,4,4,9
20140721-M-Umag-R32-Ante_Pavic-Horacio_Zeballos,1,B-DTM,15,3,0,0,3,2,13
20140721-M-Umag-R32-Ante_Pavic-Horacio_Zeballos,1,B-DTL,12,5,0,0,5,2,10
20140721-M-Umag-R32-Ante_Pavic-Horacio_Zeballos,1,B-IO,5,2,1,0,1,1,4
20140721-M-Umag-R32-Ante_Pavic-Horacio_Zeballos,1,S-XC,2,0,0,0,0,0,2
20140721-M-Umag-R32-Ante_Pavic-Horacio_Zeballos,1,S-DTM,2,0,0,0,0,1,1
20140721-M-Umag-R32-Ante_Pavic-Horacio_Zeballos,1,S-DTL,2,0,0,0,0,1,1
20140721-M-Umag-R32-Ante_Pavic-Horacio_Zeballos,2,F-XC,41,10,1,5,4,29,12
20140721-M-Umag-R32-Ante_Pavic-Horacio_Zeballos,2,F-DTM,7,0,0,0,0,7,0
20140721-M-Umag-R32-Ante_Pavic-Horacio_Zeballos,2,F-DTL,13,9,5,0,4,8,5
20140721-M-Umag-R32-Ante_Pavic-Horacio_Zeballos,2,F-IO,14,7,0,5,2,11,3
20140721-M-Umag-R32-Ante_Pavic-Horacio_Zeballos,2,B-XC,22,10,4,3,3,15,7
20140721-M-Umag-R32-Ante_Pavic-Horacio_Zeballos,2,B-DTM,9,0,0,0,0,4,5
20140721-M-Umag-R32-Ante_Pavic-Horacio_Zeballos,2,B-DTL,7,2,0,0,2,5,2
20140721-M-Umag-R32-Ante_Pavic-Horacio_Zeballos,2,B-IO,8,1,0,0,1,5,3
20140721-M-Umag-R32-Ante_Pavic-Horacio_Zeballos,2,S-DTM,2,1,0,0,1,0,2
20140721-M-Umag-R32-Ante_Pavic-Horacio_Zeballos,2,S-DTL,4,0,0,0,0,1,3
20140721-M-Umag-R32-Ante_Pavic-Horacio_Zeballos,2,S-IO,1,0,0,0,0,1,0
20140906-M-US_Open-SF-Marin_Cilic-Roger_Federer,1,F-XC,21,7,3,2,2,18,3
20140906-M-US_Open-SF-Marin_Cilic-Roger_Federer,1,F-DTM,25,4,0,1,3,13,12
20140906-M-US_Open-SF-Marin_Cilic-Roger_Federer,1,F-DTL,2,1,0,0,1,0,2
20140906-M-US_Open-SF-Marin_Cilic-Roger_Federer,1,F-IO,41,9,2,2,5,24,17
20140906-M-US_Open-SF-Marin_Cilic-Roger_Federer,1,F-II,6,4,2,2,0,4,2
20140906-M-US_Open-SF-Marin_Cilic-Roger_Federer,1,B-XC,36,7,1,0,6,18,18
20140906-M-US_Open-SF-Marin_Cilic-Roger_Federer,1,B-DTM,13,1,0,0,1,6,7
20140906-M-US_Open-SF-Marin_Cilic-Roger_Federer,1,B-DTL,6,6,4,1,1,5,1
20140906-M-US_Open-SF-Marin_Cilic-Roger_Federer,1,B-IO,5,4,1,1,2,3,2
20140906-M-US_Open-SF-Marin_Cilic-Roger_Federer,1,S-XC,3,0,0,0,0,0,3
20140906-M-US_Open-SF-Marin_Cilic-Roger_Federer,1,S-DTM,2,0,0,0,0,0,2
20140906-M-US_Open-SF-Marin_Cilic-Roger_Federer,1,S-IO,1,0,0,0,0,1,0
20140906-M-US_Open-SF-Marin_Cilic-Roger_Federer,2,F-XC,12,5,1,1,3,3,9
20140906-M-US_Open-SF-Marin_Cilic-Roger_Federer,2,F-DTM,31,5,1,0,4,11,20
20140906-M-US_Open-SF-Marin_Cilic-Roger_Federer,2,F-DTL,3,2,0,0,2,1,2
20140906-M-US_Open-SF-Marin_Cilic-Roger_Federer,2,F-IO,14,7,3,0,4,7,7
20140906-M-US_Open-SF-Marin_Cilic-Roger_Federer,2,F-II,4,2,1,0,1,1,3
20140906-M-US_Open-SF-Marin_Cilic-Roger_Federer,2,B-XC,15,4,0,1,3,7,8
20140906-M-US_Open-SF-Marin_Cilic-Roger_Federer,2,B-DTM,37,5,0,0,5,18,19
20140906-M-US_Open-SF-Marin_Cilic-Roger_Federer,2,B-DTL,6,1,1,0,0,4,2
20140906-M-US_Open-SF-Marin_Cilic-Roger_Federer,2,B-IO,3,1,0,1,0,2,1
20140906-M-US_Open-SF-Marin_Cilic-Roger_Federer,2,S-XC,23,1,0,0,1,7,16
20140906-M-US_Open-SF-Marin_Cilic-Roger_Federer,2,S-DTM,3,0,0,0,0,2,1
20140908-M-US_Open-F-Marin_Cilic-Kei_Nishikori,1,F-XC,32,12,6,0,6,10,22
20140908-M-US_Open-F-Marin_Cilic-Kei_Nishikori,1,F-DTM,38,2,0,0,2,24,14
20140908-M-US_Open-F-Marin_Cilic-Kei_Nishikori,1,F-DTL,8,3,1,0,2,5,3
20140908-M-US_Open-F-Marin_Cilic-Kei_Nishikori,1,F-IO,37,9,3,5,1,26,11
20140908-M-US_Open-F-Marin_Cilic-Kei_Nishikori,1,F-II,1,0,0,0,0,1,0
20140908-M-US_Open-F-Marin_Cilic-Kei_Nishikori,1,B-XC,33,11,2,3,6,23,10
20140908-M-US_Open-F-Marin_Cilic-Kei_Nishikori,1,B-DTM,29,5,0,0,5,18,11
20140908-M-US_Open-F-Marin_Cilic-Kei_Nishikori,1,B-DTL,3,2,2,0,0,2,1
20140908-M-US_Open-F-Marin_Cilic-Kei_Nishikori,1,S-XC,14,1,0,0,1,7,7
20140908-M-US_Open-F-Marin_Cilic-Kei_Nishikori,1,S-DTM,10,2,0,1,1,7,3
20140908-M-US_Open-F-Marin_Cilic-Kei_Nishikori,1,S-DTL,1,0,0,0,0,1,0
20140908-M-US_Open-F-Marin_Cilic-Kei_Nishikori,1,S-IO,2,0,0,0,0,2,0
20140908-M-US_Open-F-Marin_Cilic-Kei_Nishikori,2,F-XC,37,8,3,1,4,23,14
20140908-M-US_Open-F-Marin_Cilic-Kei_Nishikori,2,F-DTM,30,3,0,0,3,12,18
20140908-M-US_Open-F-Marin_Cilic-Kei_Nishikori,2,F-DTL,4,4,3,0,1,3,1
20140908-M-US_Open-F-Marin_Cilic-Kei_Nishikori,2,F-IO,23,7,3,1,3,8,15
20140908-M-US_Open-F-Marin_Cilic-Kei_Nishikori,2,F-II,4,4,2,1,1,3,1
20140908-M-US_Open-F-Marin_Cilic-Kei_Nishikori,2,B-XC,48,8,0,0,8,14,34
20140908-M-US_Open-F-Marin_Cilic-Kei_Nishikori,2,B-DTM,38,3,0,0,3,13,25
20140908-M-US_Open-F-Marin_Cilic-Kei_Nishikori,2,B-DTL,10,6,0,1,5,3,7
20140908-M-US_Open-F-Marin_Cilic-Kei_Nishikori,2,B-IO,5,1,1,0,0,1,4
20140908-M-US_Open-F-Marin_Cilic-Kei_Nishikori,2,S-XC,7,0,0,0,0,3,4
20140908-M-US_Open-F-Marin_Cilic-Kei_Nishikori,2,S-DTM,5,0,0,0,0,0,5
20140908-M-US_Open-F-Marin_Cilic-Kei_Nishikori,2,S-DTL,1,0,0,0,0,0,1
20140908-M-US_Open-F-Marin_Cilic-Kei_Nishikori,2,S-IO,1,0,0,0,0,0,1
20141021-M-Valencia-R32-Norbert_Gombos-Feliciano_Lopez,1,F-XC,20,4,2,2,0,10,10
20141021-M-Valencia-R32-Norbert_Gombos-Feliciano_Lopez,1,F-DTM,13,3,1,0,2,5,8
20141021-M-Valencia-R32-Norbert_Gombos-Feliciano_Lopez,1,F-DTL,8,5,3,1,1,6,2
20141021-M-Valencia-R32-Norbert_Gombos-Feliciano_Lopez,1,F-IO,12,6,4,0,2,5,7
20141021-M-Valencia-R32-Norbert_Gombos-Feliciano_Lopez,1,F-II,2,1,0,0,1,0,2
20141021-M-Valencia-R32-Norbert_Gombos-Feliciano_Lopez,1,B-XC,24,7,1,3,3,13,11
20141021-M-Valencia-R32-Norbert_Gombos-Feliciano_Lopez,1,B-DTM,15,4,0,1,3,5,10
20141021-M-Valencia-R32-Norbert_Gombos-Feliciano_Lopez,1,B-DTL,3,2,1,0,1,2,1
20141021-M-Valencia-R32-Norbert_Gombos-Feliciano_Lopez,1,B-IO,3,1,0,0,1,2,1
20141021-M-Valencia-R32-Norbert_Gombos-Feliciano_Lopez,1,S-XC,1,0,0,0,0,1,0
20141021-M-Valencia-R32-Norbert_Gombos-Feliciano_Lopez,1,S-DTL,2,1,0,0,1,0,2
20141021-M-Valencia-R32-Norbert_Gombos-Feliciano_Lopez,2,F-XC,23,2,0,0,2,10,13
20141021-M-Valencia-R32-Norbert_Gombos-Feliciano_Lopez,2,F-DTM,15,2,1,0,1,10,5
20141021-M-Valencia-R32-Norbert_Gombos-Feliciano_Lopez,2,F-DTL,1,0,0,0,0,0,1
20141021-M-Valencia-R32-Norbert_Gombos-Feliciano_Lopez,2,F-IO,4,2,0,0,2,2,2
20141021-M-Valencia-R32-Norbert_Gombos-Feliciano_Lopez,2,B-XC,5,3,2,0,1,2,3
20141021-M-Valencia-R32-Norbert_Gombos-Feliciano_Lopez,2,B-DTM,9,4,0,2,2,6,3
20141021-M-Valencia-R32-Norbert_Gombos-Feliciano_Lopez,2,B-DTL,1,0,0,0,0,1,0
20141021-M-Valencia-R32-Norbert_Gombos-Feliciano_Lopez,2,S-XC,1,0,0,0,0,1,0
20141021-M-Valencia-R32-Norbert_Gombos-Feliciano_Lopez,2,S-DTM,11,1,0,0,1,6,5
20141021-M-Valencia-R32-Norbert_Gombos-Feliciano_Lopez,2,S-DTL,1,1,0,1,0,1,0
20141021-M-Valencia-R32-Norbert_Gombos-Feliciano_Lopez,2,S-IO,5,0,0,0,0,3,2
20141020-M-Valencia-R32-Stefan_Kozlov-Martin_Klizan,1,F-XC,36,7,1,2,4,17,19
20141020-M-Valencia-R32-Stefan_Kozlov-Martin_Klizan,1,F-DTM,14,2,0,0,2,4,10
20141020-M-Valencia-R32-Stefan_Kozlov-Martin_Klizan,1,F-DTL,4,2,0,0,2,0,4
20141020-M-Valencia-R32-Stefan_Kozlov-Martin_Klizan,1,F-IO,13,2,1,0,1,6,7
20141020-M-Valencia-R32-Stefan_Kozlov-Martin_Klizan,1,F-II,3,2,0,1,1,1,2
20141020-M-Valencia-R32-Stefan_Kozlov-Martin_Klizan,1,B-XC,22,3,0,0,3,8,14
20141020-M-Valencia-R32-Stefan_Kozlov-Martin_Klizan,1,B-DTM,34,1,0,0,1,19,15
20141020-M-Valencia-R32-Stefan_Kozlov-Martin_Klizan,1,B-DTL,10,4,1,1,2,4,6
20141020-M-Valencia-R32-Stefan_Kozlov-Martin_Klizan,1,B-IO,2,0,0,0,0,0,2
20141020-M-Valencia-R32-Stefan_Kozlov-Martin_Klizan,1,S-XC,2,0,0,0,0,1,1
20141020-M-Valencia-R32-Stefan_Kozlov-Martin_Klizan,1,S-DTM,5,1,0,0,1,2,3
20141020-M-Valencia-R32-Stefan_Kozlov-Martin_Klizan,1,S-DTL,2,0,0,0,0,1,1
20141020-M-Valencia-R32-Stefan_Kozlov-Martin_Klizan,2,F-XC,61,11,2,3,6,33,28
20141020-M-Valencia-R32-Stefan_Kozlov-Martin_Klizan,2,F-DTM,12,2,0,0,2,9,3
20141020-M-Valencia-R32-Stefan_Kozlov-Martin_Klizan,2,F-DTL,2,2,1,0,1,1,1
20141020-M-Valencia-R32-Stefan_Kozlov-Martin_Klizan,2,F-IO,12,6,4,1,1,7,5
20141020-M-Valencia-R32-Stefan_Kozlov-Martin_Klizan,2,F-II,3,3,2,0,1,2,1
20141020-M-Valencia-R32-Stefan_Kozlov-Martin_Klizan,2,B-XC,28,5,1,1,3,14,14
20141020-M-Valencia-R32-Stefan_Kozlov-Martin_Klizan,2,B-DTM,26,2,0,0,2,13,13
20141020-M-Valencia-R32-Stefan_Kozlov-Martin_Klizan,2,B-DTL,7,2,1,0,1,4,3
20141020-M-Valencia-R32-Stefan_Kozlov-Martin_Klizan,2,B-IO,4,1,1,0,0,3,1
20141020-M-Valencia-R32-Stefan_Kozlov-Martin_Klizan,2,S-DTM,1,0,0,0,0,1,0
20141020-M-Valencia-R32-Stefan_Kozlov-Martin_Klizan,2,S-DTL,1,1,0,1,0,1,0
20141025-M-Valencia-SF-David_Ferrer-Andy_Murray,1,F-XC,66,9,2,1,6,38,28
20141025-M-Valencia-SF-David_Ferrer-Andy_Murray,1,F-DTM,38,1,0,0,1,14,24
20141025-M-Valencia-SF-David_Ferrer-Andy_Murray,1,F-DTL,15,5,3,0,2,8,7
20141025-M-Valencia-SF-David_Ferrer-Andy_Murray,1,F-IO,55,9,1,3,5,28,27
20141025-M-Valencia-SF-David_Ferrer-Andy_Murray,1,F-II,17,6,1,1,4,9,8
20141025-M-Valencia-SF-David_Ferrer-Andy_Murray,1,B-XC,91,5,0,0,5,50,41
20141025-M-Valencia-SF-David_Ferrer-Andy_Murray,1,B-DTM,30,2,0,0,2,11,19
20141025-M-Valencia-SF-David_Ferrer-Andy_Murray,1,B-DTL,5,2,0,1,1,2,3
20141025-M-Valencia-SF-David_Ferrer-Andy_Murray,1,B-IO,1,0,0,0,0,0,1
20141025-M-Valencia-SF-David_Ferrer-Andy_Murray,1,S-XC,5,1,0,0,1,2,3
20141025-M-Valencia-SF-David_Ferrer-Andy_Murray,1,S-DTM,7,0,0,0,0,3,4
20141025-M-Valencia-SF-David_Ferrer-Andy_Murray,2,F-XC,50,9,4,2,3,25,25
20141025-M-Valencia-SF-David_Ferrer-Andy_Murray,2,F-DTM,35,1,0,0,1,15,20
20141025-M-Valencia-SF-David_Ferrer-Andy_Murray,2,F-DTL,20,5,0,0,5,8,12
20141025-M-Valencia-SF-David_Ferrer-Andy_Murray,2,F-IO,35,7,3,1,3,22,13
20141025-M-Valencia-SF-David_Ferrer-Andy_Murray,2,F-II,5,3,0,0,3,1,4
20141025-M-Valencia-SF-David_Ferrer-Andy_Murray,2,B-XC,93,11,1,1,9,44,49
20141025-M-Valencia-SF-David_Ferrer-Andy_Murray,2,B-DTM,43,4,0,0,4,19,24
20141025-M-Valencia-SF-David_Ferrer-Andy_Murray,2,B-DTL,16,5,2,1,2,9,7
20141025-M-Valencia-SF-David_Ferrer-Andy_Murray,2,B-IO,6,2,0,1,1,2,4
20141025-M-Valencia-SF-David_Ferrer-Andy_Murray,2,S-XC,15,2,0,1,1,10,5
20141025-M-Valencia-SF-David_Ferrer-Andy_Murray,2,S-DTM,9,0,0,0,0,3,6
20141025-M-Valencia-SF-David_Ferrer-Andy_Murray,2,S-DTL,4,1,0,0,1,0,4
20141025-M-Valencia-SF-David_Ferrer-Andy_Murray,2,S-IO,1,0,0,0,0,1,0
20140530-M-Vicenza_CH-QF-Yoshihito_Nishioka-Andrej_Martin,1,F-XC,80,4,1,2,1,55,25
20140530-M-Vicenza_CH-QF-Yoshihito_Nishioka-Andrej_Martin,1,F-DTM,12,1,0,0,1,8,4
20140530-M-Vicenza_CH-QF-Yoshihito_Nishioka-Andrej_Martin,1,F-DTL,9,3,2,0,1,6,3
20140530-M-Vicenza_CH-QF-Yoshihito_Nishioka-Andrej_Martin,1,F-IO,8,3,1,1,1,6,2
20140530-M-Vicenza_CH-QF-Yoshihito_Nishioka-Andrej_Martin,1,F-II,2,0,0,0,0,1,1
20140530-M-Vicenza_CH-QF-Yoshihito_Nishioka-Andrej_Martin,1,B-XC,84,11,3,3,5,46,38
20140530-M-Vicenza_CH-QF-Yoshihito_Nishioka-Andrej_Martin,1,B-DTM,55,2,0,0,2,24,31
20140530-M-Vicenza_CH-QF-Yoshihito_Nishioka-Andrej_Martin,1,B-DTL,21,2,1,0,1,14,7
20140530-M-Vicenza_CH-QF-Yoshihito_Nishioka-Andrej_Martin,1,B-IO,14,1,0,1,0,10,4
20140530-M-Vicenza_CH-QF-Yoshihito_Nishioka-Andrej_Martin,1,S-DTM,3,1,0,1,0,2,1
20140530-M-Vicenza_CH-QF-Yoshihito_Nishioka-Andrej_Martin,1,S-DTL,3,0,0,0,0,1,2
20140530-M-Vicenza_CH-QF-Yoshihito_Nishioka-Andrej_Martin,1,S-IO,1,0,0,0,0,1,0
20140530-M-Vicenza_CH-QF-Yoshihito_Nishioka-Andrej_Martin,2,F-XC,82,12,3,4,5,43,39
20140530-M-Vicenza_CH-QF-Yoshihito_Nishioka-Andrej_Martin,2,F-DTM,22,0,0,0,0,9,13
20140530-M-Vicenza_CH-QF-Yoshihito_Nishioka-Andrej_Martin,2,F-DTL,22,10,1,2,6,8,14
20140530-M-Vicenza_CH-QF-Yoshihito_Nishioka-Andrej_Martin,2,F-IO,40,9,5,0,4,20,20
20140530-M-Vicenza_CH-QF-Yoshihito_Nishioka-Andrej_Martin,2,F-II,8,3,1,0,2,4,4
20140530-M-Vicenza_CH-QF-Yoshihito_Nishioka-Andrej_Martin,2,B-XC,34,3,0,1,2,8,26
20140530-M-Vicenza_CH-QF-Yoshihito_Nishioka-Andrej_Martin,2,B-DTM,33,3,0,0,3,13,20
20140530-M-Vicenza_CH-QF-Yoshihito_Nishioka-Andrej_Martin,2,B-DTL,24,5,1,0,4,7,17
20140530-M-Vicenza_CH-QF-Yoshihito_Nishioka-Andrej_Martin,2,B-IO,12,4,0,1,3,6,6
20140530-M-Vicenza_CH-QF-Yoshihito_Nishioka-Andrej_Martin,2,S-XC,8,0,0,0,0,2,6
20140530-M-Vicenza_CH-QF-Yoshihito_Nishioka-Andrej_Martin,2,S-DTM,17,0,0,0,0,10,7
20140530-M-Vicenza_CH-QF-Yoshihito_Nishioka-Andrej_Martin,2,S-DTL,10,0,0,0,0,3,7
20140530-M-Vicenza_CH-QF-Yoshihito_Nishioka-Andrej_Martin,2,S-IO,2,0,0,0,0,1,1
20141018-M-Vienna-SF-Viktor_Troicki-Andy_Murray,1,F-XC,25,0,0,0,0,10,15
20141018-M-Vienna-SF-Viktor_Troicki-Andy_Murray,1,F-DTM,26,3,0,0,3,6,20
20141018-M-Vienna-SF-Viktor_Troicki-Andy_Murray,1,F-DTL,8,2,1,1,0,4,4
20141018-M-Vienna-SF-Viktor_Troicki-Andy_Murray,1,F-IO,10,4,1,0,3,3,7
20141018-M-Vienna-SF-Viktor_Troicki-Andy_Murray,1,F-II,4,0,0,0,0,0,4
20141018-M-Vienna-SF-Viktor_Troicki-Andy_Murray,1,B-XC,25,4,1,2,1,12,13
20141018-M-Vienna-SF-Viktor_Troicki-Andy_Murray,1,B-DTM,19,5,0,0,5,6,13
20141018-M-Vienna-SF-Viktor_Troicki-Andy_Murray,1,B-DTL,5,4,1,0,3,1,4
20141018-M-Vienna-SF-Viktor_Troicki-Andy_Murray,1,B-IO,11,3,0,0,3,4,7
20141018-M-Vienna-SF-Viktor_Troicki-Andy_Murray,1,S-XC,3,1,0,0,1,1,2
20141018-M-Vienna-SF-Viktor_Troicki-Andy_Murray,1,S-DTM,3,0,0,0,0,0,3
20141018-M-Vienna-SF-Viktor_Troicki-Andy_Murray,1,S-DTL,1,0,0,0,0,0,1
20141018-M-Vienna-SF-Viktor_Troicki-Andy_Murray,2,F-XC,46,12,9,0,3,35,11
20141018-M-Vienna-SF-Viktor_Troicki-Andy_Murray,2,F-DTM,19,2,0,1,1,12,7
20141018-M-Vienna-SF-Viktor_Troicki-Andy_Murray,2,F-DTL,8,4,2,1,1,6,2
20141018-M-Vienna-SF-Viktor_Troicki-Andy_Murray,2,F-IO,13,4,1,2,1,9,4
20141018-M-Vienna-SF-Viktor_Troicki-Andy_Murray,2,F-II,1,0,0,0,0,1,0
20141018-M-Vienna-SF-Viktor_Troicki-Andy_Murray,2,B-XC,16,5,0,2,3,8,8
20141018-M-Vienna-SF-Viktor_Troicki-Andy_Murray,2,B-DTM,20,4,0,2,2,11,9
20141018-M-Vienna-SF-Viktor_Troicki-Andy_Murray,2,B-DTL,5,3,0,1,2,3,2
20141018-M-Vienna-SF-Viktor_Troicki-Andy_Murray,2,S-XC,9,0,0,0,0,9,0
20141018-M-Vienna-SF-Viktor_Troicki-Andy_Murray,2,S-DTM,14,2,0,0,2,8,6
20141018-M-Vienna-SF-Viktor_Troicki-Andy_Murray,2,S-DTL,3,1,0,0,1,1,2
20141018-M-Vienna-SF-Viktor_Troicki-Andy_Murray,2,S-IO,3,0,0,0,0,3,0
20130210-M-Vina_del_Mar-F-Horacio_Zeballos-Rafael_Nadal,1,F-XC,51,22,8,6,8,32,19
20130210-M-Vina_del_Mar-F-Horacio_Zeballos-Rafael_Nadal,1,F-DTM,38,3,0,1,2,20,18
20130210-M-Vina_del_Mar-F-Horacio_Zeballos-Rafael_Nadal,1,F-DTL,11,2,0,0,2,5,6
20130210-M-Vina_del_Mar-F-Horacio_Zeballos-Rafael_Nadal,1,F-IO,36,14,9,2,3,23,13
20130210-M-Vina_del_Mar-F-Horacio_Zeballos-Rafael_Nadal,1,F-II,2,2,1,0,1,1,1
20130210-M-Vina_del_Mar-F-Horacio_Zeballos-Rafael_Nadal,1,B-XC,43,4,0,0,4,26,17
20130210-M-Vina_del_Mar-F-Horacio_Zeballos-Rafael_Nadal,1,B-DTM,32,1,0,0,1,14,18
20130210-M-Vina_del_Mar-F-Horacio_Zeballos-Rafael_Nadal,1,B-DTL,7,6,4,0,2,4,3
20130210-M-Vina_del_Mar-F-Horacio_Zeballos-Rafael_Nadal,1,B-IO,4,3,2,1,0,3,1
20130210-M-Vina_del_Mar-F-Horacio_Zeballos-Rafael_Nadal,1,S-XC,7,1,1,0,0,3,4
20130210-M-Vina_del_Mar-F-Horacio_Zeballos-Rafael_Nadal,1,S-DTM,8,2,0,0,2,2,6
20130210-M-Vina_del_Mar-F-Horacio_Zeballos-Rafael_Nadal,1,S-DTL,5,2,1,0,1,3,2
20130210-M-Vina_del_Mar-F-Horacio_Zeballos-Rafael_Nadal,1,S-IO,2,2,1,0,1,1,1
20130210-M-Vina_del_Mar-F-Horacio_Zeballos-Rafael_Nadal,2,F-XC,47,17,5,7,5,29,18
20130210-M-Vina_del_Mar-F-Horacio_Zeballos-Rafael_Nadal,2,F-DTM,36,3,1,0,2,13,23
20130210-M-Vina_del_Mar-F-Horacio_Zeballos-Rafael_Nadal,2,F-DTL,9,4,1,1,2,4,5
20130210-M-Vina_del_Mar-F-Horacio_Zeballos-Rafael_Nadal,2,F-IO,44,11,7,1,3,29,15
20130210-M-Vina_del_Mar-F-Horacio_Zeballos-Rafael_Nadal,2,F-II,6,3,2,1,0,6,0
20130210-M-Vina_del_Mar-F-Horacio_Zeballos-Rafael_Nadal,2,B-XC,40,0,0,0,0,19,21
20130210-M-Vina_del_Mar-F-Horacio_Zeballos-Rafael_Nadal,2,B-DTM,30,3,0,0,3,9,21
20130210-M-Vina_del_Mar-F-Horacio_Zeballos-Rafael_Nadal,2,B-DTL,16,4,1,1,2,7,9
20130210-M-Vina_del_Mar-F-Horacio_Zeballos-Rafael_Nadal,2,B-IO,8,3,0,2,1,3,5
20130210-M-Vina_del_Mar-F-Horacio_Zeballos-Rafael_Nadal,2,S-XC,1,1,1,0,0,1,0
20130210-M-Vina_del_Mar-F-Horacio_Zeballos-Rafael_Nadal,2,S-DTM,8,0,0,0,0,3,5
20130210-M-Vina_del_Mar-F-Horacio_Zeballos-Rafael_Nadal,2,S-DTL,2,0,0,0,0,1,1
20130210-M-Vina_del_Mar-F-Horacio_Zeballos-Rafael_Nadal,2,S-IO,1,1,1,0,0,1,0
20140625-M-Wimbledon-R64-Tomas_Berdych-Bernard_Tomic,1,F-XC,58,24,17,4,3,45,13
20140625-M-Wimbledon-R64-Tomas_Berdych-Bernard_Tomic,1,F-DTM,20,1,0,0,1,15,5
20140625-M-Wimbledon-R64-Tomas_Berdych-Bernard_Tomic,1,F-DTL,16,3,2,0,1,9,7
20140625-M-Wimbledon-R64-Tomas_Berdych-Bernard_Tomic,1,F-IO,36,15,7,5,3,29,7
20140625-M-Wimbledon-R64-Tomas_Berdych-Bernard_Tomic,1,F-II,4,2,2,0,0,4,0
20140625-M-Wimbledon-R64-Tomas_Berdych-Bernard_Tomic,1,B-XC,31,3,1,0,2,21,10
20140625-M-Wimbledon-R64-Tomas_Berdych-Bernard_Tomic,1,B-DTM,21,3,0,1,2,12,9
20140625-M-Wimbledon-R64-Tomas_Berdych-Bernard_Tomic,1,B-DTL,15,3,1,0,2,9,6
20140625-M-Wimbledon-R64-Tomas_Berdych-Bernard_Tomic,1,B-II,1,0,0,0,0,0,1
20140625-M-Wimbledon-R64-Tomas_Berdych-Bernard_Tomic,1,S-XC,11,3,0,0,3,4,7
20140625-M-Wimbledon-R64-Tomas_Berdych-Bernard_Tomic,1,S-DTM,3,1,0,0,1,0,3
20140625-M-Wimbledon-R64-Tomas_Berdych-Bernard_Tomic,1,S-DTL,5,2,0,1,1,2,3
20140625-M-Wimbledon-R64-Tomas_Berdych-Bernard_Tomic,1,S-IO,1,0,0,0,0,0,1
20140625-M-Wimbledon-R64-Tomas_Berdych-Bernard_Tomic,1,S-II,2,0,0,0,0,0,2
20140625-M-Wimbledon-R64-Tomas_Berdych-Bernard_Tomic,2,F-XC,48,15,7,3,5,23,25
20140625-M-Wimbledon-R64-Tomas_Berdych-Bernard_Tomic,2,F-DTM,13,1,0,0,1,4,9
20140625-M-Wimbledon-R64-Tomas_Berdych-Bernard_Tomic,2,F-DTL,22,5,2,1,2,7,15
20140625-M-Wimbledon-R64-Tomas_Berdych-Bernard_Tomic,2,F-IO,34,10,1,7,2,20,14
20140625-M-Wimbledon-R64-Tomas_Berdych-Bernard_Tomic,2,F-II,3,0,0,0,0,1,2
20140625-M-Wimbledon-R64-Tomas_Berdych-Bernard_Tomic,2,B-XC,23,6,2,2,2,11,12
20140625-M-Wimbledon-R64-Tomas_Berdych-Bernard_Tomic,2,B-DTM,15,1,0,0,1,7,8
20140625-M-Wimbledon-R64-Tomas_Berdych-Bernard_Tomic,2,B-DTL,16,7,1,3,3,6,10
20140625-M-Wimbledon-R64-Tomas_Berdych-Bernard_Tomic,2,B-IO,6,2,0,1,1,3,3
20140625-M-Wimbledon-R64-Tomas_Berdych-Bernard_Tomic,2,B-II,1,0,0,0,0,1,0
20140625-M-Wimbledon-R64-Tomas_Berdych-Bernard_Tomic,2,S-XC,19,3,0,1,2,5,14
20140625-M-Wimbledon-R64-Tomas_Berdych-Bernard_Tomic,2,S-DTM,18,1,0,0,1,3,15
20140625-M-Wimbledon-R64-Tomas_Berdych-Bernard_Tomic,2,S-DTL,8,3,1,0,2,2,6
20140625-M-Wimbledon-R64-Tomas_Berdych-Bernard_Tomic,2,S-IO,2,1,0,0,1,0,2
20140624-M-Wimbledon-R128-Kenny_De_Schepper-Kei_Nishikori,1,F-XC,30,14,4,5,5,14,16
20140624-M-Wimbledon-R128-Kenny_De_Schepper-Kei_Nishikori,1,F-DTM,20,5,1,1,3,8,12
20140624-M-Wimbledon-R128-Kenny_De_Schepper-Kei_Nishikori,1,F-DTL,4,2,1,1,0,2,2
20140624-M-Wimbledon-R128-Kenny_De_Schepper-Kei_Nishikori,1,F-IO,6,0,0,0,0,4,2
20140624-M-Wimbledon-R128-Kenny_De_Schepper-Kei_Nishikori,1,B-XC,9,5,1,1,3,3,6
20140624-M-Wimbledon-R128-Kenny_De_Schepper-Kei_Nishikori,1,B-DTM,17,1,0,0,1,9,8
20140624-M-Wimbledon-R128-Kenny_De_Schepper-Kei_Nishikori,1,B-DTL,5,2,0,0,2,1,4
20140624-M-Wimbledon-R128-Kenny_De_Schepper-Kei_Nishikori,1,B-IO,5,2,0,0,2,3,2
20140624-M-Wimbledon-R128-Kenny_De_Schepper-Kei_Nishikori,1,S-XC,3,0,0,0,0,0,3
20140624-M-Wimbledon-R128-Kenny_De_Schepper-Kei_Nishikori,1,S-DTM,19,1,1,0,0,7,12
20140624-M-Wimbledon-R128-Kenny_De_Schepper-Kei_Nishikori,1,S-DTL,5,1,0,0,1,0,5
20140624-M-Wimbledon-R128-Kenny_De_Schepper-Kei_Nishikori,1,S-IO,3,0,0,0,0,1,2
20140624-M-Wimbledon-R128-Kenny_De_Schepper-Kei_Nishikori,2,F-XC,41,9,1,2,6,29,12
20140624-M-Wimbledon-R128-Kenny_De_Schepper-Kei_Nishikori,2,F-DTM,15,2,0,1,1,5,10
20140624-M-Wimbledon-R128-Kenny_De_Schepper-Kei_Nishikori,2,F-DTL,5,4,3,0,1,3,2
20140624-M-Wimbledon-R128-Kenny_De_Schepper-Kei_Nishikori,2,F-IO,15,5,2,2,1,13,2
20140624-M-Wimbledon-R128-Kenny_De_Schepper-Kei_Nishikori,2,F-II,2,1,1,0,0,2,0
20140624-M-Wimbledon-R128-Kenny_De_Schepper-Kei_Nishikori,2,B-XC,18,3,1,2,0,12,6
20140624-M-Wimbledon-R128-Kenny_De_Schepper-Kei_Nishikori,2,B-DTM,17,2,1,1,0,9,8
20140624-M-Wimbledon-R128-Kenny_De_Schepper-Kei_Nishikori,2,B-DTL,10,3,2,1,0,8,2
20140624-M-Wimbledon-R128-Kenny_De_Schepper-Kei_Nishikori,2,B-IO,4,0,0,0,0,1,3
20140624-M-Wimbledon-R128-Kenny_De_Schepper-Kei_Nishikori,2,S-XC,2,1,1,0,0,2,0
20140624-M-Wimbledon-R128-Kenny_De_Schepper-Kei_Nishikori,2,S-DTM,2,0,0,0,0,1,1
20140624-M-Wimbledon-R128-Kenny_De_Schepper-Kei_Nishikori,2,S-DTL,1,0,0,0,0,0,1
20140624-M-Wimbledon-R128-Kenny_De_Schepper-Kei_Nishikori,2,S-IO,3,1,0,1,0,2,1
20140628-M-Wimbledon-R32-Mikhail_Kukushkin-Rafael_Nadal,1,F-XC,59,14,3,5,6,23,36
20140628-M-Wimbledon-R32-Mikhail_Kukushkin-Rafael_Nadal,1,F-DTM,21,1,0,0,1,9,12
20140628-M-Wimbledon-R32-Mikhail_Kukushkin-Rafael_Nadal,1,F-DTL,20,10,5,2,3,10,10
20140628-M-Wimbledon-R32-Mikhail_Kukushkin-Rafael_Nadal,1,F-IO,46,16,4,2,10,21,25
20140628-M-Wimbledon-R32-Mikhail_Kukushkin-Rafael_Nadal,1,F-II,4,2,1,0,1,1,3
20140628-M-Wimbledon-R32-Mikhail_Kukushkin-Rafael_Nadal,1,B-XC,18,10,5,2,3,11,7
20140628-M-Wimbledon-R32-Mikhail_Kukushkin-Rafael_Nadal,1,B-DTM,32,1,0,0,1,13,19
20140628-M-Wimbledon-R32-Mikhail_Kukushkin-Rafael_Nadal,1,B-DTL,32,9,0,6,3,21,11
20140628-M-Wimbledon-R32-Mikhail_Kukushkin-Rafael_Nadal,1,B-IO,15,2,0,0,2,6,9
20140628-M-Wimbledon-R32-Mikhail_Kukushkin-Rafael_Nadal,1,S-XC,2,1,0,0,1,0,2
20140628-M-Wimbledon-R32-Mikhail_Kukushkin-Rafael_Nadal,1,S-DTM,2,0,0,0,0,0,2
20140628-M-Wimbledon-R32-Mikhail_Kukushkin-Rafael_Nadal,1,S-DTL,8,0,0,0,0,4,4
20140628-M-Wimbledon-R32-Mikhail_Kukushkin-Rafael_Nadal,1,S-IO,1,0,0,0,0,0,1
20140628-M-Wimbledon-R32-Mikhail_Kukushkin-Rafael_Nadal,2,F-XC,59,11,4,6,1,32,27
20140628-M-Wimbledon-R32-Mikhail_Kukushkin-Rafael_Nadal,2,F-DTM,21,2,0,0,2,8,13
20140628-M-Wimbledon-R32-Mikhail_Kukushkin-Rafael_Nadal,2,F-DTL,12,8,5,2,1,9,3
20140628-M-Wimbledon-R32-Mikhail_Kukushkin-Rafael_Nadal,2,F-IO,23,12,8,3,1,17,6
20140628-M-Wimbledon-R32-Mikhail_Kukushkin-Rafael_Nadal,2,F-II,6,2,1,1,0,4,2
20140628-M-Wimbledon-R32-Mikhail_Kukushkin-Rafael_Nadal,2,B-XC,26,9,2,4,3,15,11
20140628-M-Wimbledon-R32-Mikhail_Kukushkin-Rafael_Nadal,2,B-DTM,25,2,0,1,1,20,5
20140628-M-Wimbledon-R32-Mikhail_Kukushkin-Rafael_Nadal,2,B-DTL,8,4,1,2,1,6,2
20140628-M-Wimbledon-R32-Mikhail_Kukushkin-Rafael_Nadal,2,B-IO,4,2,0,1,1,3,1
20140628-M-Wimbledon-R32-Mikhail_Kukushkin-Rafael_Nadal,2,S-XC,10,1,0,1,0,7,3
20140628-M-Wimbledon-R32-Mikhail_Kukushkin-Rafael_Nadal,2,S-DTM,31,2,0,1,1,16,15
20140628-M-Wimbledon-R32-Mikhail_Kukushkin-Rafael_Nadal,2,S-DTL,12,1,0,0,1,5,7
20140628-M-Wimbledon-R32-Mikhail_Kukushkin-Rafael_Nadal,2,S-IO,2,1,0,1,0,2,0
20140701-M-Wimbledon-R16-Nick_Kyrgios-Rafael_Nadal,1,F-XC,66,16,5,7,4,37,29
20140701-M-Wimbledon-R16-Nick_Kyrgios-Rafael_Nadal,1,F-DTM,23,4,0,0,4,6,17
20140701-M-Wimbledon-R16-Nick_Kyrgios-Rafael_Nadal,1,F-DTL,8,4,1,1,2,3,5
20140701-M-Wimbledon-R16-Nick_Kyrgios-Rafael_Nadal,1,F-IO,25,12,7,1,4,12,13
20140701-M-Wimbledon-R16-Nick_Kyrgios-Rafael_Nadal,1,F-II,4,1,0,0,1,1,3
20140701-M-Wimbledon-R16-Nick_Kyrgios-Rafael_Nadal,1,B-XC,58,16,4,7,5,30,28
20140701-M-Wimbledon-R16-Nick_Kyrgios-Rafael_Nadal,1,B-DTM,15,1,0,0,1,3,12
20140701-M-Wimbledon-R16-Nick_Kyrgios-Rafael_Nadal,1,B-DTL,16,7,3,0,4,5,11
20140701-M-Wimbledon-R16-Nick_Kyrgios-Rafael_Nadal,1,B-IO,9,4,1,1,2,4,5
20140701-M-Wimbledon-R16-Nick_Kyrgios-Rafael_Nadal,1,B-II,1,1,1,0,0,1,0
20140701-M-Wimbledon-R16-Nick_Kyrgios-Rafael_Nadal,1,S-XC,1,0,0,0,0,0,1
20140701-M-Wimbledon-R16-Nick_Kyrgios-Rafael_Nadal,1,S-DTM,2,0,0,0,0,0,2
20140701-M-Wimbledon-R16-Nick_Kyrgios-Rafael_Nadal,1,S-DTL,2,0,0,0,0,0,2
20140701-M-Wimbledon-R16-Nick_Kyrgios-Rafael_Nadal,1,S-IO,1,0,0,0,0,1,0
20140701-M-Wimbledon-R16-Nick_Kyrgios-Rafael_Nadal,1,S-II,1,0,0,0,0,1,0
20140701-M-Wimbledon-R16-Nick_Kyrgios-Rafael_Nadal,2,F-XC,67,11,6,4,1,46,21
20140701-M-Wimbledon-R16-Nick_Kyrgios-Rafael_Nadal,2,F-DTM,25,2,2,0,0,16,9
20140701-M-Wimbledon-R16-Nick_Kyrgios-Rafael_Nadal,2,F-DTL,24,18,8,5,5,17,7
20140701-M-Wimbledon-R16-Nick_Kyrgios-Rafael_Nadal,2,F-IO,29,12,6,3,3,19,10
20140701-M-Wimbledon-R16-Nick_Kyrgios-Rafael_Nadal,2,F-II,7,6,2,1,3,3,4
20140701-M-Wimbledon-R16-Nick_Kyrgios-Rafael_Nadal,2,B-XC,21,6,0,5,1,15,6
20140701-M-Wimbledon-R16-Nick_Kyrgios-Rafael_Nadal,2,B-DTM,18,1,0,0,1,11,7
20140701-M-Wimbledon-R16-Nick_Kyrgios-Rafael_Nadal,2,B-DTL,12,6,2,2,2,9,3
20140701-M-Wimbledon-R16-Nick_Kyrgios-Rafael_Nadal,2,B-IO,2,0,0,0,0,2,0
20140701-M-Wimbledon-R16-Nick_Kyrgios-Rafael_Nadal,2,S-XC,4,0,0,0,0,1,3
20140701-M-Wimbledon-R16-Nick_Kyrgios-Rafael_Nadal,2,S-DTM,15,0,0,0,0,9,6
20140701-M-Wimbledon-R16-Nick_Kyrgios-Rafael_Nadal,2,S-DTL,8,1,0,0,1,1,7
20140701-M-Wimbledon-R16-Nick_Kyrgios-Rafael_Nadal,2,S-IO,2,0,0,0,0,2,0
20140626-M-Wimbledon-R64-Rafael_Nadal-Lukas_Rosol,1,F-XC,47,16,9,2,5,32,15
20140626-M-Wimbledon-R64-Rafael_Nadal-Lukas_Rosol,1,F-DTM,25,2,1,0,1,15,10
20140626-M-Wimbledon-R64-Rafael_Nadal-Lukas_Rosol,1,F-DTL,7,4,4,0,0,5,2
20140626-M-Wimbledon-R64-Rafael_Nadal-Lukas_Rosol,1,F-IO,24,12,7,4,1,19,5
20140626-M-Wimbledon-R64-Rafael_Nadal-Lukas_Rosol,1,F-II,9,6,4,1,1,8,1
20140626-M-Wimbledon-R64-Rafael_Nadal-Lukas_Rosol,1,B-XC,29,5,1,3,1,15,14
20140626-M-Wimbledon-R64-Rafael_Nadal-Lukas_Rosol,1,B-DTM,8,0,0,0,0,7,1
20140626-M-Wimbledon-R64-Rafael_Nadal-Lukas_Rosol,1,B-DTL,4,1,1,0,0,2,2
20140626-M-Wimbledon-R64-Rafael_Nadal-Lukas_Rosol,1,B-IO,2,0,0,0,0,1,1
20140626-M-Wimbledon-R64-Rafael_Nadal-Lukas_Rosol,1,S-XC,4,0,0,0,0,2,2
20140626-M-Wimbledon-R64-Rafael_Nadal-Lukas_Rosol,1,S-DTM,17,1,0,0,1,8,9
20140626-M-Wimbledon-R64-Rafael_Nadal-Lukas_Rosol,1,S-DTL,5,2,1,1,0,4,1
20140626-M-Wimbledon-R64-Rafael_Nadal-Lukas_Rosol,1,S-IO,1,0,0,0,0,1,0
20140626-M-Wimbledon-R64-Rafael_Nadal-Lukas_Rosol,2,F-XC,58,14,5,3,6,28,30
20140626-M-Wimbledon-R64-Rafael_Nadal-Lukas_Rosol,2,F-DTM,24,4,1,0,3,9,15
20140626-M-Wimbledon-R64-Rafael_Nadal-Lukas_Rosol,2,F-DTL,18,14,10,1,3,14,4
20140626-M-Wimbledon-R64-Rafael_Nadal-Lukas_Rosol,2,F-IO,32,19,7,5,7,20,12
20140626-M-Wimbledon-R64-Rafael_Nadal-Lukas_Rosol,2,F-II,3,3,2,0,1,2,1
20140626-M-Wimbledon-R64-Rafael_Nadal-Lukas_Rosol,2,B-XC,19,8,2,3,3,9,10
20140626-M-Wimbledon-R64-Rafael_Nadal-Lukas_Rosol,2,B-DTM,16,4,0,0,4,3,13
20140626-M-Wimbledon-R64-Rafael_Nadal-Lukas_Rosol,2,B-DTL,12,6,1,1,4,5,7
20140626-M-Wimbledon-R64-Rafael_Nadal-Lukas_Rosol,2,B-IO,2,0,0,0,0,0,2
20140626-M-Wimbledon-R64-Rafael_Nadal-Lukas_Rosol,2,S-DTM,5,0,0,0,0,1,4
20140626-M-Wimbledon-R64-Rafael_Nadal-Lukas_Rosol,2,S-DTL,4,1,0,1,0,1,3
20140626-M-Wimbledon-R64-Rafael_Nadal-Lukas_Rosol,2,S-IO,2,0,0,0,0,1,1
20130703-M-Wimbledon-QF-David_Ferrer-Juan_Martin_Del_Potro,1,F-XC,51,10,2,4,4,34,17
20130703-M-Wimbledon-QF-David_Ferrer-Juan_Martin_Del_Potro,1,F-DTM,24,2,0,1,1,12,12
20130703-M-Wimbledon-QF-David_Ferrer-Juan_Martin_Del_Potro,1,F-DTL,26,8,2,0,6,17,9
20130703-M-Wimbledon-QF-David_Ferrer-Juan_Martin_Del_Potro,1,F-IO,70,14,4,4,6,37,33
20130703-M-Wimbledon-QF-David_Ferrer-Juan_Martin_Del_Potro,1,F-II,10,4,1,0,3,4,6
20130703-M-Wimbledon-QF-David_Ferrer-Juan_Martin_Del_Potro,1,B-XC,45,4,0,0,3,11,34
20130703-M-Wimbledon-QF-David_Ferrer-Juan_Martin_Del_Potro,1,B-DTM,56,6,1,0,5,29,27
20130703-M-Wimbledon-QF-David_Ferrer-Juan_Martin_Del_Potro,1,B-DTL,17,9,5,0,4,9,8
20130703-M-Wimbledon-QF-David_Ferrer-Juan_Martin_Del_Potro,1,B-IO,3,2,2,0,0,2,1
20130703-M-Wimbledon-QF-David_Ferrer-Juan_Martin_Del_Potro,1,B-II,1,0,0,0,0,1,0
20130703-M-Wimbledon-QF-David_Ferrer-Juan_Martin_Del_Potro,1,S-XC,3,1,0,0,1,1,2
20130703-M-Wimbledon-QF-David_Ferrer-Juan_Martin_Del_Potro,1,S-DTM,4,1,0,0,1,1,3
20130703-M-Wimbledon-QF-David_Ferrer-Juan_Martin_Del_Potro,2,F-XC,57,21,13,1,7,25,32
20130703-M-Wimbledon-QF-David_Ferrer-Juan_Martin_Del_Potro,2,F-DTM,30,2,0,1,1,15,15
20130703-M-Wimbledon-QF-David_Ferrer-Juan_Martin_Del_Potro,2,F-DTL,16,4,2,1,1,9,7
20130703-M-Wimbledon-QF-David_Ferrer-Juan_Martin_Del_Potro,2,F-IO,31,10,5,2,3,21,10
20130703-M-Wimbledon-QF-David_Ferrer-Juan_Martin_Del_Potro,2,F-II,3,1,0,1,0,2,1
20130703-M-Wimbledon-QF-David_Ferrer-Juan_Martin_Del_Potro,2,B-XC,68,1,0,1,0,38,30
20130703-M-Wimbledon-QF-David_Ferrer-Juan_Martin_Del_Potro,2,B-DTM,43,3,0,0,3,15,28
20130703-M-Wimbledon-QF-David_Ferrer-Juan_Martin_Del_Potro,2,B-DTL,12,3,2,1,0,8,4
20130703-M-Wimbledon-QF-David_Ferrer-Juan_Martin_Del_Potro,2,B-IO,9,3,1,1,1,4,5
20130703-M-Wimbledon-QF-David_Ferrer-Juan_Martin_Del_Potro,2,S-XC,17,1,0,0,1,12,5
20130703-M-Wimbledon-QF-David_Ferrer-Juan_Martin_Del_Potro,2,S-DTM,6,0,0,0,0,3,3
20130703-M-Wimbledon-QF-David_Ferrer-Juan_Martin_Del_Potro,2,S-DTL,2,0,0,0,0,0,2
20130707-M-Wimbledon-F-Novak_Djokovic-Andy_Murray,1,F-XC,91,14,5,6,3,50,41
20130707-M-Wimbledon-F-Novak_Djokovic-Andy_Murray,1,F-DTM,42,4,0,0,4,17,25
20130707-M-Wimbledon-F-Novak_Djokovic-Andy_Murray,1,F-DTL,46,9,1,1,7,24,22
20130707-M-Wimbledon-F-Novak_Djokovic-Andy_Murray,1,F-IO,54,8,1,2,5,31,23
20130707-M-Wimbledon-F-Novak_Djokovic-Andy_Murray,1,F-II,2,0,0,0,0,1,1
20130707-M-Wimbledon-F-Novak_Djokovic-Andy_Murray,1,B-XC,80,11,3,1,7,41,39
20130707-M-Wimbledon-F-Novak_Djokovic-Andy_Murray,1,B-DTM,36,2,0,1,1,24,12
20130707-M-Wimbledon-F-Novak_Djokovic-Andy_Murray,1,B-DTL,38,9,1,3,5,17,21
20130707-M-Wimbledon-F-Novak_Djokovic-Andy_Murray,1,B-IO,22,3,0,1,2,15,7
20130707-M-Wimbledon-F-Novak_Djokovic-Andy_Murray,1,S-XC,14,3,0,2,1,7,7
20130707-M-Wimbledon-F-Novak_Djokovic-Andy_Murray,1,S-DTM,11,1,0,0,1,8,3
20130707-M-Wimbledon-F-Novak_Djokovic-Andy_Murray,1,S-DTL,1,0,0,0,0,0,1
20130707-M-Wimbledon-F-Novak_Djokovic-Andy_Murray,2,F-XC,106,11,5,1,5,53,53
20130707-M-Wimbledon-F-Novak_Djokovic-Andy_Murray,2,F-DTM,37,2,0,1,1,18,19
20130707-M-Wimbledon-F-Novak_Djokovic-Andy_Murray,2,F-DTL,41,9,4,3,2,23,18
20130707-M-Wimbledon-F-Novak_Djokovic-Andy_Murray,2,F-IO,26,8,1,2,5,15,11
20130707-M-Wimbledon-F-Novak_Djokovic-Andy_Murray,2,F-II,1,1,1,0,0,1,0
20130707-M-Wimbledon-F-Novak_Djokovic-Andy_Murray,2,B-XC,82,12,5,3,4,42,40
20130707-M-Wimbledon-F-Novak_Djokovic-Andy_Murray,2,B-DTM,52,1,0,0,1,21,31
20130707-M-Wimbledon-F-Novak_Djokovic-Andy_Murray,2,B-DTL,27,7,4,1,2,13,14
20130707-M-Wimbledon-F-Novak_Djokovic-Andy_Murray,2,B-IO,13,2,0,0,2,8,5
20130707-M-Wimbledon-F-Novak_Djokovic-Andy_Murray,2,S-XC,23,0,0,0,0,10,13
20130707-M-Wimbledon-F-Novak_Djokovic-Andy_Murray,2,S-DTM,27,0,0,0,0,7,20
20130707-M-Wimbledon-F-Novak_Djokovic-Andy_Murray,2,S-DTL,7,1,0,0,1,2,5
20130707-M-Wimbledon-F-Novak_Djokovic-Andy_Murray,2,S-IO,3,1,0,0,1,1,2
20140704-M-Winnetka_CH-QF-John_Patrick_Smith-Illya_Marchenko,1,F-XC,41,5,0,0,5,18,23
20140704-M-Winnetka_CH-QF-John_Patrick_Smith-Illya_Marchenko,1,F-DTM,29,3,0,2,1,15,14
20140704-M-Winnetka_CH-QF-John_Patrick_Smith-Illya_Marchenko,1,F-DTL,11,7,4,1,2,5,6
20140704-M-Winnetka_CH-QF-John_Patrick_Smith-Illya_Marchenko,1,F-IO,26,10,2,2,6,13,13
20140704-M-Winnetka_CH-QF-John_Patrick_Smith-Illya_Marchenko,1,F-II,4,1,0,1,0,3,1
20140704-M-Winnetka_CH-QF-John_Patrick_Smith-Illya_Marchenko,1,B-XC,6,2,0,1,1,3,3
20140704-M-Winnetka_CH-QF-John_Patrick_Smith-Illya_Marchenko,1,B-DTM,29,2,0,0,2,14,15
20140704-M-Winnetka_CH-QF-John_Patrick_Smith-Illya_Marchenko,1,B-DTL,8,3,0,1,2,5,3
20140704-M-Winnetka_CH-QF-John_Patrick_Smith-Illya_Marchenko,1,B-IO,11,0,0,0,0,6,5
20140704-M-Winnetka_CH-QF-John_Patrick_Smith-Illya_Marchenko,1,S-XC,7,0,0,0,0,2,5
20140704-M-Winnetka_CH-QF-John_Patrick_Smith-Illya_Marchenko,1,S-DTM,6,0,0,0,0,3,3
20140704-M-Winnetka_CH-QF-John_Patrick_Smith-Illya_Marchenko,1,S-DTL,5,1,0,1,0,3,2
20140704-M-Winnetka_CH-QF-John_Patrick_Smith-Illya_Marchenko,1,S-IO,3,0,0,0,0,2,1
20140704-M-Winnetka_CH-QF-John_Patrick_Smith-Illya_Marchenko,2,F-XC,43,5,1,2,2,22,21
20140704-M-Winnetka_CH-QF-John_Patrick_Smith-Illya_Marchenko,2,F-DTM,25,1,0,0,1,14,11
20140704-M-Winnetka_CH-QF-John_Patrick_Smith-Illya_Marchenko,2,F-DTL,4,2,1,0,1,1,3
20140704-M-Winnetka_CH-QF-John_Patrick_Smith-Illya_Marchenko,2,F-IO,23,11,3,2,6,11,12
20140704-M-Winnetka_CH-QF-John_Patrick_Smith-Illya_Marchenko,2,F-II,7,2,1,0,1,4,3
20140704-M-Winnetka_CH-QF-John_Patrick_Smith-Illya_Marchenko,2,B-XC,49,15,3,2,10,23,26
20140704-M-Winnetka_CH-QF-John_Patrick_Smith-Illya_Marchenko,2,B-DTM,23,0,0,0,0,8,15
20140704-M-Winnetka_CH-QF-John_Patrick_Smith-Illya_Marchenko,2,B-DTL,6,3,1,2,0,4,2
20140704-M-Winnetka_CH-QF-John_Patrick_Smith-Illya_Marchenko,2,B-IO,7,0,0,0,0,4,3
20140704-M-Winnetka_CH-QF-John_Patrick_Smith-Illya_Marchenko,2,S-XC,2,0,0,0,0,2,0
20140704-M-Winnetka_CH-QF-John_Patrick_Smith-Illya_Marchenko,2,S-DTM,5,0,0,0,0,2,3
20140704-M-Winnetka_CH-QF-John_Patrick_Smith-Illya_Marchenko,2,S-DTL,5,1,0,0,1,3,2
20140704-M-Winnetka_CH-QF-John_Patrick_Smith-Illya_Marchenko,2,S-IO,5,1,0,0,1,1,4
20140630-M-Winnetka_CH-F-Farrukh_Dustov-Denis_Kudla,1,F-XC,25,4,1,0,3,7,18
20140630-M-Winnetka_CH-F-Farrukh_Dustov-Denis_Kudla,1,F-DTM,15,5,0,1,4,5,10
20140630-M-Winnetka_CH-F-Farrukh_Dustov-Denis_Kudla,1,F-DTL,9,5,0,1,4,1,8
20140630-M-Winnetka_CH-F-Farrukh_Dustov-Denis_Kudla,1,F-IO,19,5,1,1,3,8,11
20140630-M-Winnetka_CH-F-Farrukh_Dustov-Denis_Kudla,1,F-II,1,0,0,0,0,1,0
20140630-M-Winnetka_CH-F-Farrukh_Dustov-Denis_Kudla,1,B-XC,15,3,0,1,2,5,10
20140630-M-Winnetka_CH-F-Farrukh_Dustov-Denis_Kudla,1,B-DTM,16,1,0,0,1,6,10
20140630-M-Winnetka_CH-F-Farrukh_Dustov-Denis_Kudla,1,B-DTL,10,5,1,1,3,5,5
20140630-M-Winnetka_CH-F-Farrukh_Dustov-Denis_Kudla,1,B-IO,3,1,1,0,0,2,1
20140630-M-Winnetka_CH-F-Farrukh_Dustov-Denis_Kudla,1,S-XC,23,4,0,0,4,7,16
20140630-M-Winnetka_CH-F-Farrukh_Dustov-Denis_Kudla,1,S-DTM,10,0,0,0,0,7,3
20140630-M-Winnetka_CH-F-Farrukh_Dustov-Denis_Kudla,1,S-DTL,2,0,0,0,0,2,0
20140630-M-Winnetka_CH-F-Farrukh_Dustov-Denis_Kudla,2,F-XC,24,5,0,3,2,16,8
20140630-M-Winnetka_CH-F-Farrukh_Dustov-Denis_Kudla,2,F-DTM,8,2,0,0,2,3,5
20140630-M-Winnetka_CH-F-Farrukh_Dustov-Denis_Kudla,2,F-DTL,13,3,0,1,2,8,5
20140630-M-Winnetka_CH-F-Farrukh_Dustov-Denis_Kudla,2,F-IO,24,7,2,2,3,15,9
20140630-M-Winnetka_CH-F-Farrukh_Dustov-Denis_Kudla,2,F-II,2,0,0,0,0,2,0
20140630-M-Winnetka_CH-F-Farrukh_Dustov-Denis_Kudla,2,B-XC,37,10,4,2,4,21,16
20140630-M-Winnetka_CH-F-Farrukh_Dustov-Denis_Kudla,2,B-DTM,14,1,0,0,1,8,6
20140630-M-Winnetka_CH-F-Farrukh_Dustov-Denis_Kudla,2,B-DTL,10,5,0,3,2,7,3
20140630-M-Winnetka_CH-F-Farrukh_Dustov-Denis_Kudla,2,B-IO,7,2,0,0,2,3,4
20140630-M-Winnetka_CH-F-Farrukh_Dustov-Denis_Kudla,2,S-XC,7,0,0,0,0,3,4
20140630-M-Winnetka_CH-F-Farrukh_Dustov-Denis_Kudla,2,S-DTM,1,0,0,0,0,1,0
20140630-M-Winnetka_CH-F-Farrukh_Dustov-Denis_Kudla,2,S-DTL,1,0,0,0,0,1,0
20141113-M-London-RR-Roger_Federer-Andy_Murray,1,F-XC,21,7,2,2,3,15,6
20141113-M-London-RR-Roger_Federer-Andy_Murray,1,F-DTM,11,0,0,0,0,7,4
20141113-M-London-RR-Roger_Federer-Andy_Murray,1,F-DTL,4,1,0,0,1,3,1
20141113-M-London-RR-Roger_Federer-Andy_Murray,1,F-IO,19,6,0,3,3,13,6
20141113-M-London-RR-Roger_Federer-Andy_Murray,1,F-II,3,1,0,1,0,2,1
20141113-M-London-RR-Roger_Federer-Andy_Murray,1,B-XC,18,0,0,0,0,16,2
20141113-M-London-RR-Roger_Federer-Andy_Murray,1,B-DTM,19,1,0,0,1,14,5
20141113-M-London-RR-Roger_Federer-Andy_Murray,1,B-DTL,1,1,1,0,0,1,0
20141113-M-London-RR-Roger_Federer-Andy_Murray,1,B-IO,1,1,0,1,0,1,0
20141113-M-London-RR-Roger_Federer-Andy_Murray,1,S-XC,14,0,0,0,0,8,6
20141113-M-London-RR-Roger_Federer-Andy_Murray,1,S-DTM,4,0,0,0,0,1,3
20141113-M-London-RR-Roger_Federer-Andy_Murray,2,F-XC,16,2,0,0,2,6,10
20141113-M-London-RR-Roger_Federer-Andy_Murray,2,F-DTM,19,3,0,1,2,7,12
20141113-M-London-RR-Roger_Federer-Andy_Murray,2,F-DTL,5,2,0,0,2,0,5
20141113-M-London-RR-Roger_Federer-Andy_Murray,2,F-IO,16,3,0,0,3,3,13
20141113-M-London-RR-Roger_Federer-Andy_Murray,2,F-II,2,1,0,0,1,0,2
20141113-M-London-RR-Roger_Federer-Andy_Murray,2,B-XC,39,6,2,0,4,13,26
20141113-M-London-RR-Roger_Federer-Andy_Murray,2,B-DTM,17,3,0,0,3,3,14
20141113-M-London-RR-Roger_Federer-Andy_Murray,2,B-DTL,6,1,0,0,1,0,6
20141113-M-London-RR-Roger_Federer-Andy_Murray,2,S-XC,4,1,0,0,1,1,3
20141113-M-London-RR-Roger_Federer-Andy_Murray,2,S-DTM,2,0,0,0,0,0,2
20141113-M-London-RR-Roger_Federer-Andy_Murray,2,S-DTL,1,0,0,0,0,1,0
20141109-M-London-RR-Kei_Nishikori-Andy_Murray,1,F-XC,38,10,1,3,6,19,19
20141109-M-London-RR-Kei_Nishikori-Andy_Murray,1,F-DTM,19,1,0,0,1,14,5
20141109-M-London-RR-Kei_Nishikori-Andy_Murray,1,F-DTL,13,2,0,1,1,9,4
20141109-M-London-RR-Kei_Nishikori-Andy_Murray,1,F-IO,28,6,3,0,3,17,11
20141109-M-London-RR-Kei_Nishikori-Andy_Murray,1,F-II,6,2,1,0,1,4,2
20141109-M-London-RR-Kei_Nishikori-Andy_Murray,1,B-XC,38,6,1,1,4,24,14
20141109-M-London-RR-Kei_Nishikori-Andy_Murray,1,B-DTM,12,1,0,0,1,6,6
20141109-M-London-RR-Kei_Nishikori-Andy_Murray,1,B-DTL,7,2,0,0,2,2,5
20141109-M-London-RR-Kei_Nishikori-Andy_Murray,1,B-IO,4,2,2,0,0,2,2
20141109-M-London-RR-Kei_Nishikori-Andy_Murray,1,S-XC,4,1,0,0,1,1,3
20141109-M-London-RR-Kei_Nishikori-Andy_Murray,1,S-DTM,4,0,0,0,0,2,2
20141109-M-London-RR-Kei_Nishikori-Andy_Murray,2,F-XC,32,6,0,2,4,14,18
20141109-M-London-RR-Kei_Nishikori-Andy_Murray,2,F-DTM,20,1,0,0,1,9,11
20141109-M-London-RR-Kei_Nishikori-Andy_Murray,2,F-DTL,3,0,0,0,0,2,1
20141109-M-London-RR-Kei_Nishikori-Andy_Murray,2,F-IO,11,6,4,1,1,7,4
20141109-M-London-RR-Kei_Nishikori-Andy_Murray,2,F-II,2,0,0,0,0,2,0
20141109-M-London-RR-Kei_Nishikori-Andy_Murray,2,B-XC,37,7,0,0,7,15,22
20141109-M-London-RR-Kei_Nishikori-Andy_Murray,2,B-DTM,29,4,0,0,4,9,20
20141109-M-London-RR-Kei_Nishikori-Andy_Murray,2,B-DTL,5,4,0,2,2,3,2
20141109-M-London-RR-Kei_Nishikori-Andy_Murray,2,B-IO,2,0,0,0,0,1,1
20141109-M-London-RR-Kei_Nishikori-Andy_Murray,2,S-XC,13,1,0,0,1,3,10
20141109-M-London-RR-Kei_Nishikori-Andy_Murray,2,S-DTM,14,1,0,1,0,4,10
20141109-M-London-RR-Kei_Nishikori-Andy_Murray,2,S-DTL,2,0,0,0,0,1,1
20141109-M-London-RR-Kei_Nishikori-Andy_Murray,2,S-IO,1,0,0,0,0,0,1
20141111-M-London-RR-Andy_Murray-Milos_Raonic,1,F-XC,19,2,1,1,0,14,5
20141111-M-London-RR-Andy_Murray-Milos_Raonic,1,F-DTM,19,2,0,1,1,10,9
20141111-M-London-RR-Andy_Murray-Milos_Raonic,1,F-DTL,7,0,0,0,0,3,4
20141111-M-London-RR-Andy_Murray-Milos_Raonic,1,F-IO,6,1,0,0,1,3,3
20141111-M-London-RR-Andy_Murray-Milos_Raonic,1,F-II,3,2,0,0,2,1,2
20141111-M-London-RR-Andy_Murray-Milos_Raonic,1,B-XC,23,5,1,0,4,11,12
20141111-M-London-RR-Andy_Murray-Milos_Raonic,1,B-DTM,25,2,0,1,1,13,12
20141111-M-London-RR-Andy_Murray-Milos_Raonic,1,B-DTL,8,4,1,1,2,3,5
20141111-M-London-RR-Andy_Murray-Milos_Raonic,1,B-IO,4,2,0,0,2,2,2
20141111-M-London-RR-Andy_Murray-Milos_Raonic,1,S-XC,7,0,0,0,0,3,4
20141111-M-London-RR-Andy_Murray-Milos_Raonic,1,S-DTM,5,0,0,0,0,1,4
20141111-M-London-RR-Andy_Murray-Milos_Raonic,1,S-DTL,4,1,0,1,0,2,2
20141111-M-London-RR-Andy_Murray-Milos_Raonic,1,S-IO,1,1,0,0,1,0,1
20141111-M-London-RR-Andy_Murray-Milos_Raonic,2,F-XC,23,7,1,1,5,8,15
20141111-M-London-RR-Andy_Murray-Milos_Raonic,2,F-DTM,23,2,0,0,2,11,12
20141111-M-London-RR-Andy_Murray-Milos_Raonic,2,F-DTL,4,4,0,0,4,0,4
20141111-M-London-RR-Andy_Murray-Milos_Raonic,2,F-IO,49,17,4,3,10,22,27
20141111-M-London-RR-Andy_Murray-Milos_Raonic,2,F-II,3,1,1,0,0,3,0
20141111-M-London-RR-Andy_Murray-Milos_Raonic,2,B-XC,14,3,0,0,3,9,5
20141111-M-London-RR-Andy_Murray-Milos_Raonic,2,B-DTM,11,2,0,0,2,5,6
20141111-M-London-RR-Andy_Murray-Milos_Raonic,2,B-IO,1,0,0,0,0,0,1
20141111-M-London-RR-Andy_Murray-Milos_Raonic,2,S-XC,11,0,0,0,0,3,8
20141111-M-London-RR-Andy_Murray-Milos_Raonic,2,S-DTM,2,1,0,0,1,0,2
20141111-M-London-RR-Andy_Murray-Milos_Raonic,2,S-DTL,1,1,0,0,1,0,1
20141111-M-London-RR-Andy_Murray-Milos_Raonic,2,S-IO,1,1,0,0,1,0,1
20131109-M-Tour_Finals-RR-Roger_Federer-Juan_Martin_Del_Potro,1,F-XC,34,9,3,1,5,19,15
20131109-M-Tour_Finals-RR-Roger_Federer-Juan_Martin_Del_Potro,1,F-DTM,38,5,0,0,5,15,23
20131109-M-Tour_Finals-RR-Roger_Federer-Juan_Martin_Del_Potro,1,F-DTL,3,0,0,0,0,3,0
20131109-M-Tour_Finals-RR-Roger_Federer-Juan_Martin_Del_Potro,1,F-IO,32,9,4,1,4,22,10
20131109-M-Tour_Finals-RR-Roger_Federer-Juan_Martin_Del_Potro,1,F-II,7,4,1,0,3,3,4
20131109-M-Tour_Finals-RR-Roger_Federer-Juan_Martin_Del_Potro,1,B-XC,32,2,0,0,2,12,20
20131109-M-Tour_Finals-RR-Roger_Federer-Juan_Martin_Del_Potro,1,B-DTM,31,4,0,1,3,14,17
20131109-M-Tour_Finals-RR-Roger_Federer-Juan_Martin_Del_Potro,1,B-DTL,6,1,0,0,1,3,3
20131109-M-Tour_Finals-RR-Roger_Federer-Juan_Martin_Del_Potro,1,B-IO,2,1,0,0,1,1,1
20131109-M-Tour_Finals-RR-Roger_Federer-Juan_Martin_Del_Potro,1,S-XC,26,0,0,0,0,13,13
20131109-M-Tour_Finals-RR-Roger_Federer-Juan_Martin_Del_Potro,1,S-DTM,14,0,0,0,0,9,5
20131109-M-Tour_Finals-RR-Roger_Federer-Juan_Martin_Del_Potro,1,S-DTL,4,0,0,0,0,4,0
20131109-M-Tour_Finals-RR-Roger_Federer-Juan_Martin_Del_Potro,1,S-IO,2,1,0,0,1,0,2
20131109-M-Tour_Finals-RR-Roger_Federer-Juan_Martin_Del_Potro,2,F-XC,37,13,4,3,6,20,17
20131109-M-Tour_Finals-RR-Roger_Federer-Juan_Martin_Del_Potro,2,F-DTM,46,9,0,1,8,17,29
20131109-M-Tour_Finals-RR-Roger_Federer-Juan_Martin_Del_Potro,2,F-DTL,8,2,0,1,1,4,4
20131109-M-Tour_Finals-RR-Roger_Federer-Juan_Martin_Del_Potro,2,F-IO,32,5,0,2,3,18,14
20131109-M-Tour_Finals-RR-Roger_Federer-Juan_Martin_Del_Potro,2,F-II,4,2,2,0,0,4,0
20131109-M-Tour_Finals-RR-Roger_Federer-Juan_Martin_Del_Potro,2,B-XC,50,6,0,1,5,23,27
20131109-M-Tour_Finals-RR-Roger_Federer-Juan_Martin_Del_Potro,2,B-DTM,26,0,0,0,0,10,16
20131109-M-Tour_Finals-RR-Roger_Federer-Juan_Martin_Del_Potro,2,B-DTL,5,3,1,1,1,3,2
20131109-M-Tour_Finals-RR-Roger_Federer-Juan_Martin_Del_Potro,2,B-IO,3,1,0,0,1,2,1
20131109-M-Tour_Finals-RR-Roger_Federer-Juan_Martin_Del_Potro,2,S-XC,12,1,0,0,1,4,8
20131109-M-Tour_Finals-RR-Roger_Federer-Juan_Martin_Del_Potro,2,S-DTM,3,0,0,0,0,1,2
20131109-M-Tour_Finals-RR-Roger_Federer-Juan_Martin_Del_Potro,2,S-DTL,1,0,0,0,0,0,1
20131109-M-Tour_Finals-RR-Roger_Federer-Juan_Martin_Del_Potro,2,S-IO,1,0,0,0,0,1,0
20131107-M-Tour_Finals-RR-Novak_Djokovic-Juan_Martin_Del_Potro,1,F-XC,32,9,0,3,6,19,13
20131107-M-Tour_Finals-RR-Novak_Djokovic-Juan_Martin_Del_Potro,1,F-DTM,32,2,0,0,2,17,15
20131107-M-Tour_Finals-RR-Novak_Djokovic-Juan_Martin_Del_Potro,1,F-DTL,9,4,1,1,2,6,3
20131107-M-Tour_Finals-RR-Novak_Djokovic-Juan_Martin_Del_Potro,1,F-IO,15,2,0,1,1,10,5
20131107-M-Tour_Finals-RR-Novak_Djokovic-Juan_Martin_Del_Potro,1,F-II,1,0,0,0,0,0,1
20131107-M-Tour_Finals-RR-Novak_Djokovic-Juan_Martin_Del_Potro,1,B-XC,51,5,1,1,3,24,27
20131107-M-Tour_Finals-RR-Novak_Djokovic-Juan_Martin_Del_Potro,1,B-DTM,50,3,0,0,3,25,25
20131107-M-Tour_Finals-RR-Novak_Djokovic-Juan_Martin_Del_Potro,1,B-DTL,6,6,1,1,4,2,4
20131107-M-Tour_Finals-RR-Novak_Djokovic-Juan_Martin_Del_Potro,1,B-IO,8,2,1,0,1,5,3
20131107-M-Tour_Finals-RR-Novak_Djokovic-Juan_Martin_Del_Potro,1,S-XC,7,2,0,0,2,2,5
20131107-M-Tour_Finals-RR-Novak_Djokovic-Juan_Martin_Del_Potro,1,S-DTM,3,0,0,0,0,1,2
20131107-M-Tour_Finals-RR-Novak_Djokovic-Juan_Martin_Del_Potro,2,F-XC,35,3,0,0,3,16,19
20131107-M-Tour_Finals-RR-Novak_Djokovic-Juan_Martin_Del_Potro,2,F-DTM,27,2,0,0,2,10,17
20131107-M-Tour_Finals-RR-Novak_Djokovic-Juan_Martin_Del_Potro,2,F-DTL,2,2,0,0,2,0,2
20131107-M-Tour_Finals-RR-Novak_Djokovic-Juan_Martin_Del_Potro,2,F-IO,22,4,2,0,2,15,7
20131107-M-Tour_Finals-RR-Novak_Djokovic-Juan_Martin_Del_Potro,2,F-II,4,3,1,1,1,3,1
20131107-M-Tour_Finals-RR-Novak_Djokovic-Juan_Martin_Del_Potro,2,B-XC,48,7,1,0,6,22,26
20131107-M-Tour_Finals-RR-Novak_Djokovic-Juan_Martin_Del_Potro,2,B-DTM,49,4,0,1,3,22,27
20131107-M-Tour_Finals-RR-Novak_Djokovic-Juan_Martin_Del_Potro,2,B-DTL,2,1,1,0,0,1,1
20131107-M-Tour_Finals-RR-Novak_Djokovic-Juan_Martin_Del_Potro,2,B-IO,2,1,0,0,1,1,1
20131107-M-Tour_Finals-RR-Novak_Djokovic-Juan_Martin_Del_Potro,2,S-XC,8,0,0,0,0,2,6
20131107-M-Tour_Finals-RR-Novak_Djokovic-Juan_Martin_Del_Potro,2,S-DTM,5,0,0,0,0,0,5
20131107-M-Tour_Finals-RR-Novak_Djokovic-Juan_Martin_Del_Potro,2,S-DTL,1,0,0,0,0,0,1
20131110-M-Tour_Finals-SF-Roger_Federer-Rafael_Nadal,1,F-XC,28,4,1,1,2,12,16
20131110-M-Tour_Finals-SF-Roger_Federer-Rafael_Nadal,1,F-DTM,19,7,0,1,6,5,14
20131110-M-Tour_Finals-SF-Roger_Federer-Rafael_Nadal,1,F-DTL,6,4,0,0,4,1,5
20131110-M-Tour_Finals-SF-Roger_Federer-Rafael_Nadal,1,F-IO,8,6,2,1,3,4,4
20131110-M-Tour_Finals-SF-Roger_Federer-Rafael_Nadal,1,B-XC,21,5,1,0,4,10,11
20131110-M-Tour_Finals-SF-Roger_Federer-Rafael_Nadal,1,B-DTM,20,4,0,0,4,8,12
20131110-M-Tour_Finals-SF-Roger_Federer-Rafael_Nadal,1,B-DTL,6,1,0,0,1,1,5
20131110-M-Tour_Finals-SF-Roger_Federer-Rafael_Nadal,1,B-IO,4,0,0,0,0,2,2
20131110-M-Tour_Finals-SF-Roger_Federer-Rafael_Nadal,1,S-XC,3,1,0,0,1,0,3
20131110-M-Tour_Finals-SF-Roger_Federer-Rafael_Nadal,1,S-DTM,5,0,0,0,0,2,3
20131110-M-Tour_Finals-SF-Roger_Federer-Rafael_Nadal,1,S-DTL,2,2,0,0,2,0,2
20131110-M-Tour_Finals-SF-Roger_Federer-Rafael_Nadal,1,S-IO,1,0,0,0,0,0,1
20131110-M-Tour_Finals-SF-Roger_Federer-Rafael_Nadal,2,F-XC,34,6,2,1,3,21,13
20131110-M-Tour_Finals-SF-Roger_Federer-Rafael_Nadal,2,F-DTM,20,4,0,0,4,9,11
20131110-M-Tour_Finals-SF-Roger_Federer-Rafael_Nadal,2,F-DTL,2,1,0,1,0,2,0
20131110-M-Tour_Finals-SF-Roger_Federer-Rafael_Nadal,2,F-IO,13,5,3,0,2,7,6
20131110-M-Tour_Finals-SF-Roger_Federer-Rafael_Nadal,2,F-II,1,0,0,0,0,1,0
20131110-M-Tour_Finals-SF-Roger_Federer-Rafael_Nadal,2,B-XC,19,2,1,0,1,12,7
20131110-M-Tour_Finals-SF-Roger_Federer-Rafael_Nadal,2,B-DTM,28,4,0,1,3,19,9
20131110-M-Tour_Finals-SF-Roger_Federer-Rafael_Nadal,2,B-DTL,7,2,0,0,2,3,4
20131110-M-Tour_Finals-SF-Roger_Federer-Rafael_Nadal,2,B-IO,4,1,1,0,0,3,1
20131110-M-Tour_Finals-SF-Roger_Federer-Rafael_Nadal,2,S-XC,1,0,0,0,0,1,0
20131110-M-Tour_Finals-SF-Roger_Federer-Rafael_Nadal,2,S-DTM,3,1,0,0,1,1,2
20131110-M-Tour_Finals-SF-Roger_Federer-Rafael_Nadal,2,S-DTL,3,0,0,0,0,1,2
20131107-M-Tour_Finals-RR-Richard_Gasquet-Roger_Federer,1,F-XC,9,3,1,0,2,7,2
20131107-M-Tour_Finals-RR-Richard_Gasquet-Roger_Federer,1,F-DTM,31,4,0,1,3,12,19
20131107-M-Tour_Finals-RR-Richard_Gasquet-Roger_Federer,1,F-DTL,8,1,1,0,0,3,5
20131107-M-Tour_Finals-RR-Richard_Gasquet-Roger_Federer,1,F-IO,12,1,0,0,1,6,6
20131107-M-Tour_Finals-RR-Richard_Gasquet-Roger_Federer,1,B-XC,44,8,1,1,6,29,15
20131107-M-Tour_Finals-RR-Richard_Gasquet-Roger_Federer,1,B-DTM,16,2,0,2,0,9,7
20131107-M-Tour_Finals-RR-Richard_Gasquet-Roger_Federer,1,B-DTL,4,3,2,0,1,2,2
20131107-M-Tour_Finals-RR-Richard_Gasquet-Roger_Federer,1,B-IO,1,0,0,0,0,0,1
20131107-M-Tour_Finals-RR-Richard_Gasquet-Roger_Federer,1,S-XC,9,2,0,0,2,2,7
20131107-M-Tour_Finals-RR-Richard_Gasquet-Roger_Federer,1,S-DTM,2,0,0,0,0,2,0
20131107-M-Tour_Finals-RR-Richard_Gasquet-Roger_Federer,2,F-XC,14,2,0,0,2,6,8
20131107-M-Tour_Finals-RR-Richard_Gasquet-Roger_Federer,2,F-DTM,28,3,0,0,3,12,16
20131107-M-Tour_Finals-RR-Richard_Gasquet-Roger_Federer,2,F-DTL,2,2,0,0,2,0,2
20131107-M-Tour_Finals-RR-Richard_Gasquet-Roger_Federer,2,F-IO,21,8,3,2,3,11,10
20131107-M-Tour_Finals-RR-Richard_Gasquet-Roger_Federer,2,F-II,6,5,1,2,2,4,2
20131107-M-Tour_Finals-RR-Richard_Gasquet-Roger_Federer,2,B-XC,28,6,3,0,3,13,15
20131107-M-Tour_Finals-RR-Richard_Gasquet-Roger_Federer,2,B-DTM,26,6,0,1,5,11,15
20131107-M-Tour_Finals-RR-Richard_Gasquet-Roger_Federer,2,B-DTL,5,1,0,0,1,3,2
20131107-M-Tour_Finals-RR-Richard_Gasquet-Roger_Federer,2,S-XC,9,1,0,0,1,1,8
20131107-M-Tour_Finals-RR-Richard_Gasquet-Roger_Federer,2,S-DTM,4,1,0,0,1,3,1
20131107-M-Tour_Finals-RR-Richard_Gasquet-Roger_Federer,2,S-DTL,2,0,0,0,0,0,2
20141115-M-London-SF-Roger_Federer-Stanislas_Wawrinka,1,F-XC,44,10,1,2,7,18,26
20141115-M-London-SF-Roger_Federer-Stanislas_Wawrinka,1,F-DTM,47,3,0,0,3,18,29
20141115-M-London-SF-Roger_Federer-Stanislas_Wawrinka,1,F-DTL,10,5,3,1,1,7,3
20141115-M-London-SF-Roger_Federer-Stanislas_Wawrinka,1,F-IO,28,6,0,2,4,16,12
20141115-M-London-SF-Roger_Federer-Stanislas_Wawrinka,1,F-II,5,2,0,1,1,3,2
20141115-M-London-SF-Roger_Federer-Stanislas_Wawrinka,1,B-XC,44,3,2,1,0,25,19
20141115-M-London-SF-Roger_Federer-Stanislas_Wawrinka,1,B-DTM,36,4,0,0,4,14,22
20141115-M-London-SF-Roger_Federer-Stanislas_Wawrinka,1,B-DTL,8,2,0,1,1,4,4
20141115-M-London-SF-Roger_Federer-Stanislas_Wawrinka,1,B-IO,6,1,0,0,1,2,4
20141115-M-London-SF-Roger_Federer-Stanislas_Wawrinka,1,S-XC,25,2,0,0,2,11,14
20141115-M-London-SF-Roger_Federer-Stanislas_Wawrinka,1,S-DTM,18,1,0,0,1,5,13
20141115-M-London-SF-Roger_Federer-Stanislas_Wawrinka,1,S-DTL,2,0,0,0,0,1,1
20141115-M-London-SF-Roger_Federer-Stanislas_Wawrinka,2,F-XC,51,11,4,5,2,33,18
20141115-M-London-SF-Roger_Federer-Stanislas_Wawrinka,2,F-DTM,44,6,1,1,4,26,18
20141115-M-London-SF-Roger_Federer-Stanislas_Wawrinka,2,F-DTL,14,5,0,0,5,5,9
20141115-M-London-SF-Roger_Federer-Stanislas_Wawrinka,2,F-IO,34,8,4,0,4,18,16
20141115-M-London-SF-Roger_Federer-Stanislas_Wawrinka,2,F-II,6,3,0,0,3,1,5
20141115-M-London-SF-Roger_Federer-Stanislas_Wawrinka,2,B-XC,89,15,5,3,7,48,41
20141115-M-London-SF-Roger_Federer-Stanislas_Wawrinka,2,B-DTM,27,4,0,1,3,13,14
20141115-M-London-SF-Roger_Federer-Stanislas_Wawrinka,2,B-DTL,9,5,2,0,3,4,5
20141115-M-London-SF-Roger_Federer-Stanislas_Wawrinka,2,B-IO,9,6,3,0,3,5,4
20141115-M-London-SF-Roger_Federer-Stanislas_Wawrinka,2,S-XC,11,2,0,2,0,3,8
20141115-M-London-SF-Roger_Federer-Stanislas_Wawrinka,2,S-DTM,5,1,0,0,1,1,4
20141115-M-London-SF-Roger_Federer-Stanislas_Wawrinka,2,S-DTL,1,0,0,0,0,0,1
20131106-M-Tour_Finals-RR-David_Ferrer-Tomas_Berdych,1,F-XC,25,4,0,2,2,15,10
20131106-M-Tour_Finals-RR-David_Ferrer-Tomas_Berdych,1,F-DTM,40,7,0,0,7,22,18
20131106-M-Tour_Finals-RR-David_Ferrer-Tomas_Berdych,1,F-DTL,6,2,1,0,1,3,3
20131106-M-Tour_Finals-RR-David_Ferrer-Tomas_Berdych,1,F-IO,17,2,0,2,0,12,5
20131106-M-Tour_Finals-RR-David_Ferrer-Tomas_Berdych,1,F-II,2,0,0,0,0,1,1
20131106-M-Tour_Finals-RR-David_Ferrer-Tomas_Berdych,1,B-XC,16,0,0,0,0,9,7
20131106-M-Tour_Finals-RR-David_Ferrer-Tomas_Berdych,1,B-DTM,26,3,0,0,3,14,12
20131106-M-Tour_Finals-RR-David_Ferrer-Tomas_Berdych,1,S-XC,3,0,0,0,0,2,1
20131106-M-Tour_Finals-RR-David_Ferrer-Tomas_Berdych,1,S-DTL,1,0,0,0,0,0,1
20131106-M-Tour_Finals-RR-David_Ferrer-Tomas_Berdych,2,F-XC,31,9,3,2,4,15,16
20131106-M-Tour_Finals-RR-David_Ferrer-Tomas_Berdych,2,F-DTM,19,1,0,0,1,3,16
20131106-M-Tour_Finals-RR-David_Ferrer-Tomas_Berdych,2,F-DTL,2,1,1,0,0,2,0
20131106-M-Tour_Finals-RR-David_Ferrer-Tomas_Berdych,2,F-IO,12,7,3,1,3,6,6
20131106-M-Tour_Finals-RR-David_Ferrer-Tomas_Berdych,2,F-II,3,1,0,0,1,1,2
20131106-M-Tour_Finals-RR-David_Ferrer-Tomas_Berdych,2,B-XC,26,9,2,2,5,8,18
20131106-M-Tour_Finals-RR-David_Ferrer-Tomas_Berdych,2,B-DTM,26,2,0,0,2,14,12
20131106-M-Tour_Finals-RR-David_Ferrer-Tomas_Berdych,2,B-DTL,4,0,0,0,0,2,2
20131106-M-Tour_Finals-RR-David_Ferrer-Tomas_Berdych,2,B-IO,5,2,0,0,2,2,3
20131106-M-Tour_Finals-RR-David_Ferrer-Tomas_Berdych,2,S-XC,15,2,0,0,2,6,9
20131106-M-Tour_Finals-RR-David_Ferrer-Tomas_Berdych,2,S-DTM,5,0,0,0,0,1,4
20131106-M-Tour_Finals-RR-David_Ferrer-Tomas_Berdych,2,S-DTL,1,1,0,0,1,0,1
20131106-M-Tour_Finals-RR-David_Ferrer-Tomas_Berdych,2,S-IO,2,0,0,0,0,1,1
20131108-M-Tour_Finals-RR-Stanislas_Wawrinka-David_Ferrer,1,F-XC,47,10,0,3,7,13,34
20131108-M-Tour_Finals-RR-Stanislas_Wawrinka-David_Ferrer,1,F-DTM,30,3,0,0,3,15,15
20131108-M-Tour_Finals-RR-Stanislas_Wawrinka-David_Ferrer,1,F-DTL,8,7,3,0,4,3,5
20131108-M-Tour_Finals-RR-Stanislas_Wawrinka-David_Ferrer,1,F-IO,11,4,1,1,2,7,4
20131108-M-Tour_Finals-RR-Stanislas_Wawrinka-David_Ferrer,1,F-II,2,0,0,0,0,1,1
20131108-M-Tour_Finals-RR-Stanislas_Wawrinka-David_Ferrer,1,B-XC,58,11,0,2,9,28,30
20131108-M-Tour_Finals-RR-Stanislas_Wawrinka-David_Ferrer,1,B-DTM,21,5,0,0,5,5,16
20131108-M-Tour_Finals-RR-Stanislas_Wawrinka-David_Ferrer,1,B-DTL,10,5,2,0,3,6,4
20131108-M-Tour_Finals-RR-Stanislas_Wawrinka-David_Ferrer,1,B-IO,5,2,0,0,2,2,3
20131108-M-Tour_Finals-RR-Stanislas_Wawrinka-David_Ferrer,1,S-XC,28,2,0,0,2,13,15
20131108-M-Tour_Finals-RR-Stanislas_Wawrinka-David_Ferrer,1,S-DTM,9,2,0,0,2,1,8
20131108-M-Tour_Finals-RR-Stanislas_Wawrinka-David_Ferrer,1,S-DTL,2,0,0,0,0,1,1
20131108-M-Tour_Finals-RR-Stanislas_Wawrinka-David_Ferrer,2,F-XC,41,5,0,0,5,27,14
20131108-M-Tour_Finals-RR-Stanislas_Wawrinka-David_Ferrer,2,F-DTM,43,2,0,0,2,25,18
20131108-M-Tour_Finals-RR-Stanislas_Wawrinka-David_Ferrer,2,F-DTL,9,2,0,0,2,5,4
20131108-M-Tour_Finals-RR-Stanislas_Wawrinka-David_Ferrer,2,F-IO,31,3,1,0,2,15,16
20131108-M-Tour_Finals-RR-Stanislas_Wawrinka-David_Ferrer,2,F-II,3,0,0,0,0,1,2
20131108-M-Tour_Finals-RR-Stanislas_Wawrinka-David_Ferrer,2,B-XC,44,7,1,2,4,24,20
20131108-M-Tour_Finals-RR-Stanislas_Wawrinka-David_Ferrer,2,B-DTM,25,6,0,0,6,9,16
20131108-M-Tour_Finals-RR-Stanislas_Wawrinka-David_Ferrer,2,B-DTL,2,1,1,0,0,2,0
20131108-M-Tour_Finals-RR-Stanislas_Wawrinka-David_Ferrer,2,B-IO,1,0,0,0,0,1,0
20131108-M-Tour_Finals-RR-Stanislas_Wawrinka-David_Ferrer,2,S-XC,4,0,0,0,0,2,2
20131108-M-Tour_Finals-RR-Stanislas_Wawrinka-David_Ferrer,2,S-DTM,7,1,0,1,0,3,4
20131110-M-Tour_Finals-SF-Novak_Djokovic-Stanislas_Wawrinka,1,F-XC,33,3,2,0,1,27,6
20131110-M-Tour_Finals-SF-Novak_Djokovic-Stanislas_Wawrinka,1,F-DTM,37,5,1,0,4,21,16
20131110-M-Tour_Finals-SF-Novak_Djokovic-Stanislas_Wawrinka,1,F-DTL,9,1,0,1,0,7,2
20131110-M-Tour_Finals-SF-Novak_Djokovic-Stanislas_Wawrinka,1,F-IO,38,4,0,3,1,27,11
20131110-M-Tour_Finals-SF-Novak_Djokovic-Stanislas_Wawrinka,1,F-II,3,1,0,0,1,2,1
20131110-M-Tour_Finals-SF-Novak_Djokovic-Stanislas_Wawrinka,1,B-XC,47,4,1,1,2,29,18
20131110-M-Tour_Finals-SF-Novak_Djokovic-Stanislas_Wawrinka,1,B-DTM,38,1,0,1,0,26,12
20131110-M-Tour_Finals-SF-Novak_Djokovic-Stanislas_Wawrinka,1,B-DTL,13,1,0,0,1,4,9
20131110-M-Tour_Finals-SF-Novak_Djokovic-Stanislas_Wawrinka,1,B-IO,5,0,0,0,0,3,2
20131110-M-Tour_Finals-SF-Novak_Djokovic-Stanislas_Wawrinka,1,S-XC,4,1,0,0,1,3,1
20131110-M-Tour_Finals-SF-Novak_Djokovic-Stanislas_Wawrinka,1,S-DTM,3,1,0,0,1,1,2
20131110-M-Tour_Finals-SF-Novak_Djokovic-Stanislas_Wawrinka,1,S-DTL,2,1,0,0,1,0,2
20131110-M-Tour_Finals-SF-Novak_Djokovic-Stanislas_Wawrinka,2,F-XC,58,15,4,4,7,22,36
20131110-M-Tour_Finals-SF-Novak_Djokovic-Stanislas_Wawrinka,2,F-DTM,40,2,0,0,2,15,25
20131110-M-Tour_Finals-SF-Novak_Djokovic-Stanislas_Wawrinka,2,F-DTL,4,2,0,0,2,1,3
20131110-M-Tour_Finals-SF-Novak_Djokovic-Stanislas_Wawrinka,2,F-IO,16,6,0,0,6,3,13
20131110-M-Tour_Finals-SF-Novak_Djokovic-Stanislas_Wawrinka,2,B-XC,53,5,1,1,3,20,33
20131110-M-Tour_Finals-SF-Novak_Djokovic-Stanislas_Wawrinka,2,B-DTM,33,5,0,0,5,8,25
20131110-M-Tour_Finals-SF-Novak_Djokovic-Stanislas_Wawrinka,2,B-DTL,6,5,0,0,5,0,6
20131110-M-Tour_Finals-SF-Novak_Djokovic-Stanislas_Wawrinka,2,B-IO,4,3,1,0,2,1,3
20131110-M-Tour_Finals-SF-Novak_Djokovic-Stanislas_Wawrinka,2,S-XC,26,3,0,0,3,12,14
20131110-M-Tour_Finals-SF-Novak_Djokovic-Stanislas_Wawrinka,2,S-DTM,10,1,0,0,1,1,9
20131110-M-Tour_Finals-SF-Novak_Djokovic-Stanislas_Wawrinka,2,S-DTL,2,1,0,0,1,0,2
20131110-M-Tour_Finals-SF-Novak_Djokovic-Stanislas_Wawrinka,2,S-IO,1,0,0,0,0,1,0
20141112-M-London-RR-Marin_Cilic-Tomas_Berdych,1,F-XC,30,9,1,1,7,14,16
20141112-M-London-RR-Marin_Cilic-Tomas_Berdych,1,F-DTM,21,4,0,0,4,7,14
20141112-M-London-RR-Marin_Cilic-Tomas_Berdych,1,F-DTL,5,2,0,0,2,2,3
20141112-M-London-RR-Marin_Cilic-Tomas_Berdych,1,F-IO,13,6,2,1,3,7,6
20141112-M-London-RR-Marin_Cilic-Tomas_Berdych,1,B-XC,33,4,0,1,3,17,16
20141112-M-London-RR-Marin_Cilic-Tomas_Berdych,1,B-DTM,24,4,0,0,4,8,16
20141112-M-London-RR-Marin_Cilic-Tomas_Berdych,1,B-DTL,2,2,1,0,1,1,1
20141112-M-London-RR-Marin_Cilic-Tomas_Berdych,1,B-IO,3,1,1,0,0,2,1
20141112-M-London-RR-Marin_Cilic-Tomas_Berdych,1,S-XC,1,1,0,0,1,0,1
20141112-M-London-RR-Marin_Cilic-Tomas_Berdych,1,S-DTM,1,0,0,0,0,0,1
20141112-M-London-RR-Marin_Cilic-Tomas_Berdych,2,F-XC,16,3,2,0,1,10,6
20141112-M-London-RR-Marin_Cilic-Tomas_Berdych,2,F-DTM,21,1,0,0,1,12,9
20141112-M-London-RR-Marin_Cilic-Tomas_Berdych,2,F-DTL,6,6,1,1,4,2,4
20141112-M-London-RR-Marin_Cilic-Tomas_Berdych,2,F-IO,12,7,2,2,3,8,4
20141112-M-London-RR-Marin_Cilic-Tomas_Berdych,2,B-XC,18,2,0,1,1,8,10
20141112-M-London-RR-Marin_Cilic-Tomas_Berdych,2,B-DTM,27,5,0,1,4,12,15
20141112-M-London-RR-Marin_Cilic-Tomas_Berdych,2,B-DTL,10,4,1,1,2,3,7
20141112-M-London-RR-Marin_Cilic-Tomas_Berdych,2,B-IO,2,1,1,0,0,2,0
20141112-M-London-RR-Marin_Cilic-Tomas_Berdych,2,S-XC,7,0,0,0,0,5,2
20141112-M-London-RR-Marin_Cilic-Tomas_Berdych,2,S-DTM,6,0,0,0,0,2,4
20141112-M-London-RR-Marin_Cilic-Tomas_Berdych,2,S-DTL,4,0,0,0,0,3,1
20141110-M-London-RR-Marin_Cilic-Novak_Djokovic,1,F-XC,29,6,1,1,4,9,20
20141110-M-London-RR-Marin_Cilic-Novak_Djokovic,1,F-DTM,12,1,0,0,1,7,5
20141110-M-London-RR-Marin_Cilic-Novak_Djokovic,1,F-DTL,2,0,0,0,0,0,2
20141110-M-London-RR-Marin_Cilic-Novak_Djokovic,1,F-IO,17,4,0,0,4,6,11
20141110-M-London-RR-Marin_Cilic-Novak_Djokovic,1,F-II,3,2,0,0,2,0,3
20141110-M-London-RR-Marin_Cilic-Novak_Djokovic,1,B-XC,17,6,1,0,5,5,12
20141110-M-London-RR-Marin_Cilic-Novak_Djokovic,1,B-DTM,24,5,1,0,4,6,18
20141110-M-London-RR-Marin_Cilic-Novak_Djokovic,1,B-DTL,1,0,0,0,0,0,1
20141110-M-London-RR-Marin_Cilic-Novak_Djokovic,1,B-IO,1,0,0,0,0,0,1
20141110-M-London-RR-Marin_Cilic-Novak_Djokovic,1,S-XC,4,0,0,0,0,1,3
20141110-M-London-RR-Marin_Cilic-Novak_Djokovic,1,S-DTM,1,0,0,0,0,1,0
20141110-M-London-RR-Marin_Cilic-Novak_Djokovic,2,F-XC,13,5,3,1,1,11,2
20141110-M-London-RR-Marin_Cilic-Novak_Djokovic,2,F-DTM,20,2,0,1,1,11,9
20141110-M-London-RR-Marin_Cilic-Novak_Djokovic,2,F-DTL,7,2,0,1,1,5,2
20141110-M-London-RR-Marin_Cilic-Novak_Djokovic,2,F-IO,12,4,1,1,2,7,5
20141110-M-London-RR-Marin_Cilic-Novak_Djokovic,2,F-II,1,1,1,0,0,1,0
20141110-M-London-RR-Marin_Cilic-Novak_Djokovic,2,B-XC,18,0,0,0,0,13,5
20141110-M-London-RR-Marin_Cilic-Novak_Djokovic,2,B-DTM,17,2,0,0,2,7,10
20141110-M-London-RR-Marin_Cilic-Novak_Djokovic,2,B-DTL,5,4,1,0,3,2,3
20141110-M-London-RR-Marin_Cilic-Novak_Djokovic,2,B-IO,4,0,0,0,0,2,2
20141110-M-London-RR-Marin_Cilic-Novak_Djokovic,2,S-XC,4,0,0,0,0,4,0
20141110-M-London-RR-Marin_Cilic-Novak_Djokovic,2,S-DTM,2,0,0,0,0,2,0
20131111-M-Tour_Finals-F-Novak_Djokovic-Rafael_Nadal,1,F-XC,45,5,0,1,4,24,21
20131111-M-Tour_Finals-F-Novak_Djokovic-Rafael_Nadal,1,F-DTM,23,2,0,0,2,13,10
20131111-M-Tour_Finals-F-Novak_Djokovic-Rafael_Nadal,1,F-DTL,9,3,1,0,2,3,6
20131111-M-Tour_Finals-F-Novak_Djokovic-Rafael_Nadal,1,F-IO,25,6,2,2,2,17,8
20131111-M-Tour_Finals-F-Novak_Djokovic-Rafael_Nadal,1,F-II,1,0,0,0,0,0,1
20131111-M-Tour_Finals-F-Novak_Djokovic-Rafael_Nadal,1,B-XC,25,7,2,2,3,14,11
20131111-M-Tour_Finals-F-Novak_Djokovic-Rafael_Nadal,1,B-DTM,38,3,0,0,3,22,16
20131111-M-Tour_Finals-F-Novak_Djokovic-Rafael_Nadal,1,B-DTL,15,6,1,1,4,6,9
20131111-M-Tour_Finals-F-Novak_Djokovic-Rafael_Nadal,1,B-IO,5,2,1,0,1,4,1
20131111-M-Tour_Finals-F-Novak_Djokovic-Rafael_Nadal,1,S-DTM,2,1,0,0,1,0,2
20131111-M-Tour_Finals-F-Novak_Djokovic-Rafael_Nadal,2,F-XC,46,3,1,0,2,23,23
20131111-M-Tour_Finals-F-Novak_Djokovic-Rafael_Nadal,2,F-DTM,40,6,0,0,6,15,25
20131111-M-Tour_Finals-F-Novak_Djokovic-Rafael_Nadal,2,F-DTL,3,2,0,0,2,1,2
20131111-M-Tour_Finals-F-Novak_Djokovic-Rafael_Nadal,2,F-IO,29,6,0,1,5,10,19
20131111-M-Tour_Finals-F-Novak_Djokovic-Rafael_Nadal,2,F-II,2,2,1,0,1,1,1
20131111-M-Tour_Finals-F-Novak_Djokovic-Rafael_Nadal,2,B-XC,14,3,1,1,1,9,5
20131111-M-Tour_Finals-F-Novak_Djokovic-Rafael_Nadal,2,B-DTM,28,3,0,0,3,9,19
20131111-M-Tour_Finals-F-Novak_Djokovic-Rafael_Nadal,2,B-DTL,5,3,0,1,2,2,3
20131111-M-Tour_Finals-F-Novak_Djokovic-Rafael_Nadal,2,B-IO,5,0,0,0,0,2,3
20131111-M-Tour_Finals-F-Novak_Djokovic-Rafael_Nadal,2,S-XC,7,0,0,0,0,4,3
20131111-M-Tour_Finals-F-Novak_Djokovic-Rafael_Nadal,2,S-DTM,11,2,0,0,2,2,9
20131111-M-Tour_Finals-F-Novak_Djokovic-Rafael_Nadal,2,S-DTL,5,3,1,0,2,2,3
20131111-M-Tour_Finals-F-Novak_Djokovic-Rafael_Nadal,2,S-IO,3,0,0,0,0,2,1
20141114-M-London-RR-Stanislas_Wawrinka-Marin_Cilic,1,F-XC,19,11,2,5,4,13,6
20141114-M-London-RR-Stanislas_Wawrinka-Marin_Cilic,1,F-DTM,26,6,0,0,6,11,15
20141114-M-London-RR-Stanislas_Wawrinka-Marin_Cilic,1,F-DTL,8,3,0,1,2,2,6
20141114-M-London-RR-Stanislas_Wawrinka-Marin_Cilic,1,F-IO,12,6,4,1,1,11,1
20141114-M-London-RR-Stanislas_Wawrinka-Marin_Cilic,1,F-II,2,0,0,0,0,2,0
20141114-M-London-RR-Stanislas_Wawrinka-Marin_Cilic,1,B-XC,27,7,1,2,4,18,9
20141114-M-London-RR-Stanislas_Wawrinka-Marin_Cilic,1,B-DTM,9,2,1,0,1,6,3
20141114-M-London-RR-Stanislas_Wawrinka-Marin_Cilic,1,B-DTL,8,7,3,0,4,4,4
20141114-M-London-RR-Stanislas_Wawrinka-Marin_Cilic,1,B-IO,1,0,0,0,0,1,0
20141114-M-London-RR-Stanislas_Wawrinka-Marin_Cilic,1,S-XC,9,0,0,0,0,5,4
20141114-M-London-RR-Stanislas_Wawrinka-Marin_Cilic,1,S-DTM,4,1,0,0,1,2,2
20141114-M-London-RR-Stanislas_Wawrinka-Marin_Cilic,2,F-XC,31,10,0,2,8,15,16
20141114-M-London-RR-Stanislas_Wawrinka-Marin_Cilic,2,F-DTM,9,0,0,0,0,1,8
20141114-M-London-RR-Stanislas_Wawrinka-Marin_Cilic,2,F-DTL,2,1,1,0,0,1,1
20141114-M-London-RR-Stanislas_Wawrinka-Marin_Cilic,2,F-IO,21,5,1,2,2,12,9
20141114-M-London-RR-Stanislas_Wawrinka-Marin_Cilic,2,F-II,8,4,2,2,0,5,3
20141114-M-London-RR-Stanislas_Wawrinka-Marin_Cilic,2,B-XC,30,8,0,1,7,8,22
20141114-M-London-RR-Stanislas_Wawrinka-Marin_Cilic,2,B-DTM,12,2,0,0,2,3,9
20141114-M-London-RR-Stanislas_Wawrinka-Marin_Cilic,2,B-DTL,5,3,1,1,1,3,2
20141114-M-London-RR-Stanislas_Wawrinka-Marin_Cilic,2,B-IO,2,1,1,0,0,2,0
20141114-M-London-RR-Stanislas_Wawrinka-Marin_Cilic,2,S-XC,6,2,0,0,2,0,6
20141114-M-London-RR-Stanislas_Wawrinka-Marin_Cilic,2,S-DTL,1,1,0,0,1,0,1
20140921-M-Campinas_CH-F-Andre_Ghem-Diego_Sebastian_Schwartzman,1,F-XC,38,16,7,5,4,20,18
20140921-M-Campinas_CH-F-Andre_Ghem-Diego_Sebastian_Schwartzman,1,F-DTM,17,7,0,2,5,6,11
20140921-M-Campinas_CH-F-Andre_Ghem-Diego_Sebastian_Schwartzman,1,F-DTL,8,4,0,0,4,1,7
20140921-M-Campinas_CH-F-Andre_Ghem-Diego_Sebastian_Schwartzman,1,F-IO,19,8,4,2,2,14,5
20140921-M-Campinas_CH-F-Andre_Ghem-Diego_Sebastian_Schwartzman,1,F-II,1,1,1,0,0,1,0
20140921-M-Campinas_CH-F-Andre_Ghem-Diego_Sebastian_Schwartzman,1,B-XC,28,10,2,2,6,16,12
20140921-M-Campinas_CH-F-Andre_Ghem-Diego_Sebastian_Schwartzman,1,B-DTM,23,1,0,0,1,8,15
20140921-M-Campinas_CH-F-Andre_Ghem-Diego_Sebastian_Schwartzman,1,B-DTL,12,5,2,1,2,7,5
20140921-M-Campinas_CH-F-Andre_Ghem-Diego_Sebastian_Schwartzman,1,B-IO,12,5,1,0,4,5,7
20140921-M-Campinas_CH-F-Andre_Ghem-Diego_Sebastian_Schwartzman,1,S-XC,12,1,0,1,0,6,6
20140921-M-Campinas_CH-F-Andre_Ghem-Diego_Sebastian_Schwartzman,1,S-DTM,6,2,0,0,2,1,5
20140921-M-Campinas_CH-F-Andre_Ghem-Diego_Sebastian_Schwartzman,1,S-DTL,3,2,1,1,0,2,1
20140921-M-Campinas_CH-F-Andre_Ghem-Diego_Sebastian_Schwartzman,1,S-IO,1,0,0,0,0,1,0
20140921-M-Campinas_CH-F-Andre_Ghem-Diego_Sebastian_Schwartzman,2,F-XC,31,8,4,1,3,23,8
20140921-M-Campinas_CH-F-Andre_Ghem-Diego_Sebastian_Schwartzman,2,F-DTM,32,7,0,3,4,13,19
20140921-M-Campinas_CH-F-Andre_Ghem-Diego_Sebastian_Schwartzman,2,F-DTL,14,7,0,2,5,4,10
20140921-M-Campinas_CH-F-Andre_Ghem-Diego_Sebastian_Schwartzman,2,F-IO,19,8,0,4,4,11,8
20140921-M-Campinas_CH-F-Andre_Ghem-Diego_Sebastian_Schwartzman,2,F-II,8,8,2,1,5,3,5
20140921-M-Campinas_CH-F-Andre_Ghem-Diego_Sebastian_Schwartzman,2,B-XC,31,5,2,2,1,15,16
20140921-M-Campinas_CH-F-Andre_Ghem-Diego_Sebastian_Schwartzman,2,B-DTM,19,3,0,0,3,7,12
20140921-M-Campinas_CH-F-Andre_Ghem-Diego_Sebastian_Schwartzman,2,B-DTL,3,3,2,0,1,2,1
20140921-M-Campinas_CH-F-Andre_Ghem-Diego_Sebastian_Schwartzman,2,B-IO,1,0,0,0,0,1,0
20140921-M-Campinas_CH-F-Andre_Ghem-Diego_Sebastian_Schwartzman,2,S-XC,2,0,0,0,0,1,1
20140921-M-Campinas_CH-F-Andre_Ghem-Diego_Sebastian_Schwartzman,2,S-DTM,9,0,0,0,0,3,6
20140921-M-Campinas_CH-F-Andre_Ghem-Diego_Sebastian_Schwartzman,2,S-DTL,1,1,1,0,0,1,0
20150303-M-Quimper_CH-R32-Jurgen_Zopp-Maxime_Authom,1,F-XC,25,6,2,1,3,13,12
20150303-M-Quimper_CH-R32-Jurgen_Zopp-Maxime_Authom,1,F-DTM,23,4,0,0,4,12,11
20150303-M-Quimper_CH-R32-Jurgen_Zopp-Maxime_Authom,1,F-DTL,4,0,0,0,0,1,3
20150303-M-Quimper_CH-R32-Jurgen_Zopp-Maxime_Authom,1,F-IO,17,10,3,1,6,7,10
20150303-M-Quimper_CH-R32-Jurgen_Zopp-Maxime_Authom,1,F-II,2,1,1,0,0,2,0
20150303-M-Quimper_CH-R32-Jurgen_Zopp-Maxime_Authom,1,B-XC,22,4,1,1,2,13,9
20150303-M-Quimper_CH-R32-Jurgen_Zopp-Maxime_Authom,1,B-DTM,25,2,0,0,2,6,19
20150303-M-Quimper_CH-R32-Jurgen_Zopp-Maxime_Authom,1,B-DTL,5,3,1,0,2,1,4
20150303-M-Quimper_CH-R32-Jurgen_Zopp-Maxime_Authom,1,B-IO,6,3,0,2,1,3,3
20150303-M-Quimper_CH-R32-Jurgen_Zopp-Maxime_Authom,1,S-XC,1,0,0,0,0,0,1
20150303-M-Quimper_CH-R32-Jurgen_Zopp-Maxime_Authom,1,S-DTM,1,0,0,0,0,0,1
20150303-M-Quimper_CH-R32-Jurgen_Zopp-Maxime_Authom,1,S-DTL,2,0,0,0,0,1,1
20150303-M-Quimper_CH-R32-Jurgen_Zopp-Maxime_Authom,2,F-XC,28,4,3,1,0,16,12
20150303-M-Quimper_CH-R32-Jurgen_Zopp-Maxime_Authom,2,F-DTM,26,2,0,1,1,13,13
20150303-M-Quimper_CH-R32-Jurgen_Zopp-Maxime_Authom,2,F-DTL,6,5,2,0,3,3,3
20150303-M-Quimper_CH-R32-Jurgen_Zopp-Maxime_Authom,2,F-IO,25,14,6,2,6,16,9
20150303-M-Quimper_CH-R32-Jurgen_Zopp-Maxime_Authom,2,F-II,1,1,0,0,1,0,1
20150303-M-Quimper_CH-R32-Jurgen_Zopp-Maxime_Authom,2,B-XC,28,8,1,2,5,13,15
20150303-M-Quimper_CH-R32-Jurgen_Zopp-Maxime_Authom,2,B-DTM,23,4,0,1,3,15,8
20150303-M-Quimper_CH-R32-Jurgen_Zopp-Maxime_Authom,2,B-DTL,7,4,1,0,3,4,3
20150303-M-Quimper_CH-R32-Jurgen_Zopp-Maxime_Authom,2,B-IO,3,2,1,1,0,3,0
20150303-M-Quimper_CH-R32-Jurgen_Zopp-Maxime_Authom,2,S-XC,3,0,0,0,0,1,2
20150303-M-Quimper_CH-R32-Jurgen_Zopp-Maxime_Authom,2,S-DTM,1,0,0,0,0,0,1
20150318-M-Shenzhen_CH-R16-Marton_Fucsovics-Tristan_Lamasine,1,F-XC,26,9,1,3,5,18,8
20150318-M-Shenzhen_CH-R16-Marton_Fucsovics-Tristan_Lamasine,1,F-DTM,22,2,0,0,2,8,14
20150318-M-Shenzhen_CH-R16-Marton_Fucsovics-Tristan_Lamasine,1,F-DTL,11,3,1,0,2,6,5
20150318-M-Shenzhen_CH-R16-Marton_Fucsovics-Tristan_Lamasine,1,F-IO,14,6,2,2,2,9,5
20150318-M-Shenzhen_CH-R16-Marton_Fucsovics-Tristan_Lamasine,1,F-II,2,1,1,0,0,1,1
20150318-M-Shenzhen_CH-R16-Marton_Fucsovics-Tristan_Lamasine,1,B-XC,12,4,0,2,2,5,7
20150318-M-Shenzhen_CH-R16-Marton_Fucsovics-Tristan_Lamasine,1,B-DTM,15,3,0,1,2,4,11
20150318-M-Shenzhen_CH-R16-Marton_Fucsovics-Tristan_Lamasine,1,B-DTL,3,2,1,0,1,1,2
20150318-M-Shenzhen_CH-R16-Marton_Fucsovics-Tristan_Lamasine,1,B-IO,6,3,1,1,1,4,2
20150318-M-Shenzhen_CH-R16-Marton_Fucsovics-Tristan_Lamasine,1,S-XC,9,1,0,0,1,3,6
20150318-M-Shenzhen_CH-R16-Marton_Fucsovics-Tristan_Lamasine,1,S-DTM,7,1,0,0,1,2,5
20150318-M-Shenzhen_CH-R16-Marton_Fucsovics-Tristan_Lamasine,1,S-DTL,3,1,0,0,1,0,3
20150318-M-Shenzhen_CH-R16-Marton_Fucsovics-Tristan_Lamasine,2,F-XC,31,14,6,4,4,18,13
20150318-M-Shenzhen_CH-R16-Marton_Fucsovics-Tristan_Lamasine,2,F-DTM,15,2,0,0,2,8,7
20150318-M-Shenzhen_CH-R16-Marton_Fucsovics-Tristan_Lamasine,2,F-DTL,3,1,0,0,1,1,2
20150318-M-Shenzhen_CH-R16-Marton_Fucsovics-Tristan_Lamasine,2,F-IO,34,13,3,4,6,25,9
20150318-M-Shenzhen_CH-R16-Marton_Fucsovics-Tristan_Lamasine,2,F-II,2,2,1,1,0,2,0
20150318-M-Shenzhen_CH-R16-Marton_Fucsovics-Tristan_Lamasine,2,B-XC,12,5,1,1,3,5,7
20150318-M-Shenzhen_CH-R16-Marton_Fucsovics-Tristan_Lamasine,2,B-DTM,14,5,0,2,3,7,7
20150318-M-Shenzhen_CH-R16-Marton_Fucsovics-Tristan_Lamasine,2,B-DTL,3,0,0,0,0,2,1
20150318-M-Shenzhen_CH-R16-Marton_Fucsovics-Tristan_Lamasine,2,S-XC,6,0,0,0,0,2,4
20150318-M-Shenzhen_CH-R16-Marton_Fucsovics-Tristan_Lamasine,2,S-DTM,6,0,0,0,0,0,6
20150325-M-Miami_Masters-R128-Diego_Sebastian_Schwartzman-Dominic_Thiem,1,F-XC,36,7,1,2,4,21,15
20150325-M-Miami_Masters-R128-Diego_Sebastian_Schwartzman-Dominic_Thiem,1,F-DTM,30,3,0,0,3,13,17
20150325-M-Miami_Masters-R128-Diego_Sebastian_Schwartzman-Dominic_Thiem,1,F-DTL,11,5,1,2,2,7,4
20150325-M-Miami_Masters-R128-Diego_Sebastian_Schwartzman-Dominic_Thiem,1,F-IO,36,14,3,1,10,18,18
20150325-M-Miami_Masters-R128-Diego_Sebastian_Schwartzman-Dominic_Thiem,1,F-II,2,0,0,0,0,1,1
20150325-M-Miami_Masters-R128-Diego_Sebastian_Schwartzman-Dominic_Thiem,1,B-XC,44,4,0,2,2,26,18
20150325-M-Miami_Masters-R128-Diego_Sebastian_Schwartzman-Dominic_Thiem,1,B-DTM,34,7,0,1,6,16,18
20150325-M-Miami_Masters-R128-Diego_Sebastian_Schwartzman-Dominic_Thiem,1,B-DTL,7,3,2,0,1,2,5
20150325-M-Miami_Masters-R128-Diego_Sebastian_Schwartzman-Dominic_Thiem,1,B-IO,8,6,0,2,4,3,5
20150325-M-Miami_Masters-R128-Diego_Sebastian_Schwartzman-Dominic_Thiem,1,S-XC,3,0,0,0,0,1,2
20150325-M-Miami_Masters-R128-Diego_Sebastian_Schwartzman-Dominic_Thiem,1,S-DTM,5,0,0,0,0,1,4
20150325-M-Miami_Masters-R128-Diego_Sebastian_Schwartzman-Dominic_Thiem,1,S-IO,1,0,0,0,0,1,0
20150325-M-Miami_Masters-R128-Diego_Sebastian_Schwartzman-Dominic_Thiem,2,F-XC,39,15,4,1,10,19,20
20150325-M-Miami_Masters-R128-Diego_Sebastian_Schwartzman-Dominic_Thiem,2,F-DTM,23,3,0,2,1,13,10
20150325-M-Miami_Masters-R128-Diego_Sebastian_Schwartzman-Dominic_Thiem,2,F-DTL,10,6,1,0,5,4,6
20150325-M-Miami_Masters-R128-Diego_Sebastian_Schwartzman-Dominic_Thiem,2,F-IO,27,9,2,2,5,10,17
20150325-M-Miami_Masters-R128-Diego_Sebastian_Schwartzman-Dominic_Thiem,2,F-II,3,1,1,0,0,1,2
20150325-M-Miami_Masters-R128-Diego_Sebastian_Schwartzman-Dominic_Thiem,2,B-XC,21,3,0,1,2,11,10
20150325-M-Miami_Masters-R128-Diego_Sebastian_Schwartzman-Dominic_Thiem,2,B-DTM,18,2,0,0,2,9,9
20150325-M-Miami_Masters-R128-Diego_Sebastian_Schwartzman-Dominic_Thiem,2,B-DTL,3,3,3,0,0,3,0
20150325-M-Miami_Masters-R128-Diego_Sebastian_Schwartzman-Dominic_Thiem,2,B-IO,2,1,0,0,1,0,2
20150325-M-Miami_Masters-R128-Diego_Sebastian_Schwartzman-Dominic_Thiem,2,S-XC,32,6,0,0,6,12,20
20150325-M-Miami_Masters-R128-Diego_Sebastian_Schwartzman-Dominic_Thiem,2,S-DTM,18,0,0,0,0,7,11
20150325-M-Miami_Masters-R128-Diego_Sebastian_Schwartzman-Dominic_Thiem,2,S-DTL,4,1,0,0,1,1,3
20150325-M-Miami_Masters-R128-Diego_Sebastian_Schwartzman-Dominic_Thiem,2,S-IO,2,0,0,0,0,0,2
20140924-M-Napa_CH-R16-Alex_Bolt-Dennis_Novikov,1,F-XC,31,8,5,1,2,17,14
20140924-M-Napa_CH-R16-Alex_Bolt-Dennis_Novikov,1,F-DTM,22,1,0,1,0,9,13
20140924-M-Napa_CH-R16-Alex_Bolt-Dennis_Novikov,1,F-DTL,13,9,3,3,3,7,6
20140924-M-Napa_CH-R16-Alex_Bolt-Dennis_Novikov,1,F-IO,15,7,1,2,4,8,7
20140924-M-Napa_CH-R16-Alex_Bolt-Dennis_Novikov,1,F-II,7,4,2,2,0,6,1
20140924-M-Napa_CH-R16-Alex_Bolt-Dennis_Novikov,1,B-XC,10,1,0,0,1,3,7
20140924-M-Napa_CH-R16-Alex_Bolt-Dennis_Novikov,1,B-DTM,11,1,0,0,1,6,5
20140924-M-Napa_CH-R16-Alex_Bolt-Dennis_Novikov,1,B-DTL,2,2,0,0,2,0,2
20140924-M-Napa_CH-R16-Alex_Bolt-Dennis_Novikov,1,B-IO,1,1,1,0,0,1,0
20140924-M-Napa_CH-R16-Alex_Bolt-Dennis_Novikov,1,S-XC,9,2,0,1,1,5,4
20140924-M-Napa_CH-R16-Alex_Bolt-Dennis_Novikov,1,S-DTM,12,0,0,0,0,3,9
20140924-M-Napa_CH-R16-Alex_Bolt-Dennis_Novikov,1,S-DTL,7,1,0,0,1,2,5
20140924-M-Napa_CH-R16-Alex_Bolt-Dennis_Novikov,2,F-XC,34,7,1,1,5,16,18
20140924-M-Napa_CH-R16-Alex_Bolt-Dennis_Novikov,2,F-DTM,13,1,0,0,1,7,6
20140924-M-Napa_CH-R16-Alex_Bolt-Dennis_Novikov,2,F-DTL,7,5,3,2,0,6,1
20140924-M-Napa_CH-R16-Alex_Bolt-Dennis_Novikov,2,F-IO,14,8,3,1,4,10,4
20140924-M-Napa_CH-R16-Alex_Bolt-Dennis_Novikov,2,B-XC,24,12,1,5,6,12,12
20140924-M-Napa_CH-R16-Alex_Bolt-Dennis_Novikov,2,B-DTM,20,3,0,0,3,8,12
20140924-M-Napa_CH-R16-Alex_Bolt-Dennis_Novikov,2,B-DTL,7,2,2,0,0,4,3
20140924-M-Napa_CH-R16-Alex_Bolt-Dennis_Novikov,2,B-IO,6,2,1,1,0,5,1
20140924-M-Napa_CH-R16-Alex_Bolt-Dennis_Novikov,2,S-XC,2,0,0,0,0,1,1
20140924-M-Napa_CH-R16-Alex_Bolt-Dennis_Novikov,2,S-DTM,1,0,0,0,0,0,1
20140924-M-Napa_CH-R16-Alex_Bolt-Dennis_Novikov,2,S-DTL,3,1,1,0,0,2,1
20140924-M-Napa_CH-R16-Alex_Bolt-Dennis_Novikov,2,S-IO,1,0,0,0,0,1,0
20150313-M-Santiago_CH-QF-Jordi_Samper_Montana-Ruben_Ramirez_Hidalgo,1,F-XC,39,11,1,2,8,22,17
20150313-M-Santiago_CH-QF-Jordi_Samper_Montana-Ruben_Ramirez_Hidalgo,1,F-DTM,53,9,0,0,9,33,20
20150313-M-Santiago_CH-QF-Jordi_Samper_Montana-Ruben_Ramirez_Hidalgo,1,F-DTL,9,4,1,2,1,8,1
20150313-M-Santiago_CH-QF-Jordi_Samper_Montana-Ruben_Ramirez_Hidalgo,1,F-IO,48,8,0,2,6,24,24
20150313-M-Santiago_CH-QF-Jordi_Samper_Montana-Ruben_Ramirez_Hidalgo,1,F-II,17,5,2,2,1,15,2
20150313-M-Santiago_CH-QF-Jordi_Samper_Montana-Ruben_Ramirez_Hidalgo,1,B-XC,19,1,0,0,1,5,14
20150313-M-Santiago_CH-QF-Jordi_Samper_Montana-Ruben_Ramirez_Hidalgo,1,B-DTM,9,0,0,0,0,4,5
20150313-M-Santiago_CH-QF-Jordi_Samper_Montana-Ruben_Ramirez_Hidalgo,1,B-DTL,2,0,0,0,0,2,0
20150313-M-Santiago_CH-QF-Jordi_Samper_Montana-Ruben_Ramirez_Hidalgo,1,S-XC,31,3,0,0,3,15,16
20150313-M-Santiago_CH-QF-Jordi_Samper_Montana-Ruben_Ramirez_Hidalgo,1,S-DTM,27,1,0,0,1,16,11
20150313-M-Santiago_CH-QF-Jordi_Samper_Montana-Ruben_Ramirez_Hidalgo,1,S-DTL,2,0,0,0,0,0,2
20150313-M-Santiago_CH-QF-Jordi_Samper_Montana-Ruben_Ramirez_Hidalgo,2,F-XC,57,17,5,0,12,21,36
20150313-M-Santiago_CH-QF-Jordi_Samper_Montana-Ruben_Ramirez_Hidalgo,2,F-DTM,41,3,0,0,3,15,26
20150313-M-Santiago_CH-QF-Jordi_Samper_Montana-Ruben_Ramirez_Hidalgo,2,F-DTL,8,3,1,0,2,1,7
20150313-M-Santiago_CH-QF-Jordi_Samper_Montana-Ruben_Ramirez_Hidalgo,2,F-IO,90,13,2,0,11,41,49
20150313-M-Santiago_CH-QF-Jordi_Samper_Montana-Ruben_Ramirez_Hidalgo,2,F-II,7,2,0,2,0,7,0
20150313-M-Santiago_CH-QF-Jordi_Samper_Montana-Ruben_Ramirez_Hidalgo,2,B-XC,38,8,1,0,7,14,24
20150313-M-Santiago_CH-QF-Jordi_Samper_Montana-Ruben_Ramirez_Hidalgo,2,B-DTM,21,4,0,0,4,6,15
20150313-M-Santiago_CH-QF-Jordi_Samper_Montana-Ruben_Ramirez_Hidalgo,2,B-DTL,3,1,1,0,0,3,0
20150313-M-Santiago_CH-QF-Jordi_Samper_Montana-Ruben_Ramirez_Hidalgo,2,S-XC,3,0,0,0,0,0,3
20150313-M-Santiago_CH-QF-Jordi_Samper_Montana-Ruben_Ramirez_Hidalgo,2,S-DTM,1,0,0,0,0,0,1
20150313-M-Santiago_CH-QF-Jordi_Samper_Montana-Ruben_Ramirez_Hidalgo,2,S-DTL,1,0,0,0,0,0,1
20150318-M-Indian_Wells-R16-Roger_Federer-Jack_Sock,1,F-XC,23,11,2,4,5,15,8
20150318-M-Indian_Wells-R16-Roger_Federer-Jack_Sock,1,F-DTM,6,0,0,0,0,2,4
20150318-M-Indian_Wells-R16-Roger_Federer-Jack_Sock,1,F-DTL,5,1,0,1,0,4,1
20150318-M-Indian_Wells-R16-Roger_Federer-Jack_Sock,1,F-IO,14,8,5,0,3,9,5
20150318-M-Indian_Wells-R16-Roger_Federer-Jack_Sock,1,F-II,5,2,0,1,1,3,2
20150318-M-Indian_Wells-R16-Roger_Federer-Jack_Sock,1,B-XC,14,3,2,1,0,9,5
20150318-M-Indian_Wells-R16-Roger_Federer-Jack_Sock,1,B-DTM,10,2,0,0,2,3,7
20150318-M-Indian_Wells-R16-Roger_Federer-Jack_Sock,1,B-DTL,8,4,3,0,1,7,1
20150318-M-Indian_Wells-R16-Roger_Federer-Jack_Sock,1,B-IO,1,1,0,0,1,0,1
20150318-M-Indian_Wells-R16-Roger_Federer-Jack_Sock,1,S-XC,6,1,0,0,1,2,4
20150318-M-Indian_Wells-R16-Roger_Federer-Jack_Sock,1,S-DTM,2,0,0,0,0,1,1
20150318-M-Indian_Wells-R16-Roger_Federer-Jack_Sock,2,F-XC,15,3,1,0,2,6,9
20150318-M-Indian_Wells-R16-Roger_Federer-Jack_Sock,2,F-DTM,12,1,0,0,1,9,3
20150318-M-Indian_Wells-R16-Roger_Federer-Jack_Sock,2,F-DTL,6,1,0,0,1,0,6
20150318-M-Indian_Wells-R16-Roger_Federer-Jack_Sock,2,F-IO,37,11,3,3,5,20,17
20150318-M-Indian_Wells-R16-Roger_Federer-Jack_Sock,2,F-II,9,5,1,2,2,5,4
20150318-M-Indian_Wells-R16-Roger_Federer-Jack_Sock,2,B-XC,3,0,0,0,0,1,2
20150318-M-Indian_Wells-R16-Roger_Federer-Jack_Sock,2,B-DTM,3,0,0,0,0,1,2
20150318-M-Indian_Wells-R16-Roger_Federer-Jack_Sock,2,B-DTL,1,1,0,0,1,0,1
20150318-M-Indian_Wells-R16-Roger_Federer-Jack_Sock,2,S-XC,5,0,0,0,0,2,3
20150318-M-Indian_Wells-R16-Roger_Federer-Jack_Sock,2,S-DTM,4,1,0,0,1,1,3
20150318-M-Indian_Wells-R16-Roger_Federer-Jack_Sock,2,S-DTL,1,0,0,0,0,1,0
20150318-M-Indian_Wells-R16-Roger_Federer-Jack_Sock,2,S-IO,1,0,0,0,0,0,1
20150328-M-Miami_Masters-R64-Mikhail_Youzhny-Kei_Nishikori,1,F-XC,13,3,1,1,1,9,4
20150328-M-Miami_Masters-R64-Mikhail_Youzhny-Kei_Nishikori,1,F-DTM,14,3,0,0,3,3,11
20150328-M-Miami_Masters-R64-Mikhail_Youzhny-Kei_Nishikori,1,F-DTL,12,5,1,1,3,5,7
20150328-M-Miami_Masters-R64-Mikhail_Youzhny-Kei_Nishikori,1,F-IO,12,3,0,2,1,6,6
20150328-M-Miami_Masters-R64-Mikhail_Youzhny-Kei_Nishikori,1,B-XC,33,2,0,0,2,11,22
20150328-M-Miami_Masters-R64-Mikhail_Youzhny-Kei_Nishikori,1,B-DTM,12,4,0,0,4,1,11
20150328-M-Miami_Masters-R64-Mikhail_Youzhny-Kei_Nishikori,1,B-DTL,16,9,1,0,8,3,13
20150328-M-Miami_Masters-R64-Mikhail_Youzhny-Kei_Nishikori,1,B-IO,1,1,0,0,1,0,1
20150328-M-Miami_Masters-R64-Mikhail_Youzhny-Kei_Nishikori,1,S-XC,15,3,0,1,2,6,9
20150328-M-Miami_Masters-R64-Mikhail_Youzhny-Kei_Nishikori,1,S-DTM,6,1,0,0,1,2,4
20150328-M-Miami_Masters-R64-Mikhail_Youzhny-Kei_Nishikori,1,S-DTL,5,1,0,0,1,1,4
20150328-M-Miami_Masters-R64-Mikhail_Youzhny-Kei_Nishikori,2,F-XC,16,3,1,1,1,9,7
20150328-M-Miami_Masters-R64-Mikhail_Youzhny-Kei_Nishikori,2,F-DTM,12,2,0,0,2,5,7
20150328-M-Miami_Masters-R64-Mikhail_Youzhny-Kei_Nishikori,2,F-DTL,7,2,0,2,0,6,1
20150328-M-Miami_Masters-R64-Mikhail_Youzhny-Kei_Nishikori,2,F-IO,16,2,2,0,0,14,2
20150328-M-Miami_Masters-R64-Mikhail_Youzhny-Kei_Nishikori,2,F-II,1,1,0,1,0,1,0
20150328-M-Miami_Masters-R64-Mikhail_Youzhny-Kei_Nishikori,2,B-XC,50,9,3,1,5,32,18
20150328-M-Miami_Masters-R64-Mikhail_Youzhny-Kei_Nishikori,2,B-DTM,10,0,0,0,0,7,3
20150328-M-Miami_Masters-R64-Mikhail_Youzhny-Kei_Nishikori,2,B-DTL,4,2,0,1,1,2,2
20150328-M-Miami_Masters-R64-Mikhail_Youzhny-Kei_Nishikori,2,B-IO,2,0,0,0,0,1,1
20150328-M-Miami_Masters-R64-Mikhail_Youzhny-Kei_Nishikori,2,S-XC,8,3,0,0,3,3,5
20150328-M-Miami_Masters-R64-Mikhail_Youzhny-Kei_Nishikori,2,S-DTM,1,0,0,0,0,0,1
20150325-M-Miami_Masters-R64-Vasek_Pospisil-Juan_Martin_Del_Potro,1,F-XC,18,7,2,2,3,8,10
20150325-M-Miami_Masters-R64-Vasek_Pospisil-Juan_Martin_Del_Potro,1,F-DTM,9,0,0,0,0,3,6
20150325-M-Miami_Masters-R64-Vasek_Pospisil-Juan_Martin_Del_Potro,1,F-DTL,12,2,0,0,2,5,7
20150325-M-Miami_Masters-R64-Vasek_Pospisil-Juan_Martin_Del_Potro,1,F-IO,43,8,0,3,5,29,14
20150325-M-Miami_Masters-R64-Vasek_Pospisil-Juan_Martin_Del_Potro,1,F-II,14,10,5,2,3,9,5
20150325-M-Miami_Masters-R64-Vasek_Pospisil-Juan_Martin_Del_Potro,1,B-XC,8,1,0,0,1,4,4
20150325-M-Miami_Masters-R64-Vasek_Pospisil-Juan_Martin_Del_Potro,1,B-DTM,6,2,0,0,2,0,6
20150325-M-Miami_Masters-R64-Vasek_Pospisil-Juan_Martin_Del_Potro,1,B-DTL,1,0,0,0,0,0,1
20150325-M-Miami_Masters-R64-Vasek_Pospisil-Juan_Martin_Del_Potro,1,S-XC,14,1,1,0,0,6,8
20150325-M-Miami_Masters-R64-Vasek_Pospisil-Juan_Martin_Del_Potro,1,S-DTM,4,0,0,0,0,0,4
20150325-M-Miami_Masters-R64-Vasek_Pospisil-Juan_Martin_Del_Potro,1,S-DTL,4,0,0,0,0,2,2
20150325-M-Miami_Masters-R64-Vasek_Pospisil-Juan_Martin_Del_Potro,2,F-XC,26,9,3,3,3,19,7
20150325-M-Miami_Masters-R64-Vasek_Pospisil-Juan_Martin_Del_Potro,2,F-DTM,16,0,0,0,0,7,9
20150325-M-Miami_Masters-R64-Vasek_Pospisil-Juan_Martin_Del_Potro,2,F-DTL,6,2,0,0,2,3,3
20150325-M-Miami_Masters-R64-Vasek_Pospisil-Juan_Martin_Del_Potro,2,F-IO,35,7,1,3,3,24,11
20150325-M-Miami_Masters-R64-Vasek_Pospisil-Juan_Martin_Del_Potro,2,F-II,8,2,0,1,1,6,2
20150325-M-Miami_Masters-R64-Vasek_Pospisil-Juan_Martin_Del_Potro,2,B-XC,8,0,0,0,0,3,5
20150325-M-Miami_Masters-R64-Vasek_Pospisil-Juan_Martin_Del_Potro,2,B-DTM,6,0,0,0,0,0,6
20150325-M-Miami_Masters-R64-Vasek_Pospisil-Juan_Martin_Del_Potro,2,B-DTL,2,0,0,0,0,0,2
20150325-M-Miami_Masters-R64-Vasek_Pospisil-Juan_Martin_Del_Potro,2,S-XC,27,2,0,0,2,11,16
20150325-M-Miami_Masters-R64-Vasek_Pospisil-Juan_Martin_Del_Potro,2,S-DTM,3,0,0,0,0,0,3
20150325-M-Miami_Masters-R64-Vasek_Pospisil-Juan_Martin_Del_Potro,2,S-DTL,2,0,0,0,0,0,2
20150329-M-Miami_Masters-R32-Leonardo_Mayer-Kevin_Anderson,1,F-XC,28,9,3,1,5,17,11
20150329-M-Miami_Masters-R32-Leonardo_Mayer-Kevin_Anderson,1,F-DTM,14,2,0,0,2,8,6
20150329-M-Miami_Masters-R32-Leonardo_Mayer-Kevin_Anderson,1,F-DTL,6,3,1,0,2,3,3
20150329-M-Miami_Masters-R32-Leonardo_Mayer-Kevin_Anderson,1,F-IO,22,8,1,3,4,12,10
20150329-M-Miami_Masters-R32-Leonardo_Mayer-Kevin_Anderson,1,F-II,1,0,0,0,0,1,0
20150329-M-Miami_Masters-R32-Leonardo_Mayer-Kevin_Anderson,1,B-XC,26,3,0,0,3,13,13
20150329-M-Miami_Masters-R32-Leonardo_Mayer-Kevin_Anderson,1,B-DTM,13,2,0,0,2,8,5
20150329-M-Miami_Masters-R32-Leonardo_Mayer-Kevin_Anderson,1,B-DTL,4,3,2,0,1,3,1
20150329-M-Miami_Masters-R32-Leonardo_Mayer-Kevin_Anderson,1,S-XC,3,0,0,0,0,2,1
20150329-M-Miami_Masters-R32-Leonardo_Mayer-Kevin_Anderson,1,S-DTM,2,1,0,1,0,2,0
20150329-M-Miami_Masters-R32-Leonardo_Mayer-Kevin_Anderson,1,S-DTL,2,1,0,1,0,2,0
20150329-M-Miami_Masters-R32-Leonardo_Mayer-Kevin_Anderson,2,F-XC,26,13,2,5,6,12,14
20150329-M-Miami_Masters-R32-Leonardo_Mayer-Kevin_Anderson,2,F-DTM,9,0,0,0,0,3,6
20150329-M-Miami_Masters-R32-Leonardo_Mayer-Kevin_Anderson,2,F-DTL,5,2,0,0,2,1,4
20150329-M-Miami_Masters-R32-Leonardo_Mayer-Kevin_Anderson,2,F-IO,19,6,2,1,3,9,10
20150329-M-Miami_Masters-R32-Leonardo_Mayer-Kevin_Anderson,2,F-II,3,1,0,0,1,1,2
20150329-M-Miami_Masters-R32-Leonardo_Mayer-Kevin_Anderson,2,B-XC,25,1,0,0,1,13,12
20150329-M-Miami_Masters-R32-Leonardo_Mayer-Kevin_Anderson,2,B-DTM,13,2,0,1,1,6,7
20150329-M-Miami_Masters-R32-Leonardo_Mayer-Kevin_Anderson,2,B-DTL,4,2,1,0,1,1,3
20150329-M-Miami_Masters-R32-Leonardo_Mayer-Kevin_Anderson,2,B-IO,2,1,0,0,1,0,2
20150329-M-Miami_Masters-R32-Leonardo_Mayer-Kevin_Anderson,2,S-XC,5,0,0,0,0,2,3
20150329-M-Miami_Masters-R32-Leonardo_Mayer-Kevin_Anderson,2,S-DTM,3,0,0,0,0,0,3
20150329-M-Miami_Masters-R32-Leonardo_Mayer-Kevin_Anderson,2,S-DTL,2,0,0,0,0,0,2
20150406-M-Casablanca-R32-Carlos_Berlocq-Pablo_Carreno_Busta,1,F-XC,71,14,6,4,4,42,29
20150406-M-Casablanca-R32-Carlos_Berlocq-Pablo_Carreno_Busta,1,F-DTM,38,0,0,0,0,17,21
20150406-M-Casablanca-R32-Carlos_Berlocq-Pablo_Carreno_Busta,1,F-DTL,35,6,2,3,1,17,18
20150406-M-Casablanca-R32-Carlos_Berlocq-Pablo_Carreno_Busta,1,F-IO,62,9,2,2,5,36,26
20150406-M-Casablanca-R32-Carlos_Berlocq-Pablo_Carreno_Busta,1,F-II,15,6,2,2,2,10,5
20150406-M-Casablanca-R32-Carlos_Berlocq-Pablo_Carreno_Busta,1,B-XC,87,6,0,1,5,39,48
20150406-M-Casablanca-R32-Carlos_Berlocq-Pablo_Carreno_Busta,1,B-DTM,37,0,0,0,0,15,22
20150406-M-Casablanca-R32-Carlos_Berlocq-Pablo_Carreno_Busta,1,B-DTL,28,13,7,2,4,19,9
20150406-M-Casablanca-R32-Carlos_Berlocq-Pablo_Carreno_Busta,1,B-IO,3,2,2,0,0,3,0
20150406-M-Casablanca-R32-Carlos_Berlocq-Pablo_Carreno_Busta,1,S-XC,11,0,0,0,0,8,3
20150406-M-Casablanca-R32-Carlos_Berlocq-Pablo_Carreno_Busta,1,S-DTM,10,0,0,0,0,3,7
20150406-M-Casablanca-R32-Carlos_Berlocq-Pablo_Carreno_Busta,1,S-DTL,2,0,0,0,0,2,0
20150406-M-Casablanca-R32-Carlos_Berlocq-Pablo_Carreno_Busta,2,F-XC,87,24,9,6,9,43,44
20150406-M-Casablanca-R32-Carlos_Berlocq-Pablo_Carreno_Busta,2,F-DTM,33,4,0,0,4,13,20
20150406-M-Casablanca-R32-Carlos_Berlocq-Pablo_Carreno_Busta,2,F-DTL,25,8,3,2,3,13,12
20150406-M-Casablanca-R32-Carlos_Berlocq-Pablo_Carreno_Busta,2,F-IO,67,19,11,1,7,35,32
20150406-M-Casablanca-R32-Carlos_Berlocq-Pablo_Carreno_Busta,2,F-II,11,7,6,1,0,8,3
20150406-M-Casablanca-R32-Carlos_Berlocq-Pablo_Carreno_Busta,2,B-XC,108,15,5,1,9,56,52
20150406-M-Casablanca-R32-Carlos_Berlocq-Pablo_Carreno_Busta,2,B-DTM,49,2,0,0,2,22,27
20150406-M-Casablanca-R32-Carlos_Berlocq-Pablo_Carreno_Busta,2,B-DTL,32,18,9,2,7,20,12
20150406-M-Casablanca-R32-Carlos_Berlocq-Pablo_Carreno_Busta,2,B-IO,5,3,2,0,1,4,1
20150406-M-Casablanca-R32-Carlos_Berlocq-Pablo_Carreno_Busta,2,S-XC,2,0,0,0,0,1,1
20150406-M-Casablanca-R32-Carlos_Berlocq-Pablo_Carreno_Busta,2,S-DTM,3,0,0,0,0,0,3
20150406-M-Casablanca-R32-Carlos_Berlocq-Pablo_Carreno_Busta,2,S-DTL,2,0,0,0,0,0,2
20150330-M-Miami_Masters-R32-Viktor_Troicki-Kei_Nishikori,1,F-XC,10,2,0,0,2,4,6
20150330-M-Miami_Masters-R32-Viktor_Troicki-Kei_Nishikori,1,F-DTM,15,0,0,0,0,8,7
20150330-M-Miami_Masters-R32-Viktor_Troicki-Kei_Nishikori,1,F-DTL,6,0,0,0,0,1,5
20150330-M-Miami_Masters-R32-Viktor_Troicki-Kei_Nishikori,1,F-IO,4,1,0,0,1,2,2
20150330-M-Miami_Masters-R32-Viktor_Troicki-Kei_Nishikori,1,B-XC,44,9,0,1,8,11,33
20150330-M-Miami_Masters-R32-Viktor_Troicki-Kei_Nishikori,1,B-DTM,20,3,0,0,3,4,16
20150330-M-Miami_Masters-R32-Viktor_Troicki-Kei_Nishikori,1,B-DTL,13,8,0,1,7,2,11
20150330-M-Miami_Masters-R32-Viktor_Troicki-Kei_Nishikori,1,B-IO,5,2,0,0,2,1,4
20150330-M-Miami_Masters-R32-Viktor_Troicki-Kei_Nishikori,1,S-XC,2,0,0,0,0,0,2
20150330-M-Miami_Masters-R32-Viktor_Troicki-Kei_Nishikori,1,S-DTM,1,0,0,0,0,0,1
20150330-M-Miami_Masters-R32-Viktor_Troicki-Kei_Nishikori,1,S-DTL,2,1,0,0,1,0,2
20150330-M-Miami_Masters-R32-Viktor_Troicki-Kei_Nishikori,2,F-XC,22,6,0,1,5,11,11
20150330-M-Miami_Masters-R32-Viktor_Troicki-Kei_Nishikori,2,F-DTM,7,0,0,0,0,4,3
20150330-M-Miami_Masters-R32-Viktor_Troicki-Kei_Nishikori,2,F-DTL,9,2,1,0,1,7,2
20150330-M-Miami_Masters-R32-Viktor_Troicki-Kei_Nishikori,2,F-IO,16,2,0,0,2,12,4
20150330-M-Miami_Masters-R32-Viktor_Troicki-Kei_Nishikori,2,F-II,1,0,0,0,0,1,0
20150330-M-Miami_Masters-R32-Viktor_Troicki-Kei_Nishikori,2,B-XC,35,4,0,1,3,26,9
20150330-M-Miami_Masters-R32-Viktor_Troicki-Kei_Nishikori,2,B-DTM,7,0,0,0,0,5,2
20150330-M-Miami_Masters-R32-Viktor_Troicki-Kei_Nishikori,2,B-DTL,8,1,1,0,0,5,3
20150330-M-Miami_Masters-R32-Viktor_Troicki-Kei_Nishikori,2,B-IO,3,2,2,0,0,3,0
20150330-M-Miami_Masters-R32-Viktor_Troicki-Kei_Nishikori,2,S-XC,6,0,0,0,0,6,0
20150330-M-Miami_Masters-R32-Viktor_Troicki-Kei_Nishikori,2,S-DTL,1,0,0,0,0,0,1
20090130-M-Australian_Open-SF-Fernando_Verdasco-Rafael_Nadal,1,F-XC,91,23,9,5,9,55,36
20090130-M-Australian_Open-SF-Fernando_Verdasco-Rafael_Nadal,1,F-DTM,72,12,0,5,7,39,33
20090130-M-Australian_Open-SF-Fernando_Verdasco-Rafael_Nadal,1,F-DTL,26,10,5,1,4,18,8
20090130-M-Australian_Open-SF-Fernando_Verdasco-Rafael_Nadal,1,F-IO,78,23,13,1,9,42,36
20090130-M-Australian_Open-SF-Fernando_Verdasco-Rafael_Nadal,1,F-II,7,3,1,1,1,5,2
20090130-M-Australian_Open-SF-Fernando_Verdasco-Rafael_Nadal,1,B-XC,96,18,6,3,9,48,48
20090130-M-Australian_Open-SF-Fernando_Verdasco-Rafael_Nadal,1,B-DTM,55,4,0,1,3,21,34
20090130-M-Australian_Open-SF-Fernando_Verdasco-Rafael_Nadal,1,B-DTL,36,12,5,1,6,16,20
20090130-M-Australian_Open-SF-Fernando_Verdasco-Rafael_Nadal,1,B-IO,18,7,2,1,4,8,10
20090130-M-Australian_Open-SF-Fernando_Verdasco-Rafael_Nadal,1,B-II,1,0,0,0,0,0,1
20090130-M-Australian_Open-SF-Fernando_Verdasco-Rafael_Nadal,1,S-XC,16,3,0,0,3,6,10
20090130-M-Australian_Open-SF-Fernando_Verdasco-Rafael_Nadal,1,S-DTM,13,2,0,0,2,7,6
20090130-M-Australian_Open-SF-Fernando_Verdasco-Rafael_Nadal,1,S-DTL,6,2,0,0,2,2,4
20090130-M-Australian_Open-SF-Fernando_Verdasco-Rafael_Nadal,1,S-IO,3,1,0,0,1,0,3
20090130-M-Australian_Open-SF-Fernando_Verdasco-Rafael_Nadal,2,F-XC,96,25,9,12,4,53,43
20090130-M-Australian_Open-SF-Fernando_Verdasco-Rafael_Nadal,2,F-DTM,79,3,0,0,3,38,41
20090130-M-Australian_Open-SF-Fernando_Verdasco-Rafael_Nadal,2,F-DTL,37,11,3,3,5,21,16
20090130-M-Australian_Open-SF-Fernando_Verdasco-Rafael_Nadal,2,F-IO,61,16,8,4,4,36,25
20090130-M-Australian_Open-SF-Fernando_Verdasco-Rafael_Nadal,2,F-II,8,5,2,2,1,5,3
20090130-M-Australian_Open-SF-Fernando_Verdasco-Rafael_Nadal,2,B-XC,50,7,1,2,4,29,21
20090130-M-Australian_Open-SF-Fernando_Verdasco-Rafael_Nadal,2,B-DTM,45,2,0,1,1,21,24
20090130-M-Australian_Open-SF-Fernando_Verdasco-Rafael_Nadal,2,B-DTL,16,7,3,2,2,10,6
20090130-M-Australian_Open-SF-Fernando_Verdasco-Rafael_Nadal,2,B-IO,4,0,0,0,0,3,1
20090130-M-Australian_Open-SF-Fernando_Verdasco-Rafael_Nadal,2,B-II,1,0,0,0,0,1,0
20090130-M-Australian_Open-SF-Fernando_Verdasco-Rafael_Nadal,2,S-XC,51,2,0,1,1,20,31
20090130-M-Australian_Open-SF-Fernando_Verdasco-Rafael_Nadal,2,S-DTM,49,0,0,0,0,23,26
20090130-M-Australian_Open-SF-Fernando_Verdasco-Rafael_Nadal,2,S-DTL,10,1,0,0,1,3,7
20090130-M-Australian_Open-SF-Fernando_Verdasco-Rafael_Nadal,2,S-IO,3,0,0,0,0,2,1
20090130-M-Australian_Open-SF-Fernando_Verdasco-Rafael_Nadal,2,S-II,2,0,0,0,0,0,2
20150321-M-Indian_Wells_Masters-QF-Milos_Raonic-Rafael_Nadal,1,F-XC,65,18,4,5,9,35,30
20150321-M-Indian_Wells_Masters-QF-Milos_Raonic-Rafael_Nadal,1,F-DTM,20,0,0,0,0,10,10
20150321-M-Indian_Wells_Masters-QF-Milos_Raonic-Rafael_Nadal,1,F-DTL,12,9,2,0,7,4,8
20150321-M-Indian_Wells_Masters-QF-Milos_Raonic-Rafael_Nadal,1,F-IO,47,22,8,4,10,25,22
20150321-M-Indian_Wells_Masters-QF-Milos_Raonic-Rafael_Nadal,1,F-II,14,5,0,1,4,5,9
20150321-M-Indian_Wells_Masters-QF-Milos_Raonic-Rafael_Nadal,1,B-XC,19,10,1,1,8,6,13
20150321-M-Indian_Wells_Masters-QF-Milos_Raonic-Rafael_Nadal,1,B-DTM,18,4,0,0,4,6,12
20150321-M-Indian_Wells_Masters-QF-Milos_Raonic-Rafael_Nadal,1,B-DTL,6,1,0,0,1,1,5
20150321-M-Indian_Wells_Masters-QF-Milos_Raonic-Rafael_Nadal,1,S-XC,6,2,0,1,1,2,4
20150321-M-Indian_Wells_Masters-QF-Milos_Raonic-Rafael_Nadal,1,S-DTM,1,1,0,0,1,0,1
20150321-M-Indian_Wells_Masters-QF-Milos_Raonic-Rafael_Nadal,2,F-XC,47,7,1,3,3,30,17
20150321-M-Indian_Wells_Masters-QF-Milos_Raonic-Rafael_Nadal,2,F-DTM,21,3,0,0,3,10,11
20150321-M-Indian_Wells_Masters-QF-Milos_Raonic-Rafael_Nadal,2,F-DTL,17,12,6,2,4,10,7
20150321-M-Indian_Wells_Masters-QF-Milos_Raonic-Rafael_Nadal,2,F-IO,27,10,4,2,4,19,8
20150321-M-Indian_Wells_Masters-QF-Milos_Raonic-Rafael_Nadal,2,F-II,3,0,0,0,0,2,1
20150321-M-Indian_Wells_Masters-QF-Milos_Raonic-Rafael_Nadal,2,B-XC,16,5,0,1,4,5,11
20150321-M-Indian_Wells_Masters-QF-Milos_Raonic-Rafael_Nadal,2,B-DTM,19,1,0,0,1,10,9
20150321-M-Indian_Wells_Masters-QF-Milos_Raonic-Rafael_Nadal,2,B-DTL,10,2,0,1,1,6,4
20150321-M-Indian_Wells_Masters-QF-Milos_Raonic-Rafael_Nadal,2,B-IO,5,0,0,0,0,3,2
20150321-M-Indian_Wells_Masters-QF-Milos_Raonic-Rafael_Nadal,2,S-XC,6,0,0,0,0,3,3
20150321-M-Indian_Wells_Masters-QF-Milos_Raonic-Rafael_Nadal,2,S-DTM,18,0,0,0,0,10,8
20150321-M-Indian_Wells_Masters-QF-Milos_Raonic-Rafael_Nadal,2,S-DTL,9,1,0,0,1,3,6
20150321-M-Indian_Wells_Masters-QF-Milos_Raonic-Rafael_Nadal,2,S-IO,3,0,0,0,0,1,2
20150318-M-Indian_Wells_Masters-R16-Milos_Raonic-Tommy_Robredo,1,F-XC,16,11,4,5,2,11,5
20150318-M-Indian_Wells_Masters-R16-Milos_Raonic-Tommy_Robredo,1,F-DTM,11,3,1,1,1,6,5
20150318-M-Indian_Wells_Masters-R16-Milos_Raonic-Tommy_Robredo,1,F-DTL,6,3,1,1,1,3,3
20150318-M-Indian_Wells_Masters-R16-Milos_Raonic-Tommy_Robredo,1,F-IO,30,8,6,0,2,18,12
20150318-M-Indian_Wells_Masters-R16-Milos_Raonic-Tommy_Robredo,1,F-II,9,9,5,1,3,6,3
20150318-M-Indian_Wells_Masters-R16-Milos_Raonic-Tommy_Robredo,1,B-XC,5,1,0,0,1,3,2
20150318-M-Indian_Wells_Masters-R16-Milos_Raonic-Tommy_Robredo,1,B-DTM,6,1,0,0,1,1,5
20150318-M-Indian_Wells_Masters-R16-Milos_Raonic-Tommy_Robredo,1,B-DTL,3,3,1,0,2,1,2
20150318-M-Indian_Wells_Masters-R16-Milos_Raonic-Tommy_Robredo,1,B-IO,1,0,0,0,0,1,0
20150318-M-Indian_Wells_Masters-R16-Milos_Raonic-Tommy_Robredo,1,S-XC,5,2,0,1,1,2,3
20150318-M-Indian_Wells_Masters-R16-Milos_Raonic-Tommy_Robredo,1,S-IO,1,0,0,0,0,0,1
20150318-M-Indian_Wells_Masters-R16-Milos_Raonic-Tommy_Robredo,2,F-XC,9,1,1,0,0,5,4
20150318-M-Indian_Wells_Masters-R16-Milos_Raonic-Tommy_Robredo,2,F-DTM,11,1,0,0,1,8,3
20150318-M-Indian_Wells_Masters-R16-Milos_Raonic-Tommy_Robredo,2,F-DTL,3,1,1,0,0,3,0
20150318-M-Indian_Wells_Masters-R16-Milos_Raonic-Tommy_Robredo,2,F-IO,14,4,1,1,2,6,8
20150318-M-Indian_Wells_Masters-R16-Milos_Raonic-Tommy_Robredo,2,F-II,3,0,0,0,0,1,2
20150318-M-Indian_Wells_Masters-R16-Milos_Raonic-Tommy_Robredo,2,B-XC,7,0,0,0,0,3,4
20150318-M-Indian_Wells_Masters-R16-Milos_Raonic-Tommy_Robredo,2,B-DTM,15,1,0,0,1,9,6
20150318-M-Indian_Wells_Masters-R16-Milos_Raonic-Tommy_Robredo,2,B-DTL,3,1,1,0,0,2,1
20150318-M-Indian_Wells_Masters-R16-Milos_Raonic-Tommy_Robredo,2,B-IO,3,1,0,0,1,0,3
20150318-M-Indian_Wells_Masters-R16-Milos_Raonic-Tommy_Robredo,2,S-XC,8,1,0,0,1,2,6
20150318-M-Indian_Wells_Masters-R16-Milos_Raonic-Tommy_Robredo,2,S-DTM,7,0,0,0,0,3,4
20150321-M-Indian_Wells_Masters-SF-Milos_Raonic-Roger_Federer,1,F-XC,22,8,4,1,3,11,11
20150321-M-Indian_Wells_Masters-SF-Milos_Raonic-Roger_Federer,1,F-DTM,8,2,0,0,2,2,6
20150321-M-Indian_Wells_Masters-SF-Milos_Raonic-Roger_Federer,1,F-DTL,7,3,0,2,1,3,4
20150321-M-Indian_Wells_Masters-SF-Milos_Raonic-Roger_Federer,1,F-IO,41,10,3,1,6,17,24
20150321-M-Indian_Wells_Masters-SF-Milos_Raonic-Roger_Federer,1,F-II,8,5,0,0,5,2,6
20150321-M-Indian_Wells_Masters-SF-Milos_Raonic-Roger_Federer,1,B-XC,12,2,1,0,1,3,9
20150321-M-Indian_Wells_Masters-SF-Milos_Raonic-Roger_Federer,1,B-DTM,7,3,1,0,2,2,5
20150321-M-Indian_Wells_Masters-SF-Milos_Raonic-Roger_Federer,1,B-DTL,1,1,0,0,1,0,1
20150321-M-Indian_Wells_Masters-SF-Milos_Raonic-Roger_Federer,1,B-IO,1,1,0,1,0,1,0
20150321-M-Indian_Wells_Masters-SF-Milos_Raonic-Roger_Federer,1,S-XC,10,4,1,0,3,3,7
20150321-M-Indian_Wells_Masters-SF-Milos_Raonic-Roger_Federer,1,S-DTL,1,1,0,0,1,0,1
20150321-M-Indian_Wells_Masters-SF-Milos_Raonic-Roger_Federer,2,F-XC,21,7,0,1,6,10,11
20150321-M-Indian_Wells_Masters-SF-Milos_Raonic-Roger_Federer,2,F-DTM,18,2,1,0,1,12,6
20150321-M-Indian_Wells_Masters-SF-Milos_Raonic-Roger_Federer,2,F-DTL,6,3,1,0,2,3,3
20150321-M-Indian_Wells_Masters-SF-Milos_Raonic-Roger_Federer,2,F-IO,14,5,1,2,2,11,3
20150321-M-Indian_Wells_Masters-SF-Milos_Raonic-Roger_Federer,2,F-II,1,1,0,0,1,0,1
20150321-M-Indian_Wells_Masters-SF-Milos_Raonic-Roger_Federer,2,B-XC,17,4,2,2,0,13,4
20150321-M-Indian_Wells_Masters-SF-Milos_Raonic-Roger_Federer,2,B-DTM,9,0,0,0,0,5,4
20150321-M-Indian_Wells_Masters-SF-Milos_Raonic-Roger_Federer,2,B-DTL,5,4,3,0,1,3,2
20150321-M-Indian_Wells_Masters-SF-Milos_Raonic-Roger_Federer,2,S-XC,13,1,0,0,1,7,6
20150321-M-Indian_Wells_Masters-SF-Milos_Raonic-Roger_Federer,2,S-DTM,4,0,0,0,0,2,2
20150321-M-Indian_Wells_Masters-SF-Milos_Raonic-Roger_Federer,2,S-DTL,4,0,0,0,0,3,1
